date,brand,company,positive,neutral,negative,total,theme
2025-08-16,Douglas McMillon,Walmart,11,20,9,40,
2025-08-16,Andrew Jassy,Amazon,6,28,6,40,
2025-08-16,Stephen Hemsley,UnitedHealth,8,25,7,40,
2025-08-16,Tim Cook,Apple,18,22,0,40,
2025-08-16,David Joyner,CVS Health,7,29,4,40,
2025-08-16,Warren Buffett,Berkshire Hathaway,12,25,3,40,
2025-08-16,Sundar Pichai,Alphabet,18,17,5,40,
2025-08-16,Darren Woods,Exxon Mobil,13,20,6,39,
2025-08-16,Brian Tyler,McKesson,4,14,4,22,
2025-08-16,Robert Mauch,Cencora,5,5,0,10,
2025-08-16,James Dimon,JPMorgan Chase,9,19,9,37,
2025-08-16,Ron Vachris,Costco,5,33,2,40,
2025-08-16,David Cordani,Cigna,21,17,2,40,
2025-08-16,Satya Nadella,Microsoft,10,20,10,40,
2025-08-16,Jason Hollar,Cardinal Health,13,22,5,40,
2025-08-16,Michael Wirth,Chevron,13,20,7,40,
2025-08-16,Brian Moynihan,Bank of America,3,27,10,40,
2025-08-16,Mary Barra,General Motors,11,25,4,40,
2025-08-16,James Farley Jr.,Ford Motor,1,4,3,8,
2025-08-16,Gail Boudreaux,Elevance Health,15,18,7,40,
2025-08-16,Jane Fraser,Citi,12,22,6,40,
2025-08-16,Mark Zuckerberg,Meta,14,20,6,40,
2025-08-16,Sarah London,Centene,12,20,8,40,
2025-08-16,Edward Decker,Home Depot,5,5,1,11,
2025-08-16,Priscilla Almodovar,Fannie Mae,10,16,13,39,
2025-08-16,Tim Wentworth,Walgreens,7,22,10,39,
2025-08-16,Ronald Sargent,Kroger,2,14,20,36,
2025-08-16,Mark Lashier,Phillips 66,9,20,9,38,
2025-08-16,Maryann Mannen,Marathon Petroleum,6,14,1,21,
2025-08-16,Hans Vestberg,Verizon,17,19,4,40,
2025-08-16,Jensen Huang,Nvidia,17,17,6,40,
2025-08-16,David Solomon,Goldman Sachs,2,18,19,39,
2025-08-16,Charles Scharf,Wells Fargo,29,7,4,40,
2025-08-16,Lane Riggs,Valero Energy,13,8,0,21,
2025-08-16,Brian Roberts,Comcast,10,28,2,40,
2025-08-16,Jon Farney,State Farm,10,27,3,40,
2025-08-16,John Stankey,AT&T,10,24,6,40,
2025-08-16,Michael Hutchins,Freddie Mac,3,11,4,18,
2025-08-16,James Rechtin,Humana,4,3,0,7,
2025-08-16,Edward Pick,Morgan Stanley,6,2,2,10,
2025-08-16,Brian Cornell,Target,7,21,12,40,
2025-08-16,Philip Smith,StoneX,0,9,1,10,
2025-08-16,Elon Musk,Tesla,14,18,8,40,
2025-08-16,Michael Dell,Dell Technologies,11,26,3,40,
2025-08-16,Ramon Laguarta,PepsiCo,8,28,4,40,
2025-08-16,Robert Iger,Walt Disney,13,24,3,40,
2025-08-16,Carol Tom√©,UPS,8,21,11,40,
2025-08-16,Joaquin Duato,Johnson & Johnson,8,27,5,40,
2025-08-16,Rajesh Subramaniam,FedEx,10,23,0,33,
2025-08-16,Juan Luciano,Archer Daniels Midland,3,20,17,40,
2025-08-16,Jon Moeller,Procter & Gamble,6,31,3,40,
2025-08-16,Marvin Ellison,Lowe's,15,19,6,40,
2025-08-16,Thomas Long,Energy Transfer,9,0,1,10,
2025-08-16,Christopher Calio,RTX,6,10,0,16,
2025-08-16,Susan Morris,Albertsons,9,27,4,40,
2025-08-16,Kevin Hourican,Sysco,10,27,3,40,
2025-08-16,Susan Patricia Griffith,Progressive,4,2,0,6,
2025-08-16,Stephen Squeri,American Express,14,24,2,40,
2025-08-16,James Taiclet,Lockheed Martin,11,18,11,40,
2025-08-16,Michel Khalaf,MetLife,11,17,0,28,
2025-08-16,Samuel Hazen,HCA Healthcare,8,5,0,13,
2025-08-16,Andrew Sullivan,Prudential Financial,13,23,0,36,
2025-08-16,Robert Ortberg,Boeing,4,7,2,13,
2025-08-16,Jospeh Creed,Caterpillar,0,0,0,0,
2025-08-16,Robert Davis,Merck,6,24,10,40,
2025-08-16,Thomas Wilson,Allstate,9,10,3,22,
2025-08-16,Albert Bourla,Pfizer,21,12,7,40,
2025-08-16,Arvind Krishna,IBM,14,20,6,40,
2025-08-16,Craig DeSanto,New York Life Insurance,3,15,0,18,
2025-08-16,Edward Bastian,Delta Airlines,1,8,1,10,
2025-08-16,Kevin Murphy,Ferguson,8,28,4,40,
2025-08-16,Kirt Walker,Nationwide,15,18,2,35,
2025-08-16,Patrick Zammit,TD Synnex,9,16,0,25,
2025-08-16,Scott Kirby,United Airlines,32,5,3,40,
2025-08-16,Ryan Lance,ConocoPhillips,17,19,4,40,
2025-08-16,Ernie Herrman,TJX,17,22,1,40,
2025-08-16,Robert Michael,AbbVie,6,27,2,35,
2025-08-16,James Teague,Enterprise Products Partners,2,5,2,9,
2025-08-16,Christopher Winfrey,Charter Communications,5,14,5,24,
2025-08-16,George Holm,Performance Food,11,22,2,35,
2025-08-16,Robert Isom,American Airlines,6,26,8,40,
2025-08-16,Richard Fairbank,Capital One,14,22,4,40,
2025-08-16,Charles Robbins,Cisco Systems,3,5,1,9,
2025-08-16,Enrique Lores,HP,12,23,5,40,
2025-08-16,Donnie King,Tyson Foods,12,23,5,40,
2025-08-16,Lip-Bu Tan,Intel,11,23,6,40,
2025-08-16,Safra Catz,Oracle,12,20,8,40,
2025-08-16,Hock Tan,Broadcom,13,23,4,40,
2025-08-16,John May,Deere,9,27,4,40,
2025-08-16,Elliott Hill,Nike,12,23,5,40,
2025-08-16,Timothy Sweeney,Liberty Mutual Insurance,9,0,0,9,
2025-08-16,Wilfred Chiang,Plains GP,0,1,0,1,
2025-08-16,Juan Andrade,USAA,5,16,0,21,
2025-08-16,Christopher Boerner,Bristol-Myers Squibb,9,28,3,40,
2025-08-16,Paul Bay,Ingram Micro,10,25,5,40,
2025-08-16,Phebe Novakovic,General Dynamics,27,9,4,40,
2025-08-16,James Quincey,Coca-Cola,9,28,3,40,
2025-08-16,Thasunda Brown Duckett,TIAA,19,20,0,39,
2025-08-16,Alan Schnitzer,Travelers,14,18,8,40,
2025-08-16,David Ricks,Eli Lilly,9,22,9,40,
2025-08-16,Dara Khosrowshahi,Uber,13,23,4,40,
2025-08-16,Roger Crandall,Mass Mutual,3,7,0,10,
2025-08-16,Marc Casper,Thermo Fisher Scientific,13,24,3,40,
2025-08-16,Gunjan Kedia,U.S. Bancorp,11,27,2,40,
2025-08-16,Michael Kasbar,World Kinect,2,10,0,12,
2025-08-16,Robert Ford,Abbott Laboratories,15,21,4,40,
2025-08-16,Corie Barry,Best Buy,39,1,0,40,
2025-08-16,Timothy Gerend,Northwestern Mutual,2,1,0,3,
2025-08-16,Kathy Warden,Northrop Grumman,16,20,4,40,
2025-08-16,Joseph Zubretsky,Molina Healthcare,9,22,9,40,
2025-08-16,Todd Vasos,Dollar General,6,20,14,40,
2025-08-16,Robin Vince,Bank of New York,20,17,3,40,
2025-08-16,David Zaslav,Warner Bros. Discovery,7,21,12,40,
2025-08-16,Jay Debertin,CHS,4,8,4,16,
2025-08-16,Ted Sarandos,Netflix,12,25,3,40,
2025-08-16,Cristiano Amon,Qualcomm,13,25,1,39,
2025-08-16,Lawrence Culp Jr.,General Electric,11,25,4,40,
2025-08-16,Vimal Kapur,Honeywell,11,29,0,40,
2025-08-16,Marc Benioff,Salesforce,9,23,8,40,
2025-08-16,Jacek Olczak,Philip Morris,11,24,5,40,
2025-08-16,David Flitman,US Foods,1,6,0,7,
2025-08-16,Paul Romanowski,D.R. Horton,6,15,3,24,
2025-08-16,Bryan DeBoer,Lithia Motors,11,26,3,40,
2025-08-16,Dirk Van de Put,Mondelez,11,25,4,40,
2025-08-16,Brian Niccol,Starbucks,12,28,0,40,
2025-08-16,Ryan McInerney,Visa,16,20,4,40,
2025-08-16,Robert Sulentic,CBRE,1,7,1,9,
2025-08-16,Jonathan Jaffe,Lennar,3,7,0,10,
2025-08-16,Scott Strazik,GE Vernova,11,25,4,40,
2025-08-16,William Demchak,PNC,14,21,5,40,
2025-08-16,Jennifer Rumsey,Cummins,9,26,5,40,
2025-08-16,Preston Feight,Paccar,7,25,1,33,
2025-08-16,Robert Bradway,Amgen,9,28,3,40,
2025-08-16,Matthew Lucey,PBF Energy,6,2,1,9,
2025-08-16,Patrick Geraghty,GuideWell Mutual,0,3,2,5,
2025-08-16,Alex Chriss,PayPal,12,26,2,40,
2025-08-16,Sandy Douglas,United Natural Foods,35,5,0,40,
2025-08-16,Michael Creedon,Jr.,0,14,2,16,
2025-08-16,Leon Topalian,Nucor,15,22,3,40,
2025-08-16,Roger Penske,Penske Automotive,19,20,1,40,
2025-08-16,Bom Kim,Coupang,10,29,1,40,
2025-08-16,Antonio Neri,Hewlett Packard,8,23,9,40,
2025-08-16,Harry Sideris,Duke Energy,35,4,0,39,
2025-08-16,Joseph Bae,KKR,20,18,2,40,
2025-08-16,Brian Robbins,Paramount Global,9,26,1,36,
2025-08-16,Michael Dastoor,Jabil,1,5,0,6,
2025-08-16,Daniel O'Day,Gilead Sciences,18,19,3,40,
2025-08-16,Tim Go,HF Sinclair,7,3,0,10,
2025-08-16,William Nash,CarMax,4,3,2,9,
2025-08-16,Michael Miebach,Mastercard,11,25,4,40,
2025-08-16,Lawrence Coben,NRG Energy,7,2,0,9,
2025-08-16,Sean Kerins,Arrow Electronics,3,12,0,15,
2025-08-16,Lorenzo Simonelli,Baker Hughes,17,19,4,40,
2025-08-16,Robert Jordan,Southwest Airlines,12,19,9,40,
2025-08-16,Peter Zaffino,American International,8,29,3,40,
2025-08-16,Gary Dickerson,Applied Materials,6,22,12,40,
2025-08-16,Vicki Hollub,Occidental Petroleum,17,19,3,39,
2025-08-16,Michael Manley,AutoNation,3,5,1,9,
2025-08-16,Christopher Womack,Southern,2,7,0,9,
2025-08-16,Christopher Swift,Hartford Insurance,6,4,0,10,
2025-08-16,Marc Rowan,Apollo Global Management,15,21,4,40,
2025-08-16,Richard Wurster,Charles Schwab,0,2,0,2,
2025-08-16,Christopher Kempczinski,McDonald's,1,15,4,20,
2025-08-16,Carlos Abrams-Rivera,Kraft Heinz,12,22,6,40,
2025-08-16,Lisa Su,Advanced Micro Devices,18,17,5,40,
2025-08-16,William Rogers Jr.,Truist Financial,0,5,2,7,
2025-08-16,Kathleen Quirk,Freeport-McMoRan,14,17,3,34,
2025-08-16,Sanjay Mehrotra,Micron Technology,19,19,2,40,
2025-08-16,Anthony Capuano,Marriott International,12,24,4,40,
2025-08-16,David Gitlin,Carrier Global,18,21,1,40,
2025-08-16,John Ketchum,NextEra Energy,21,18,1,40,
2025-08-16,William Brown,3M,9,21,3,33,
2025-08-16,John Doyle,Marsh & McLennan,11,8,1,20,
2025-08-16,Patricia Poppe,PG&E,8,15,2,25,
2025-08-16,Jim Vena,Union Pacific,19,21,0,40,
2025-08-16,Brian Doubles,Synchrony Financial,4,7,2,13,
2025-08-16,Rainer Blair,Danaher,5,16,1,22,
2025-08-16,Philip Gallagher,Avnet,1,4,0,5,
2025-08-16,Glenn Fogel,Booking s,0,4,2,6,
2025-08-16,Ezra Yacob,EOG Resources,23,12,0,35,
2025-08-16,Earl Austin Jr.,Quanta Services,0,1,1,2,
2025-08-16,Michael Shepherd,Discover Financial,8,15,2,25,
2025-08-16,Joseph Dominguez,Constellation Energy,15,9,1,25,
2025-08-16,William Stengel II,Genuine Parts,0,4,0,4,
2025-08-16,Christian Ulbrich,Jones Lang LaSalle,8,20,0,28,
2025-08-16,Raymond Scott,Lear Corporation,1,2,0,3,
2025-08-16,Michael Rapino,Live Nation Entertainment,12,24,4,40,
2025-08-16,Heidi Petz,Sherwin-Williams,8,28,3,39,
2025-08-16,Calvin Butler Jr.,Exelon,4,5,1,10,
2025-08-16,Tony Spring,Macy's,11,26,3,40,
2025-08-16,Jeffrey Miller,Halliburton,4,6,0,10,
2025-08-16,Kevin Lobo,Stryker,12,25,3,40,
2025-08-16,Tony Cheng,Reinsurance of America,0,0,0,0,
2025-08-16,Ronald O'Hanley,State Street,7,15,3,25,
2025-08-16,John Engel,WESCO International,5,9,1,15,
2025-08-16,Pierce Norton II,Oneok,6,2,1,9,
2025-08-16,Shantanu Narayen,Adobe,19,20,1,40,
2025-08-16,William Westrate,American Family Insurance,1,0,0,1,
2025-08-16,Christopher Kubasik,L3Harris Technologies,14,23,2,39,
2025-08-16,James Conroy,Ross Stores,4,11,0,15,
2025-08-16,Christine Leahy,CDW,0,10,2,12,
2025-08-16,Saumya Sutaria,Tenet Healthcare,6,3,1,10,
2025-08-16,Robert Eddy,BJ's Wholesale Club,3,5,1,9,
2025-08-16,Michael Lyons,Fiserv,7,23,0,30,
2025-08-16,William Gifford Jr.,Altria,1,9,0,10,
2025-08-16,Laurence Fink,BlackRock,17,16,7,40,
2025-08-16,Thomas Polen,Becton Dickinson,7,3,0,10,
2025-08-16,Noel Wallace,Colgate-Palmolive,9,23,2,34,
2025-08-16,Michael Hsu,Kimberly-Clark,6,6,2,14,
2025-08-16,Daryl Kenningham,1 Automotive,7,24,2,33,
2025-08-16,Jennifer Parmentier,Parker-Hannifin,2,12,0,14,
2025-08-16,Jeffrey Harmening,General Mills,6,18,5,29,
2025-08-16,Ravi Kumar S,Cognizant Technology,9,23,3,35,
2025-08-16,William Fehrman,American Electric Power,4,6,0,10,
2025-08-16,Peter Arduini,GE HealthCare Technologies,6,11,0,17,
2025-08-16,Maria Black,Automatic Data Processing,4,6,0,10,
2025-08-16,Lourenco Goncalves,Cleveland-Cliffs,7,21,12,40,
2025-08-16,Daniel Amos,Aflac,3,3,3,9,
2025-08-16,Mark Stewart,Goodyear Tire & Rubber,4,34,2,40,
2025-08-16,Kevin Hogan,Corebridge Financial,6,11,0,17,
2025-08-16,Thomas Palmer,Newmont,5,5,0,10,
2025-08-16,Andrew Silvernail,International Paper,6,24,0,30,
2025-08-16,Philip Daniele III,AutoZone,0,1,0,1,
2025-08-16,Ellen Cooper,Lincoln National,3,7,0,10,
2025-08-16,Ryan Marshall,Pulte,6,6,8,20,
2025-08-16,James Cracchiolo,Ameriprise Financial,2,23,2,27,
2025-08-16,Andrew Clyde,Murphy USA,14,25,1,40,
2025-08-16,Jonas Prising,Manpower,10,5,1,16,
2025-08-16,David Bozeman,C.H. Robinson Worldwide,2,8,0,10,
2025-08-16,Timothy Knavish,PPG Industries,1,2,0,3,
2025-08-16,Pedro Pizarro,Edison International,15,9,16,40,
2025-08-16,Mark Millett,Steel Dynamics,14,3,0,17,
2025-08-16,Benjamin Tisch,Loews,2,7,0,9,
2025-08-16,Karsanbhai,Emerson Electric,10,18,4,32,
2025-08-16,John Zillmer,Aramark,8,15,2,25,
2025-08-16,William Hornbuckle,MGM Resorts International,5,24,1,30,
2025-08-16,James Burke,Vistra,5,3,0,8,
2025-08-16,David Hult,Asbury Automotive,7,32,1,40,
2025-08-16,DG Macpherson,W.W. Grainger,3,6,1,10,
2025-08-16,Eric Slifka,Global Partners,13,23,4,40,
2025-08-16,Bob Pragada,Jacobs Solutions,6,8,0,14,
2025-08-16,Charles Magro,Corteva,5,3,1,9,
2025-08-16,Rick Lanoha,Peter Kiewit Sons',0,2,0,2,
2025-08-16,Michael Mahoney,Boston Scientific,12,26,1,39,
2025-08-16,Brad Beckham,O'Reilly Automotive,5,15,1,21,
2025-08-16,Thomas Bell,Leidos,7,18,1,26,
2025-08-16,Thomas Gayner,Markel,4,10,2,16,
2025-08-16,Marc Bitzer,Whirlpool,11,15,14,40,
2025-08-16,Andrew McMahon,Guardian Life,6,13,0,19,
2025-08-16,Peter Jackson,Builders FirstSource,5,12,1,18,
2025-08-16,Michael Rhodes,Ally Financial,10,25,5,40,
2025-08-16,Matthew Meloy,Targa Resources,5,5,0,10,
2025-08-16,James Breuer,Fluor,0,2,1,3,
2025-08-16,Sasan Goodarzi,Intuit,11,25,4,40,
2025-08-16,Troy Rudd,AECOM,7,24,5,36,
2025-08-16,Penny Pennington,Edward Jones,7,28,5,40,
2025-08-16,Michael Bender,Kohl's,1,25,14,40,
2025-08-16,Beth Ford,Land O'Lakes,18,21,1,40,
2025-08-16,Deanna Strable-Soethout,Principal Financial,1,7,0,8,
2025-08-16,Robert Blue,Dominion Energy,27,9,2,38,
2025-08-16,Martin Schroeter,Kyndryl s,0,10,0,10,
2025-08-16,Jon Vander Ark,Republic Services,11,20,9,40,
2025-08-16,Clay Gaspar,Devon Energy,20,2,0,22,
2025-08-16,Christopher O'Herlihy,Illinois Tool Works,2,5,2,9,
2025-08-16,Michael O'Grady,Northern Trust,25,7,1,33,
2025-08-16,Jamie Whisnant,Auto-Owners Insurance,0,2,0,2,
2025-08-16,Marc Miller,Universal Health Services,3,19,3,25,
2025-08-16,Darryl Button,Pacific Life,1,6,0,7,
2025-08-16,Hamid Akhavan,EchoStar,4,25,11,40,
2025-08-16,Christophe Beck,Ecolab,18,22,0,40,
2025-08-16,Jack Fusco,Cheniere Energy,18,19,3,40,
2025-08-16,John Wren,Omnicom,9,21,10,40,
2025-08-16,Haviv Ilan,Texas Instruments,13,25,2,40,
2025-08-16,David Burritt,United States Steel,9,17,14,40,
2025-08-16,St√©phane de La Faverie,Est√©e Lauder,13,24,3,40,
2025-08-16,Raul Nicholas Vargas Ochoa,Farmers Insurance Exchange,0,0,0,0,
2025-08-16,Thibaut Mongon,Kenvue,10,27,3,40,
2025-08-16,Ari Bousbib,IQVIA s,0,0,0,0,
2025-08-16,Donald Allan Jr.,Stanley Black & Decker,8,30,2,40,
2025-08-16,Timothy Cofer,Keurig Dr Pepper,2,2,1,5,
2025-08-16,Matthew Flannery,United Rentals,32,2,0,34,
2025-08-16,Timothy Cawley,Consolidated Edison,5,5,0,10,
2025-08-16,Adam Norwitt,Amphenol,1,14,0,15,
2025-08-16,Brent Shafer,Baxter International,1,11,0,12,
2025-08-16,Kimberly Dang,Kinder Morgan,9,1,0,10,
2025-08-16,Erik Nordstrom,Nordstrom,7,28,5,40,
2025-08-16,Frank Holding Jr.,First Citizens BancShares,6,19,1,26,
2025-08-16,Paul Shoukry,Raymond James Financial,14,25,1,40,
2025-08-16,Timothy Archer,Lam Research,2,7,1,10,
2025-08-16,Harry Lawton III,Tractor Supply,1,1,0,2,
2025-08-16,Darren Rebelez,Casey's General Stores,14,24,2,40,
2025-08-16,Scott Smith,Viatris,7,3,0,10,
2025-08-16,James Blackledge,Mutual of Omaha Insurance,0,6,0,6,
2025-08-16,Anthony Guzzi,EMCOR,4,3,0,7,
2025-08-16,Joseph Hinrichs,CSX,5,9,1,15,
2025-08-16,Justin Jude,LKQ,4,6,1,11,
2025-08-16,Judith Marks,Otis Worldwide,2,3,1,6,
2025-08-16,David Bruton Smith,Sonic Automotive,4,9,8,21,
2025-08-16,Martina Cheung,S&P Global,11,24,0,35,
2025-08-16,Leonard Schleifer,Regeneron Pharmaceuticals,5,27,8,40,
2025-08-16,Joseph Fadool,BorgWarner,4,10,0,14,
2025-08-16,Lachlan Murdoch,Fox,5,29,6,40,
2025-08-16,Karla Lewis,Reliance,3,6,1,10,
2025-08-16,John Barrett,Western & Southern Financial,7,31,2,40,
2025-08-16,Scott Donnelly,Textron,9,26,2,37,
2025-08-16,Ariane Gorin,Expedia,8,30,1,39,
2025-08-16,Michael Nolan,Fidelity National Financial,3,0,0,3,
2025-08-16,Ernest Garcia III,Carvana,23,13,4,40,
2025-08-16,Raul Fernandez,DXC Technology,4,34,1,39,
2025-08-16,Robert Berkley Jr.,W.R. Berkley,8,28,4,40,
2025-08-16,Ren√© Jones,M&T Bank,12,23,5,40,
2025-08-16,Lauren Hobart,Dick's Sporting Goods,10,26,4,40,
2025-08-16,Robert Frenzel,Xcel Energy,4,2,1,7,
2025-08-16,Timothy Spence,Fifth Third Bancorp,5,3,1,9,
2025-08-16,Stephen Schwarzman,Blackstone,18,18,4,40,
2025-08-16,Walker Martin,Sempra,0,3,0,3,
2025-08-16,Timothy NeCastro,Erie Insurance,2,7,1,10,
2025-08-16,Wendell Weeks,Corning,14,24,2,40,
2025-08-16,Kathleen Johnson,Lumen Technologies,3,5,1,9,
2025-08-16,Brian Tierney,FirstEnergy,4,19,2,25,
2025-08-16,John Hess,Hess,6,31,2,39,
2025-08-16,Adam Schechter,Labcorp,7,19,1,27,
2025-08-16,Tiang Yew Tan,Western Digital,2,0,0,2,
2025-08-16,Richard McKenney,Unum,4,5,0,9,
2025-08-16,Javier Rodriguez,DaVita,13,13,1,27,
2025-08-16,Steven Cahillane,Kellanova,2,7,0,9,
2025-08-16,Stanley Bergman,Henry Schein,11,28,1,40,
2025-08-16,Robert Sanchez,Ryder System,10,11,1,22,
2025-08-16,Tim Hingtgen,Community Health Systems,11,27,2,40,
2025-08-16,Avigal Soreq,Delek US,2,11,5,18,
2025-08-16,Gerardo Norcia,DTE Energy,8,2,0,10,
2025-08-16,Mark Pearson,Equitable,8,8,0,16,
2025-08-16,Lori Koch,DuPont,8,19,0,27,
2025-08-16,Rich Steinmeier,LPL Financial,23,15,2,40,
2025-08-16,Bruce Van Saun,Citizens Financial,12,27,1,40,
2025-08-16,Jos√© Mas,MasTec,7,14,2,23,
2025-08-16,Andr√©s Gluski,AES,16,23,0,39,
2025-08-16,Kevin Kwilinski,Berry Global,8,19,0,27,
2025-08-16,Jean-Marc Gilson,Westlake,5,5,0,10,
2025-08-16,Mark George,Norfolk Southern,15,22,3,40,
2025-08-16,Eduardo Menezes,Air Products & Chemicals,3,6,1,10,
2025-08-16,Shelley Simpson,J.B. Hunt Transport Services,6,31,3,40,
2025-08-16,Daniel Fisher,Ball,3,20,4,27,
2025-08-16,Sean Connolly,Conagra Brands,7,31,2,40,
2025-08-16,Stephen Steinour,Huntington Bancshares,2,8,0,10,
2025-08-16,James Snee,Hormel Foods,3,30,1,34,
2025-08-16,Joseph Nolan Jr.,Eversource Energy,2,1,0,3,
2025-08-16,William Oplinger,Alcoa,6,18,5,29,
2025-08-16,Andrew Marsh,Entergy,3,5,0,8,
2025-08-16,Keith Demmings,Assurant,4,7,0,11,
2025-08-16,Sumit Singh,Chewy,15,21,4,40,
2025-08-16,Niraj Shah,Wayfair,7,25,8,40,
2025-08-16,Joseph Ferraro,Avis Budget,3,6,1,10,
2025-08-16,Jeffrey Sprecher,Intercontinental Exchange,14,23,3,40,
2025-08-16,Benito Minicucci,Alaska Air,2,6,1,9,
2025-08-16,Malcolm Wilson,GXO Logistics,7,24,0,31,
2025-08-16,Eric Hansotia,AGCO,16,18,1,35,
2025-08-16,Kathleen Mazzarella,Graybar Electric,1,9,0,10,
2025-08-16,Gavin Hattersley,Molson Coors Beverage,2,31,7,40,
2025-08-16,Patrick Gallagher Jr.,Arthur J. Gallagher,9,28,3,40,
2025-08-16,Christopher Kastner,Huntington Ingalls Industries,2,4,1,7,
2025-08-16,Erik Fyrwald,International Flavors & Fragrances,7,8,2,17,
2025-08-16,Ricardo Cardenas,Darden Restaurants,3,4,1,8,
2025-08-16,Stephen Spray,Cincinnati Financial,1,4,4,9,
2025-08-16,Scott Boatwright,Chipotle Mexican Grill,7,29,4,40,
2025-08-16,Joey Wat,Yum China,12,26,2,40,
2025-08-16,Robert Goldstein,Las Vegas Sands,3,32,5,40,
2025-08-16,Kecia Steelman,Ulta Beauty,32,7,1,40,
2025-08-16,Thomas Reeg,Caesars Entertainment,5,5,1,11,
2025-08-16,Jon Rousseau,BrightSpring Health Services,20,19,1,40,
2025-08-16,William Krueger,Andersons,0,4,0,4,
2025-08-16,Michele Buck,Hershey,9,29,2,40,
2025-08-16,Christopher Nassetta,Hilton,16,21,3,40,
2025-08-16,Bruce Bodine,Mosaic,3,7,0,10,
2025-08-16,Brian Chesky,Airbnb,2,31,7,40,
2025-08-16,Kaes Van‚Äôt Hof,Diamondback Energy,24,13,2,39,
2025-08-16,Steven Vondran,American Tower,4,7,0,11,
2025-08-16,Reshma Kewalramani,Vertex Pharmaceuticals,21,16,3,40,
2025-08-16,William McDermott,ServiceNow,3,6,0,9,
2025-08-16,Brian Chambers,Owens Corning,3,12,1,16,
2025-08-16,Teresa Rasmussen,Thrivent Financial for Lutherans,3,2,0,5,
2025-08-16,Shane O'Kelly,Advance Auto Parts,16,21,3,40,
2025-08-16,Douglas Yearley Jr.,Toll Brothers,2,11,3,16,
2025-08-16,Jeffrey Lorberbaum,Mohawk Industries,10,5,1,16,
2025-08-16,Gregory Brown,Motorola Solutions,1,8,0,9,
2025-08-16,John Pfeifer,Oshkosh,6,26,4,36,
2025-08-16,Tony Xu,DoorDash,13,20,7,40,
2025-08-16,Edward Pesicka,Owens & Minor,2,28,2,32,
2025-08-16,Eugene Bredow,NVR,0,4,0,4,
2025-08-16,Philippe Krakowsky,Interpublic,15,21,4,40,
2025-08-16,Horacio Rozanski,Booz Allen Hamilton,16,19,5,40,
2025-08-16,Michael O‚ÄôSullivan,Burlington Stores,9,29,2,40,
2025-08-16,Daniel Wall,Expeditors International of Washington,4,3,0,7,
2025-08-16,Calvin McDonald,Lululemon athletica,9,30,1,40,
2025-08-16,Stephanie Ferris,Fidelity National Information,13,21,4,38,
2025-08-16,Richard Handler,Jefferies Financial,5,7,7,19,
2025-08-16,Alan Armstrong,Williams,22,13,5,40,
2025-08-16,Bracken Darrell,VF Corporation,8,28,4,40,
2025-08-16,Mikael Bratt,Autoliv,7,8,2,17,
2025-08-16,Rafael Santana,Westinghouse Air Brake Technologies,5,6,0,11,
2025-08-16,Ralph LaRossa,Public Service Enterprise,8,15,0,23,
2025-08-16,Jamie Iannone,Ebay,18,18,4,40,
2025-08-16,Scott Richardson,Celanese,7,29,4,40,
2025-08-16,Cameron Bready,Global Payments,8,29,3,40,
2025-08-16,Robert Thomson,News Corp.,6,27,6,39,
2025-08-16,Robert Martin,THOR Industries,4,5,1,10,
2025-08-16,David Rawlinson II,QVC,6,13,2,21,
2025-08-16,Andrew Teno,Icahn Enterprises,5,6,0,11,
2025-08-16,William Newlands,Constellation Brands,0,2,2,4,
2025-08-16,James Davis,Quest Diagnostics,4,5,1,10,
2025-08-16,Richard Wallace,KLA,2,4,0,6,
2025-08-16,Julian Francis,QXO Building Products,0,0,0,0,
2025-08-16,John Christmann IV,APA,4,5,1,10,
2025-08-16,Gregory Roberts,A-Mark Precious Metals,2,2,1,5,
2025-08-16,Christopher Viehbacher,Biogen,0,29,2,31,
2025-08-16,Mick Beekhuizen,Campbell's,6,23,3,32,
2025-08-16,Christopher Caldwell,Concentrix,2,6,0,8,
2025-08-16,Todd Schneider,Cintas,11,17,1,29,
2025-08-16,Tony Sarsam,SpartanNash,17,21,2,40,
2025-08-16,John Venhuizen,Ace Hardware,16,23,1,40,
2025-08-16,Vincent Roche,Analog Devices,14,23,3,40,
2025-08-16,Mark Costa,Eastman Chemical,7,17,4,28,
2025-08-16,Milan Galik,Interactive Brokers,6,15,0,21,
2025-08-16,John Turner Jr.,Regions Financial,2,8,0,10,
2025-08-16,Joanna Geraghty,JetBlue Airways,17,16,7,40,
2025-08-16,Kristin Peck,Zoetis,11,18,1,30,
2025-08-16,Christopher Gorman,KeyCorp,4,5,0,9,
2025-08-16,Mark Bertolini,Oscar Health,13,18,8,39,
2025-08-16,Brendan McCracken,Ovintiv,5,5,1,11,
2025-08-16,Robert Steer,Seaboard,1,4,0,5,
2025-08-16,Gil West,Hertz,7,25,8,40,
2025-08-16,Robert Greenberg,Skechers,7,31,2,40,
2025-08-16,Dennis Mathew,Altice,5,26,7,38,
2025-08-16,Clay Williams,NOV,9,17,3,29,
2025-08-16,Michael Doss,Graphic Packaging,6,8,1,15,
2025-08-16,Deon Stander,Avery Dennison,0,11,0,11,
2025-08-16,Adaire Fox-Martin,Equinix,15,20,3,38,
2025-08-16,Joyce Mullen,Insight Enterprises,6,12,1,19,
2025-08-16,Jennifer Witz,Sirius XM,6,14,5,25,
2025-08-16,Stefan Larsson,PVH,10,24,6,40,
2025-08-16,Jason Wells,CenterPoint Energy,22,12,6,40,
2025-08-16,Scott Lauber,WEC Energy,16,5,0,21,
2025-08-16,Matthew Pine,Xylem,2,10,1,13,
2025-08-16,Jennifer Johnson,Franklin Resources,1,8,1,10,
2025-08-16,Vincent Sorgi,PPL,9,10,1,20,
2025-08-16,Carl Eschenbach,Workday,11,19,10,40,
2025-08-16,Richard Tobin,Dover,3,6,1,10,
2025-08-16,Mark Kowlzan,Packaging Corp. of America,1,10,1,12,
2025-08-16,Scott Salmirs,ABM Industries,5,7,1,13,
2025-08-16,Gary Guthart,Intuitive Surgical,11,25,4,40,
2025-08-16,Carl Lindner lll,American Financial,0,0,0,0,
2025-08-16,Blake Moret,Rockwell Automation,11,27,1,39,
2025-08-16,Bryan Hanson,Solventum,6,11,2,19,
2025-08-16,Craig Smiddy,Old Republic International,3,6,1,10,
2025-08-16,Christopher Hilger,Securian Financial,0,6,0,6,
2025-08-16,Hamid Moghadam,Prologis,7,27,6,40,
2025-08-16,Mark Smucker,J.M. Smucker,10,24,6,40,
2025-08-16,Sheryl Palmer,Taylor Morrison Home,5,13,1,19,
2025-08-16,Mario Harik,XPO,7,32,1,40,
2025-08-16,Heather Lavallee,Voya Financial,7,9,2,18,
2025-08-16,Nikesh Arora,Palo Alto Networks,9,23,8,40,
2025-08-16,Giordano Albertazzi,Vertiv s,0,1,0,1,
2025-08-16,Shankh Mitra,Welltower,17,21,2,40,
2025-08-16,Mary Dillon,Foot Locker,10,24,6,40,
2025-08-16,William Monteleone,Par Pacific,2,6,1,9,
2025-08-16,Kevin Stein,TransDigm,9,10,2,21,
2025-08-16,Peter Matt,Commercial Metals,5,4,0,9,
2025-08-16,Robert Vitale,Post s,0,0,0,0,
2025-08-16,Keith Allman,Masco,6,9,1,16,
2025-08-16,Rusty Rush,Rush Enterprises,17,20,3,40,
2025-08-16,Stuart Bradie,KBR,15,17,4,36,
2025-08-16,Jack Sinclair,Sprouts Farmers Market,14,25,1,40,
2025-08-16,Laura Alber,Williams-Sonoma,11,23,6,40,
2025-08-16,Ivan Tornos,Zimmer Biomet s,1,2,0,3,
2025-08-16,John Mengucci,CACI International,21,17,2,40,
2025-08-16,Steve Sanghi,Microchip Technology,7,29,4,40,
2025-08-16,Albert Nahmad,Watsco,2,6,2,10,
2025-08-16,Christopher Peterson,Newell Brands,1,7,2,10,
2025-08-16,Arie Kotler,ARKO,5,23,1,29,
2025-08-16,Jure Sola,Sanmina,3,14,0,17,
2025-08-16,Andrew Wilson,Electronic Arts,14,18,8,40,
2025-08-16,David Gibbs,Yum Brands,2,37,1,40,
2025-08-16,Daniel Florness,Fastenal,3,6,1,10,
2025-08-16,Garrick Rochow,CMS Energy,12,3,0,15,
2025-08-16,Rodney Sacks,Monster Beverage,15,23,1,39,
2025-08-16,Mark Shapiro,Endeavor,5,34,1,40,
2025-08-16,Toni Townes-Whitley,Science Applications International,12,19,1,32,
2025-08-16,Mark Witkowski,Core & Main,1,6,1,8,
2025-08-16,John Plant,Howmet Aerospace,5,19,2,26,
2025-08-16,James Zallie,Ingredion,5,5,1,11,
2025-08-16,Thomas Hill,Vulcan Materials,4,8,2,14,
2025-08-17,Doug McMillon,Walmart,14,20,6,40,
2025-08-17,Andrew Jassy,Amazon,6,28,6,40,
2025-08-17,Stephen Hemsley,UnitedHealth,8,25,7,40,
2025-08-17,Tim Cook,Apple,16,22,2,40,
2025-08-17,David Joyner,CVS Health,7,29,4,40,
2025-08-17,Warren Buffett,Berkshire Hathaway,11,27,2,40,
2025-08-17,Sundar Pichai,Alphabet,18,17,5,40,
2025-08-17,Darren Woods,Exxon Mobil,12,20,7,39,
2025-08-17,Brian Tyler,McKesson,4,14,4,22,
2025-08-17,Robert Mauch,Cencora,4,6,0,10,
2025-08-17,Jamie Dimon,JPMorgan Chase,11,18,11,40,
2025-08-17,Ron Vachris,Costco,5,32,3,40,
2025-08-17,David Cordani,Cigna,21,16,3,40,
2025-08-17,Satya Nadella,Microsoft,13,18,9,40,
2025-08-17,Jason Hollar,Cardinal Health,14,21,5,40,
2025-08-17,Mike Wirth,Chevron,16,18,6,40,
2025-08-17,Brian Moynihan,Bank of America,4,29,7,40,
2025-08-17,Mary Barra,General Motors,11,25,4,40,
2025-08-17,Jim Farley,Ford Motor,13,22,5,40,
2025-08-17,Gail Boudreaux,Elevance Health,15,18,7,40,
2025-08-17,Jane Fraser,Citi,11,23,6,40,
2025-08-17,Mark Zuckerberg,Meta,13,22,5,40,
2025-08-17,Sarah London,Centene,11,21,8,40,
2025-08-17,Ted Decker,Home Depot,10,28,2,40,
2025-08-17,Priscilla Almodovar,Fannie Mae,10,16,13,39,
2025-08-17,Tim Wentworth,Walgreens,8,21,10,39,
2025-08-17,Ron Sargent,Kroger,5,21,14,40,
2025-08-17,Mark Lashier,Phillips 66,9,20,9,38,
2025-08-17,Maryann Mannen,Marathon Petroleum,6,14,1,21,
2025-08-17,Hans Vestberg,Verizon,18,18,4,40,
2025-08-17,Jensen Huang,Nvidia,14,20,6,40,
2025-08-17,David Solomon,Goldman Sachs,2,21,17,40,
2025-08-17,Charles Scharf,Wells Fargo,29,7,4,40,
2025-08-17,Lane Riggs,Valero Energy,13,8,0,21,
2025-08-17,Brian Roberts,Comcast,11,27,2,40,
2025-08-17,Jon Farney,State Farm,10,27,3,40,
2025-08-17,John Stankey,AT&T,11,23,6,40,
2025-08-17,Michael Hutchins,Freddie Mac,3,11,3,17,
2025-08-17,Jim Rechtin,Humana,18,18,4,40,
2025-08-17,Ted Pick,Morgan Stanley,17,21,2,40,
2025-08-17,Brian Cornell,Target,7,21,12,40,
2025-08-17,Philip Smith,StoneX,0,9,1,10,
2025-08-17,Elon Musk,Tesla,12,16,12,40,
2025-08-17,Michael Dell,Dell Technologies,12,25,3,40,
2025-08-17,Ramon Laguarta,PepsiCo,9,27,4,40,
2025-08-17,Bob Iger,Walt Disney,11,26,3,40,
2025-08-17,Carol Tom√©,UPS,9,20,11,40,
2025-08-17,Joaquin Duato,Johnson & Johnson,8,27,5,40,
2025-08-17,Rajesh Subramaniam,FedEx,10,23,0,33,
2025-08-17,Juan Luciano,Archer Daniels Midland,3,21,16,40,
2025-08-17,Jon Moeller,Procter & Gamble,4,31,5,40,
2025-08-17,Marvin Ellison,Lowe's,17,17,6,40,
2025-08-17,Thomas Long,Energy Transfer,9,0,1,10,
2025-08-17,Christopher Calio,RTX,6,10,0,16,
2025-08-17,Susan Morris,Albertsons,9,27,4,40,
2025-08-17,Kevin Hourican,Sysco,10,27,3,40,
2025-08-17,Tricia Griffith,Progressive,12,23,4,39,
2025-08-17,Stephen Squeri,American Express,14,24,2,40,
2025-08-17,James Taiclet,Lockheed Martin,11,18,11,40,
2025-08-17,Michel Khalaf,MetLife,11,17,0,28,
2025-08-17,Samuel Hazen,HCA Healthcare,8,6,0,14,
2025-08-17,Andrew Sullivan,Prudential Financial,14,24,0,38,
2025-08-17,Kelly Ortberg,Boeing,14,21,5,40,
2025-08-17,Joe Creed,Caterpillar,10,26,3,39,
2025-08-17,Robert M Davis,Merck,4,19,0,23,
2025-08-17,Thomas J Wilson,Allstate,1,11,1,13,
2025-08-17,Albert Bourla,Pfizer,21,12,7,40,
2025-08-17,Arvind Krishna,IBM,15,19,6,40,
2025-08-17,Craig DeSanto,New York Life Insurance,4,14,0,18,
2025-08-17,Ed Bastian,Delta Airlines,16,14,9,39,
2025-08-17,Kevin Murphy,Ferguson,7,25,3,35,
2025-08-17,Kirt Walker,Nationwide,15,17,2,34,
2025-08-17,Patrick Zammit,TD Synnex,9,16,0,25,
2025-08-17,Scott Kirby,United Airlines,35,3,2,40,
2025-08-17,Ryan Lance,ConocoPhillips,18,19,3,40,
2025-08-17,Ernie Herrman,TJX,17,22,1,40,
2025-08-17,Bob Michael,AbbVie,0,0,0,0,
2025-08-17,AJ Jim Teague,Enterprise Products Partners,6,8,0,14,
2025-08-17,Christopher Winfrey,Charter Communications,5,14,5,24,
2025-08-17,George Holm,Performance Food,10,22,2,34,
2025-08-17,Robert Isom,American Airlines,8,24,8,40,
2025-08-17,Richard Fairbank,Capital One,14,22,4,40,
2025-08-17,Chuck Robbins,Cisco Systems,12,23,5,40,
2025-08-17,Enrique Lores,HP,12,23,5,40,
2025-08-17,Donnie King,Tyson Foods,10,25,5,40,
2025-08-17,Lip-Bu Tan,Intel,8,22,10,40,
2025-08-17,Safra Catz,Oracle,13,19,8,40,
2025-08-17,Hock Tan,Broadcom,12,24,4,40,
2025-08-17,John May,Deere,8,28,4,40,
2025-08-17,Elliott Hill,Nike,12,24,4,40,
2025-08-17,Timothy M Sweeney,Liberty Mutual Insurance,14,0,0,14,
2025-08-17,Wilfred Chiang,Plains GP,1,1,0,2,
2025-08-17,Juan Andrade,USAA,5,16,0,21,
2025-08-17,Chris Boerner,Bristol-Myers Squibb,10,23,7,40,
2025-08-17,Paul Bay,Ingram Micro,11,24,5,40,
2025-08-17,Phebe Novakovic,General Dynamics,27,9,4,40,
2025-08-17,James Quincey,Coca-Cola,10,28,2,40,
2025-08-17,Thasunda Brown Duckett,TIAA,19,20,0,39,
2025-08-17,Alan Schnitzer,Travelers,14,18,8,40,
2025-08-17,David Ricks,Eli Lilly,9,22,9,40,
2025-08-17,Dara Khosrowshahi,Uber,13,23,4,40,
2025-08-17,Roger Crandall,Mass Mutual,3,7,0,10,
2025-08-17,Marc Casper,Thermo Fisher Scientific,13,24,3,40,
2025-08-17,Gunjan Kedia,US Bancorp,10,27,3,40,
2025-08-17,Michael Kasbar,World Kinect,2,10,0,12,
2025-08-17,Robert Ford,Abbott Laboratories,14,22,4,40,
2025-08-17,Corie Barry,Best Buy,39,1,0,40,
2025-08-17,Tim Gerend,Northwestern Mutual,14,25,1,40,
2025-08-17,Kathy Warden,Northrop Grumman,17,18,5,40,
2025-08-17,Joe Zubretsky,Molina Healthcare,7,6,4,17,
2025-08-17,Todd Vasos,Dollar General,6,22,12,40,
2025-08-17,Robin Vince,Bank of New York,20,17,3,40,
2025-08-17,David Zaslav,Warner Bros Discovery,7,21,12,40,
2025-08-17,Jay Debertin,CHS,4,8,4,16,
2025-08-17,Ted Sarandos,Netflix,12,26,2,40,
2025-08-17,Cristiano Amon,Qualcomm,13,25,1,39,
2025-08-17,Larry Culp,General Electric,12,25,3,40,
2025-08-17,Vimal Kapur,Honeywell,12,28,0,40,
2025-08-17,Marc Benioff,Salesforce,9,23,8,40,
2025-08-17,Jacek Olczak,Philip Morris,12,24,4,40,
2025-08-17,David Flitman,US Foods,1,7,0,8,
2025-08-17,Paul Romanowski,DR Horton,6,15,3,24,
2025-08-17,Bryan DeBoer,Lithia Motors,12,27,1,40,
2025-08-17,Dirk Van de Put,Mondelez,14,23,3,40,
2025-08-17,Brian Niccol,Starbucks,11,29,0,40,
2025-08-17,Ryan McInerney,Visa,15,22,3,40,
2025-08-17,Robert Sulentic,CBRE,1,7,1,9,
2025-08-17,Jonathan Jaffe,Lennar,2,7,1,10,
2025-08-17,Scott Strazik,GE Vernova,11,25,4,40,
2025-08-17,William Demchak,PNC,14,21,5,40,
2025-08-17,Jennifer Rumsey,Cummins,8,27,5,40,
2025-08-17,Preston Feight,Paccar,8,28,2,38,
2025-08-17,Robert Bradway,Amgen,9,28,3,40,
2025-08-17,Matthew Lucey,PBF Energy,6,2,1,9,
2025-08-17,Pat Geraghty,GuideWell Mutual,2,7,0,9,
2025-08-17,Alex Chriss,PayPal,13,25,2,40,
2025-08-17,Sandy Douglas,United Natural Foods,35,5,0,40,
2025-08-17,Michael Creedon,Dollar Tree,3,35,2,40,
2025-08-17,Leon Topalian,Nucor,16,21,3,40,
2025-08-17,Roger Penske,Penske Automotive,18,21,1,40,
2025-08-17,Bom Kim,Coupang,10,29,1,40,
2025-08-17,Antonio Neri,Hewlett Packard,8,22,10,40,
2025-08-17,Harry Sideris,Duke Energy,35,4,0,39,
2025-08-17,Joseph Bae,KKR,20,18,2,40,
2025-08-17,Brian Robbins,Paramount Global,7,28,1,36,
2025-08-17,Michael Dastoor,Jabil,1,5,0,6,
2025-08-17,Daniel O'Day,Gilead Sciences,19,18,3,40,
2025-08-17,Tim Go,HF Sinclair,6,4,0,10,
2025-08-17,William Nash,CarMax,4,3,2,9,
2025-08-17,Michael Miebach,Mastercard,12,25,3,40,
2025-08-17,Lawrence Coben,NRG Energy,7,2,0,9,
2025-08-17,Sean Kerins,Arrow Electronics,3,12,0,15,
2025-08-17,Lorenzo Simonelli,Baker Hughes,17,19,4,40,
2025-08-17,Bob Jordan,Southwest Airlines,12,22,6,40,
2025-08-17,Peter Zaffino,American International,8,29,3,40,
2025-08-17,Gary Dickerson,Applied Materials,8,20,12,40,
2025-08-17,Vicki Hollub,Occidental Petroleum,17,19,3,39,
2025-08-17,Michael Manley,AutoNation,3,6,1,10,
2025-08-17,Christopher Womack,Southern,2,7,0,9,
2025-08-17,Christopher Swift,Hartford Insurance,6,4,0,10,
2025-08-17,Marc Rowan,Apollo Global Management,15,21,4,40,
2025-08-17,Rick Wurster,Charles Schwab,14,21,4,39,
2025-08-17,Chris Kempczinski,McDonald's,13,18,9,40,
2025-08-17,Carlos Abrams-Rivera,Kraft Heinz,12,22,6,40,
2025-08-17,Lisa Su,Advanced Micro Devices,17,18,5,40,
2025-08-17,William H Rogers Jr,Truist Financial,2,8,0,10,
2025-08-17,Kathleen Quirk,Freeport-McMoRan,14,18,3,35,
2025-08-17,Sanjay Mehrotra,Micron Technology,19,19,2,40,
2025-08-17,Anthony Capuano,Marriott International,12,25,3,40,
2025-08-17,David Gitlin,Carrier Global,18,21,1,40,
2025-08-17,John Ketchum,NextEra Energy,21,18,1,40,
2025-08-17,William M Brown,3M,2,8,0,10,
2025-08-17,John Doyle,Marsh & McLennan,12,8,1,21,
2025-08-17,Patricia Poppe,PG&E,8,15,2,25,
2025-08-17,Jim Vena,Union Pacific,18,21,0,39,
2025-08-17,Brian Doubles,Synchrony Financial,4,7,2,13,
2025-08-17,Rainer Blair,Danaher,6,15,1,22,
2025-08-17,Philip Gallagher,Avnet,1,5,0,6,
2025-08-17,Glenn Fogel,Booking s,0,4,1,5,
2025-08-17,Ezra Yacob,EOG Resources,23,12,0,35,
2025-08-17,Earl Austin,Quanta Services,3,4,1,8,
2025-08-17,Michael Shepherd,Discover Financial,9,14,2,25,
2025-08-17,Joseph Dominguez,Constellation Energy,15,9,1,25,
2025-08-17,William Stengel II,Genuine Parts,0,4,0,4,
2025-08-17,Christian Ulbrich,Jones Lang LaSalle,8,19,0,27,
2025-08-17,Raymond E Scott,Lear Corporation,6,3,0,9,
2025-08-17,Michael Rapino,Live Nation Entertainment,12,24,4,40,
2025-08-17,Heidi Petz,Sherwin-Williams,8,28,3,39,
2025-08-17,Calvin G Butler Jr,Exelon,6,5,0,11,
2025-08-17,Tony Spring,Macy's,10,26,4,40,
2025-08-17,Jeff Miller,Halliburton,16,20,4,40,
2025-08-17,Kevin Lobo,Stryker,11,26,3,40,
2025-08-17,Tony Cheng,Reinsurance of America,0,0,0,0,
2025-08-17,Ronald P O'Hanley,State Street,5,15,0,20,
2025-08-17,John Engel,WESCO International,5,9,1,15,
2025-08-17,Pierce Norton II,Oneok,5,3,1,9,
2025-08-17,Shantanu Narayen,Adobe,19,20,1,40,
2025-08-17,Bill Westrate,American Family Insurance,10,16,2,28,
2025-08-17,Chris Kubasik,L3Harris Technologies,5,14,1,20,
2025-08-17,James Conroy,Ross Stores,4,11,0,15,
2025-08-17,Christine Leahy,CDW,0,9,2,11,
2025-08-17,Saumya Sutaria,Tenet Healthcare,5,4,1,10,
2025-08-17,Bob Eddy,BJ's Wholesale Club,6,32,2,40,
2025-08-17,Mike Lyons,Fiserv,4,10,0,14,
2025-08-17,William Gifford,Altria,2,6,1,9,
2025-08-17,Laurence Fink,BlackRock,18,15,7,40,
2025-08-17,Thomas Polen,Becton Dickinson,7,3,0,10,
2025-08-17,Noel Wallace,Colgate-Palmolive,9,24,2,35,
2025-08-17,Michael Hsu,Kimberly-Clark,6,6,2,14,
2025-08-17,Daryl Kenningham,1 Automotive,8,21,1,30,
2025-08-17,Jennifer Parmentier,Parker-Hannifin,2,12,0,14,
2025-08-17,Jeffrey Harmening,General Mills,6,17,5,28,
2025-08-17,Ravi Kumar S,Cognizant Technology,9,24,3,36,
2025-08-17,William Fehrman,American Electric Power,4,6,0,10,
2025-08-17,Peter Arduini,GE HealthCare Technologies,6,11,0,17,
2025-08-17,Maria Black,Automatic Data Processing,4,5,0,9,
2025-08-17,Lourenco Goncalves,Cleveland-Cliffs,7,21,12,40,
2025-08-17,Daniel Amos,Aflac,3,3,3,9,
2025-08-17,Mark Stewart,Goodyear Tire & Rubber,4,34,2,40,
2025-08-17,Kevin Hogan,Corebridge Financial,5,12,0,17,
2025-08-17,Thomas Palmer,Newmont,4,6,0,10,
2025-08-17,Andrew Silvernail,International Paper,6,23,0,29,
2025-08-17,Philip Daniele III,AutoZone,0,1,0,1,
2025-08-17,Ellen Cooper,Lincoln National,4,6,0,10,
2025-08-17,Ryan Marshall,Pulte,7,6,8,21,
2025-08-17,James Cracchiolo,Ameriprise Financial,2,24,2,28,
2025-08-17,Andrew Clyde,Murphy USA,15,24,1,40,
2025-08-17,Jonas Prising,Manpower,10,6,1,17,
2025-08-17,David Bozeman,CH Robinson Worldwide,2,7,1,10,
2025-08-17,Timothy Knavish,PPG Industries,1,2,0,3,
2025-08-17,Pedro Pizarro,Edison International,14,9,17,40,
2025-08-17,Mark Millett,Steel Dynamics,15,3,0,18,
2025-08-17,Benjamin Tisch,Loews,2,7,0,9,
2025-08-17,Karsanbhai,Emerson Electric,11,18,3,32,
2025-08-17,John Zillmer,Aramark,8,15,2,25,
2025-08-17,William Hornbuckle,MGM Resorts International,5,25,1,31,
2025-08-17,James Burke,Vistra,6,2,0,8,
2025-08-17,David Hult,Asbury Automotive,8,31,1,40,
2025-08-17,DG Macpherson,WW Grainger,3,6,1,10,
2025-08-17,Eric Slifka,Global Partners,14,22,4,40,
2025-08-17,Bob Pragada,Jacobs Solutions,6,8,0,14,
2025-08-17,Charles Magro,Corteva,5,3,1,9,
2025-08-17,Rick Lanoha,Peter Kiewit Sons',0,2,0,2,
2025-08-17,Michael Mahoney,Boston Scientific,11,26,1,38,
2025-08-17,Brad Beckham,O'Reilly Automotive,5,15,1,21,
2025-08-17,Thomas Bell,Leidos,7,18,1,26,
2025-08-17,Thomas Gayner,Markel,4,10,2,16,
2025-08-17,Marc Bitzer,Whirlpool,11,15,14,40,
2025-08-17,Andrew McMahon,Guardian Life,5,13,0,18,
2025-08-17,Peter Jackson,Builders FirstSource,5,12,1,18,
2025-08-17,Michael Rhodes,Ally Financial,10,24,5,39,
2025-08-17,Matthew Meloy,Targa Resources,5,5,0,10,
2025-08-17,James Breuer,Fluor,1,2,1,4,
2025-08-17,Sasan Goodarzi,Intuit,10,26,4,40,
2025-08-17,Troy Rudd,AECOM,7,23,5,35,
2025-08-17,Penny Pennington,Edward Jones,6,29,5,40,
2025-08-17,Michael Bender,Kohl's,1,25,14,40,
2025-08-17,Beth Ford,Land O'Lakes,17,22,1,40,
2025-08-17,Deanna Strable-Soethout,Principal Financial,1,7,0,8,
2025-08-17,Robert Blue,Dominion Energy,27,9,2,38,
2025-08-17,Martin Schroeter,Kyndryl s,0,10,0,10,
2025-08-17,Jon Vander Ark,Republic Services,10,20,10,40,
2025-08-17,Clay Gaspar,Devon Energy,19,3,0,22,
2025-08-17,Christopher O'Herlihy,Illinois Tool Works,2,5,2,9,
2025-08-17,Michael O'Grady,Northern Trust,25,7,1,33,
2025-08-17,Jamie Whisnant,Auto-Owners Insurance,0,2,0,2,
2025-08-17,Marc Miller,Universal Health Services,3,20,3,26,
2025-08-17,Darryl Button,Pacific Life,1,6,0,7,
2025-08-17,Hamid Akhavan,EchoStar,3,22,8,33,
2025-08-17,Christophe Beck,Ecolab,18,22,0,40,
2025-08-17,Jack Fusco,Cheniere Energy,17,20,3,40,
2025-08-17,John Wren,Omnicom,9,21,10,40,
2025-08-17,Haviv Ilan,Texas Instruments,12,26,2,40,
2025-08-17,David Burritt,United States Steel,9,16,15,40,
2025-08-17,St√©phane de La Faverie,Est√©e Lauder,12,25,3,40,
2025-08-17,Raul Nicholas Vargas Ochoa,Farmers Insurance Exchange,0,0,0,0,
2025-08-17,Thibaut Mongon,Kenvue,8,29,3,40,
2025-08-17,Ari Bousbib,IQVIA s,0,0,0,0,
2025-08-17,Donald Allan,Stanley Black & Decker,10,29,1,40,
2025-08-17,Timothy Cofer,Keurig Dr Pepper,2,2,1,5,
2025-08-17,Matthew Flannery,United Rentals,32,3,0,35,
2025-08-17,Timothy Cawley,Consolidated Edison,5,5,0,10,
2025-08-17,Adam Norwitt,Amphenol,2,14,0,16,
2025-08-17,Brent Shafer,Baxter International,1,11,0,12,
2025-08-17,Kimberly Dang,Kinder Morgan,9,1,0,10,
2025-08-17,Erik Nordstrom,Nordstrom,7,27,5,39,
2025-08-17,Frank Holding,First Citizens BancShares,10,16,2,28,
2025-08-17,Paul Shoukry,Raymond James Financial,14,25,1,40,
2025-08-17,Timothy Archer,Lam Research,2,7,1,10,
2025-08-17,Harry Lawton III,Tractor Supply,1,1,0,2,
2025-08-17,Darren Rebelez,Casey's General Stores,14,24,2,40,
2025-08-17,Scott Smith,Viatris,7,3,0,10,
2025-08-17,James Blackledge,Mutual of Omaha Insurance,0,6,0,6,
2025-08-17,Anthony Guzzi,EMCOR,4,3,0,7,
2025-08-17,Joseph Hinrichs,CSX,5,9,1,15,
2025-08-17,Justin Jude,LKQ,4,6,1,11,
2025-08-17,Judith Marks,Otis Worldwide,3,3,1,7,
2025-08-17,David Bruton Smith,Sonic Automotive,4,9,8,21,
2025-08-17,Martina Cheung,S&P Global,11,24,0,35,
2025-08-17,Leonard Schleifer,Regeneron Pharmaceuticals,5,27,8,40,
2025-08-17,Joseph Fadool,BorgWarner,4,11,0,15,
2025-08-17,Lachlan Murdoch,Fox,4,30,6,40,
2025-08-17,Karla Lewis,Reliance,4,5,1,10,
2025-08-17,John Barrett,Western & Southern Financial,7,31,2,40,
2025-08-17,Scott Donnelly,Textron,9,28,3,40,
2025-08-17,Ariane Gorin,Expedia,9,29,1,39,
2025-08-17,Michael Nolan,Fidelity National Financial,4,0,0,4,
2025-08-17,Ernest Garcia III,Carvana,23,13,4,40,
2025-08-17,Raul Fernandez,DXC Technology,4,34,1,39,
2025-08-17,Robert Berkley,WR Berkley,8,28,4,40,
2025-08-17,Ren√© Jones,M&T Bank,12,24,4,40,
2025-08-17,Lauren Hobart,Dick's Sporting Goods,9,27,4,40,
2025-08-17,Robert Frenzel,Xcel Energy,4,2,1,7,
2025-08-17,Timothy Spence,Fifth Third Bancorp,5,5,0,10,
2025-08-17,Stephen Schwarzman,Blackstone,19,17,4,40,
2025-08-17,Walker Martin,Sempra,0,3,0,3,
2025-08-17,Timothy NeCastro,Erie Insurance,2,7,1,10,
2025-08-17,Wendell Weeks,Corning,14,24,2,40,
2025-08-17,Kathleen Johnson,Lumen Technologies,3,4,1,8,
2025-08-17,Brian Tierney,FirstEnergy,4,19,2,25,
2025-08-17,Adam Schechter,Labcorp,7,20,1,28,
2025-08-17,Tiang Yew Tan,Western Digital,2,0,0,2,
2025-08-17,Richard McKenney,Unum,4,5,0,9,
2025-08-17,Javier Rodriguez,DaVita,13,15,1,29,
2025-08-17,Steven Cahillane,Kellanova,2,7,0,9,
2025-08-17,Stanley Bergman,Henry Schein,11,28,1,40,
2025-08-17,Robert Sanchez,Ryder System,10,11,1,22,
2025-08-17,Tim Hingtgen,Community Health Systems,11,27,2,40,
2025-08-17,Avigal Soreq,Delek US,3,11,5,19,
2025-08-17,Gerardo Norcia,DTE Energy,7,2,0,9,
2025-08-17,Mark Pearson,Equitable,7,9,0,16,
2025-08-17,Lori Koch,DuPont,8,18,0,26,
2025-08-17,Rich Steinmeier,LPL Financial,24,14,2,40,
2025-08-17,Bruce Van Saun,Citizens Financial,12,27,1,40,
2025-08-17,Jos√© Mas,MasTec,7,14,2,23,
2025-08-17,Andr√©s Gluski,AES,16,23,0,39,
2025-08-17,Kevin Kwilinski,Berry Global,8,19,0,27,
2025-08-17,Mark George,Norfolk Southern,15,22,3,40,
2025-08-17,Eduardo Menezes,Air Products & Chemicals,3,6,1,10,
2025-08-17,Shelley Simpson,JB Hunt Transport Services,6,31,3,40,
2025-08-17,Daniel Fisher,Ball,3,19,4,26,
2025-08-17,Sean Connolly,Conagra Brands,6,32,2,40,
2025-08-17,Stephen Steinour,Huntington Bancshares,2,8,0,10,
2025-08-17,James Snee,Hormel Foods,3,29,1,33,
2025-08-17,Joseph Nolan,Eversource Energy,5,3,1,9,
2025-08-17,William Oplinger,Alcoa,6,18,5,29,
2025-08-17,Andrew Marsh,Entergy,3,5,0,8,
2025-08-17,Keith Demmings,Assurant,3,8,0,11,
2025-08-17,Sumit Singh,Chewy,16,20,4,40,
2025-08-17,Niraj Shah,Wayfair,7,25,8,40,
2025-08-17,Joseph Ferraro,Avis Budget,3,6,1,10,
2025-08-17,Jeffrey Sprecher,Intercontinental Exchange,13,24,3,40,
2025-08-17,Benito Minicucci,Alaska Air,2,6,1,9,
2025-08-17,Malcolm Wilson,GXO Logistics,6,24,0,30,
2025-08-17,Eric Hansotia,AGCO,17,22,1,40,
2025-08-17,Kathleen Mazzarella,Graybar Electric,1,9,0,10,
2025-08-17,Gavin Hattersley,Molson Coors Beverage,2,31,7,40,
2025-08-17,Patrick Gallagher,Arthur J Gallagher,11,27,2,40,
2025-08-17,Christopher Kastner,Huntington Ingalls Industries,2,4,1,7,
2025-08-17,Erik Fyrwald,International Flavors & Fragrances,7,8,2,17,
2025-08-17,Ricardo Cardenas,Darden Restaurants,4,4,1,9,
2025-08-17,Stephen Spray,Cincinnati Financial,1,5,4,10,
2025-08-17,Scott Boatwright,Chipotle Mexican Grill,7,29,4,40,
2025-08-17,Joey Wat,Yum China,12,26,2,40,
2025-08-17,Robert Goldstein,Las Vegas Sands,3,32,5,40,
2025-08-17,Kecia Steelman,Ulta Beauty,31,8,1,40,
2025-08-17,Thomas Reeg,Caesars Entertainment,4,5,1,10,
2025-08-17,Jon Rousseau,BrightSpring Health Services,20,19,1,40,
2025-08-17,William Krueger,Andersons,0,4,0,4,
2025-08-17,Michele Buck,Hershey,9,29,2,40,
2025-08-17,Christopher Nassetta,Hilton,16,22,2,40,
2025-08-17,Bruce Bodine,Mosaic,3,7,0,10,
2025-08-17,Brian Chesky,Airbnb,1,31,8,40,
2025-08-17,Kaes Van‚Äôt Hof,Diamondback Energy,24,13,2,39,
2025-08-17,Steven Vondran,American Tower,4,7,0,11,
2025-08-17,Reshma Kewalramani,Vertex Pharmaceuticals,20,17,3,40,
2025-08-17,William McDermott,ServiceNow,3,6,0,9,
2025-08-17,Brian Chambers,Owens Corning,3,12,1,16,
2025-08-17,Teresa Rasmussen,Thrivent Financial for Lutherans,3,2,0,5,
2025-08-17,Shane O'Kelly,Advance Auto Parts,15,22,3,40,
2025-08-17,Douglas Yearley,Toll Brothers,9,24,5,38,
2025-08-17,Jeffrey Lorberbaum,Mohawk Industries,10,5,1,16,
2025-08-17,Gregory Brown,Motorola Solutions,1,9,0,10,
2025-08-17,John Pfeifer,Oshkosh,6,26,4,36,
2025-08-17,Tony Xu,DoorDash,13,20,7,40,
2025-08-17,Edward Pesicka,Owens & Minor,2,29,2,33,
2025-08-17,Eugene Bredow,NVR,0,4,0,4,
2025-08-17,Philippe Krakowsky,Interpublic,15,21,4,40,
2025-08-17,Horacio Rozanski,Booz Allen Hamilton,15,20,5,40,
2025-08-17,Michael O‚ÄôSullivan,Burlington Stores,9,28,3,40,
2025-08-17,Daniel Wall,Expeditors International of Washington,5,3,0,8,
2025-08-17,Calvin McDonald,Lululemon athletica,9,30,1,40,
2025-08-17,Stephanie Ferris,Fidelity National Information,14,19,4,37,
2025-08-17,Richard Handler,Jefferies Financial,5,8,8,21,
2025-08-17,Alan Armstrong,Williams,23,13,4,40,
2025-08-17,Bracken Darrell,VF Corporation,8,28,4,40,
2025-08-17,Mikael Bratt,Autoliv,6,9,2,17,
2025-08-17,Rafael Santana,Westinghouse Air Brake Technologies,5,6,0,11,
2025-08-17,Ralph LaRossa,Public Service Enterprise,7,16,0,23,
2025-08-17,Jamie Iannone,Ebay,19,16,5,40,
2025-08-17,Scott Richardson,Celanese,7,28,5,40,
2025-08-17,Cameron Bready,Global Payments,8,29,3,40,
2025-08-17,Robert Thomson,News Corp,7,27,5,39,
2025-08-17,Robert Martin,THOR Industries,4,5,1,10,
2025-08-17,David Rawlinson II,QVC,6,13,2,21,
2025-08-17,Andrew Teno,Icahn Enterprises,5,6,0,11,
2025-08-17,William Newlands,Constellation Brands,0,2,2,4,
2025-08-17,James Davis,Quest Diagnostics,4,5,1,10,
2025-08-17,Richard Wallace,KLA,2,5,0,7,
2025-08-17,Julian Francis,QXO Building Products,0,0,0,0,
2025-08-17,John Christmann IV,APA,5,5,0,10,
2025-08-17,Gregory Roberts,A-Mark Precious Metals,2,2,1,5,
2025-08-17,Christopher Viehbacher,Biogen,0,27,2,29,
2025-08-17,Mick Beekhuizen,Campbell's,6,23,3,32,
2025-08-17,Christopher Caldwell,Concentrix,2,6,0,8,
2025-08-17,Todd Schneider,Cintas,11,17,1,29,
2025-08-17,Tony Sarsam,SpartanNash,17,20,3,40,
2025-08-17,John Venhuizen,Ace Hardware,16,23,1,40,
2025-08-17,Vincent Roche,Analog Devices,15,23,2,40,
2025-08-17,Mark Costa,Eastman Chemical,7,16,4,27,
2025-08-17,Milan Galik,Interactive Brokers,6,15,0,21,
2025-08-17,John Turner,Regions Financial,19,19,2,40,
2025-08-17,Joanna Geraghty,JetBlue Airways,17,16,7,40,
2025-08-17,Kristin Peck,Zoetis,11,18,1,30,
2025-08-17,Christopher Gorman,KeyCorp,4,6,0,10,
2025-08-17,Mark Bertolini,Oscar Health,13,18,8,39,
2025-08-17,Brendan McCracken,Ovintiv,6,5,1,12,
2025-08-17,Robert Steer,Seaboard,1,4,0,5,
2025-08-17,Gil West,Hertz,7,26,7,40,
2025-08-17,Robert Greenberg,Skechers,7,31,2,40,
2025-08-17,Dennis Mathew,Altice,5,26,7,38,
2025-08-17,Clay Williams,NOV,12,22,4,38,
2025-08-17,Michael Doss,Graphic Packaging,6,9,1,16,
2025-08-17,Deon Stander,Avery Dennison,0,11,0,11,
2025-08-17,Adaire Fox-Martin,Equinix,16,19,3,38,
2025-08-17,Joyce Mullen,Insight Enterprises,6,12,1,19,
2025-08-17,Jennifer Witz,Sirius XM,6,15,6,27,
2025-08-17,Stefan Larsson,PVH,8,26,6,40,
2025-08-17,Jason Wells,CenterPoint Energy,22,13,5,40,
2025-08-17,Scott Lauber,WEC Energy,16,6,0,22,
2025-08-17,Matthew Pine,Xylem,2,10,1,13,
2025-08-17,Jennifer Johnson,Franklin Resources,1,8,1,10,
2025-08-17,Vincent Sorgi,PPL,9,10,1,20,
2025-08-17,Carl Eschenbach,Workday,10,20,10,40,
2025-08-17,Richard Tobin,Dover,3,6,1,10,
2025-08-17,Mark Kowlzan,Packaging Corp of America,1,10,1,12,
2025-08-17,Scott Salmirs,ABM Industries,7,6,1,14,
2025-08-17,Gary Guthart,Intuitive Surgical,10,26,4,40,
2025-08-17,Carl Lindner lll,American Financial,0,0,0,0,
2025-08-17,Blake Moret,Rockwell Automation,13,27,0,40,
2025-08-17,Bryan Hanson,Solventum,7,10,2,19,
2025-08-17,Craig Smiddy,Old Republic International,3,6,1,10,
2025-08-17,Christopher Hilger,Securian Financial,0,5,1,6,
2025-08-17,Hamid Moghadam,Prologis,6,28,6,40,
2025-08-17,Mark Smucker,JM Smucker,10,25,5,40,
2025-08-17,Sheryl Palmer,Taylor Morrison Home,6,13,1,20,
2025-08-17,Mario Harik,XPO,8,31,1,40,
2025-08-17,Heather Lavallee,Voya Financial,6,10,2,18,
2025-08-17,Nikesh Arora,Palo Alto Networks,7,24,9,40,
2025-08-17,Giordano Albertazzi,Vertiv s,0,1,0,1,
2025-08-17,Shankh Mitra,Welltower,17,21,2,40,
2025-08-17,Mary Dillon,Foot Locker,10,24,6,40,
2025-08-17,William Monteleone,Par Pacific,1,7,2,10,
2025-08-17,Kevin Stein,TransDigm,9,10,2,21,
2025-08-17,Peter Matt,Commercial Metals,5,3,0,8,
2025-08-17,Robert Vitale,Post s,0,0,0,0,
2025-08-17,Keith Allman,Masco,6,9,1,16,
2025-08-17,Rusty Rush,Rush Enterprises,16,21,3,40,
2025-08-17,Stuart Bradie,KBR,14,17,4,35,
2025-08-17,Jack Sinclair,Sprouts Farmers Market,13,26,1,40,
2025-08-17,Laura Alber,Williams-Sonoma,11,22,7,40,
2025-08-17,Ivan Tornos,Zimmer Biomet s,1,2,0,3,
2025-08-17,John Mengucci,CACI International,21,17,2,40,
2025-08-17,Steve Sanghi,Microchip Technology,7,29,4,40,
2025-08-17,Albert Nahmad,Watsco,2,6,1,9,
2025-08-17,Christopher Peterson,Newell Brands,1,7,2,10,
2025-08-17,Arie Kotler,ARKO,5,23,0,28,
2025-08-17,Jure Sola,Sanmina,3,14,1,18,
2025-08-17,Andrew Wilson,Electronic Arts,15,17,8,40,
2025-08-17,David Gibbs,Yum Brands,2,37,1,40,
2025-08-17,Daniel Florness,Fastenal,3,6,1,10,
2025-08-17,Garrick Rochow,CMS Energy,12,3,0,15,
2025-08-17,Rodney Sacks,Monster Beverage,16,22,1,39,
2025-08-17,Mark Shapiro,Endeavor,3,35,2,40,
2025-08-17,Toni Townes-Whitley,Science Applications International,12,19,1,32,
2025-08-17,Mark Witkowski,Core & Main,1,6,1,8,
2025-08-17,John Plant,Howmet Aerospace,5,18,2,25,
2025-08-17,James Zallie,Ingredion,4,5,1,10,
2025-08-17,Thomas Hill,Vulcan Materials,4,8,2,14,
2025-08-18,Doug McMillon,Walmart,14,20,6,40,
2025-08-18,Andrew Jassy,Amazon,6,26,5,37,
2025-08-18,Stephen Hemsley,UnitedHealth,8,25,7,40,
2025-08-18,Tim Cook,Apple,14,22,4,40,
2025-08-18,David Joyner,CVS Health,7,29,4,40,
2025-08-18,Warren Buffett,Berkshire Hathaway,12,25,3,40,
2025-08-18,Sundar Pichai,Alphabet,18,17,5,40,
2025-08-18,Darren Woods,Exxon Mobil,11,20,8,39,
2025-08-18,Brian Tyler,McKesson,4,15,4,23,
2025-08-18,Robert Mauch,Cencora,4,6,0,10,
2025-08-18,Jamie Dimon,JPMorgan Chase,10,20,10,40,
2025-08-18,Ron Vachris,Costco,5,33,2,40,
2025-08-18,David Cordani,Cigna,22,15,3,40,
2025-08-18,Satya Nadella,Microsoft,14,17,9,40,
2025-08-18,Jason Hollar,Cardinal Health,14,21,5,40,
2025-08-18,Mike Wirth,Chevron,17,17,6,40,
2025-08-18,Brian Moynihan,Bank of America,3,28,9,40,
2025-08-18,Mary Barra,General Motors,11,25,4,40,
2025-08-18,Jim Farley,Ford Motor,13,22,5,40,
2025-08-18,Gail Boudreaux,Elevance Health,15,18,7,40,
2025-08-18,Jane Fraser,Citi,12,22,6,40,
2025-08-18,Mark Zuckerberg,Meta,12,22,6,40,
2025-08-18,Sarah London,Centene,11,21,8,40,
2025-08-18,Ted Decker,Home Depot,10,28,2,40,
2025-08-18,Priscilla Almodovar,Fannie Mae,10,16,13,39,
2025-08-18,Tim Wentworth,Walgreens,8,21,10,39,
2025-08-18,Ron Sargent,Kroger,7,9,7,23,
2025-08-18,Mark Lashier,Phillips 66,9,20,9,38,
2025-08-18,Maryann Mannen,Marathon Petroleum,6,14,1,21,
2025-08-18,Hans Vestberg,Verizon,17,19,4,40,
2025-08-18,Jensen Huang,Nvidia,14,21,5,40,
2025-08-18,David Solomon,Goldman Sachs,2,22,16,40,
2025-08-18,Charles Scharf,Wells Fargo,27,8,5,40,
2025-08-18,Lane Riggs,Valero Energy,13,9,0,22,
2025-08-18,Brian Roberts,Comcast,10,27,3,40,
2025-08-18,Jon Farney,State Farm,10,27,3,40,
2025-08-18,John Stankey,AT&T,12,23,5,40,
2025-08-18,Michael Hutchins,Freddie Mac,3,11,3,17,
2025-08-18,Jim Rechtin,Humana,18,18,4,40,
2025-08-18,Ted Pick,Morgan Stanley,16,21,3,40,
2025-08-18,Brian Cornell,Target,8,21,11,40,
2025-08-18,Philip Smith,StoneX,0,9,1,10,
2025-08-18,Elon Musk,Tesla,10,18,12,40,
2025-08-18,Michael Dell,Dell Technologies,12,25,3,40,
2025-08-18,Ramon Laguarta,PepsiCo,9,28,3,40,
2025-08-18,Bob Iger,Walt Disney,11,26,3,40,
2025-08-18,Carol Tom√©,UPS,9,20,11,40,
2025-08-18,Joaquin Duato,Johnson & Johnson,8,27,5,40,
2025-08-18,Rajesh Subramaniam,FedEx,10,23,0,33,
2025-08-18,Juan Luciano,Archer Daniels Midland,4,21,15,40,
2025-08-18,Jon Moeller,Procter & Gamble,5,30,5,40,
2025-08-18,Marvin Ellison,Lowe's,17,17,6,40,
2025-08-18,Thomas Long,Energy Transfer,9,0,1,10,
2025-08-18,Christopher Calio,RTX,6,11,0,17,
2025-08-18,Susan Morris,Albertsons,9,27,4,40,
2025-08-18,Kevin Hourican,Sysco,10,26,4,40,
2025-08-18,Tricia Griffith,Progressive,12,23,4,39,
2025-08-18,Stephen Squeri,American Express,14,24,2,40,
2025-08-18,James Taiclet,Lockheed Martin,11,18,11,40,
2025-08-18,Michel Khalaf,MetLife,11,17,0,28,
2025-08-18,Samuel Hazen,HCA Healthcare,8,6,0,14,
2025-08-18,Andrew Sullivan,Prudential Financial,14,24,0,38,
2025-08-18,Kelly Ortberg,Boeing,14,21,5,40,
2025-08-18,Joe Creed,Caterpillar,10,26,3,39,
2025-08-18,Robert M Davis,Merck,4,16,0,20,
2025-08-18,Thomas J Wilson,Allstate,1,11,1,13,
2025-08-18,Albert Bourla,Pfizer,21,12,7,40,
2025-08-18,Arvind Krishna,IBM,14,20,6,40,
2025-08-18,Craig DeSanto,New York Life Insurance,3,14,0,17,
2025-08-18,Ed Bastian,Delta Airlines,18,12,9,39,
2025-08-18,Kevin Murphy,Ferguson,7,23,4,34,
2025-08-18,Kirt Walker,Nationwide,14,17,2,33,
2025-08-18,Patrick Zammit,TD Synnex,9,16,0,25,
2025-08-18,Scott Kirby,United Airlines,35,3,2,40,
2025-08-18,Ryan Lance,ConocoPhillips,18,19,3,40,
2025-08-18,Ernie Herrman,TJX,17,22,1,40,
2025-08-18,Bob Michael,AbbVie,0,0,0,0,
2025-08-18,AJ Jim Teague,Enterprise Products Partners,6,8,0,14,
2025-08-18,Christopher Winfrey,Charter Communications,5,14,5,24,
2025-08-18,George Holm,Performance Food,10,22,2,34,
2025-08-18,Robert Isom,American Airlines,7,25,8,40,
2025-08-18,Richard Fairbank,Capital One,15,22,3,40,
2025-08-18,Chuck Robbins,Cisco Systems,12,23,5,40,
2025-08-18,Enrique Lores,HP,12,23,5,40,
2025-08-18,Donnie King,Tyson Foods,10,25,5,40,
2025-08-18,Lip-Bu Tan,Intel,7,23,10,40,
2025-08-18,Safra Catz,Oracle,13,19,8,40,
2025-08-18,Hock Tan,Broadcom,13,23,4,40,
2025-08-18,John May,Deere,8,28,4,40,
2025-08-18,Elliott Hill,Nike,12,24,4,40,
2025-08-18,Timothy M Sweeney,Liberty Mutual Insurance,14,0,0,14,
2025-08-18,Wilfred Chiang,Plains GP,1,1,0,2,
2025-08-18,Juan Andrade,USAA,5,16,0,21,
2025-08-18,Chris Boerner,Bristol-Myers Squibb,10,23,7,40,
2025-08-18,Paul Bay,Ingram Micro,11,24,5,40,
2025-08-18,Phebe Novakovic,General Dynamics,27,9,4,40,
2025-08-18,James Quincey,Coca-Cola,9,29,2,40,
2025-08-18,Thasunda Brown Duckett,TIAA,19,20,0,39,
2025-08-18,Alan Schnitzer,Travelers,14,18,8,40,
2025-08-18,David Ricks,Eli Lilly,9,22,9,40,
2025-08-18,Dara Khosrowshahi,Uber,13,23,4,40,
2025-08-18,Roger Crandall,Mass Mutual,3,7,0,10,
2025-08-18,Marc Casper,Thermo Fisher Scientific,13,24,3,40,
2025-08-18,Gunjan Kedia,US Bancorp,9,28,3,40,
2025-08-18,Michael Kasbar,World Kinect,2,10,0,12,
2025-08-18,Robert Ford,Abbott Laboratories,14,21,5,40,
2025-08-18,Corie Barry,Best Buy,38,2,0,40,
2025-08-18,Tim Gerend,Northwestern Mutual,14,25,1,40,
2025-08-18,Kathy Warden,Northrop Grumman,16,21,3,40,
2025-08-18,Joe Zubretsky,Molina Healthcare,8,6,4,18,
2025-08-18,Todd Vasos,Dollar General,6,22,12,40,
2025-08-18,Robin Vince,Bank of New York,19,17,4,40,
2025-08-18,David Zaslav,Warner Bros Discovery,8,22,10,40,
2025-08-18,Jay Debertin,CHS,4,8,4,16,
2025-08-18,Ted Sarandos,Netflix,12,26,2,40,
2025-08-18,Cristiano Amon,Qualcomm,12,26,1,39,
2025-08-18,Larry Culp,General Electric,11,26,3,40,
2025-08-18,Vimal Kapur,Honeywell,12,28,0,40,
2025-08-18,Marc Benioff,Salesforce,9,24,7,40,
2025-08-18,Jacek Olczak,Philip Morris,11,24,5,40,
2025-08-18,David Flitman,US Foods,1,8,0,9,
2025-08-18,Paul Romanowski,DR Horton,6,15,3,24,
2025-08-18,Bryan DeBoer,Lithia Motors,12,26,2,40,
2025-08-18,Dirk Van de Put,Mondelez,14,23,3,40,
2025-08-18,Brian Niccol,Starbucks,9,31,0,40,
2025-08-18,Ryan McInerney,Visa,16,20,4,40,
2025-08-18,Robert Sulentic,CBRE,1,7,1,9,
2025-08-18,Jonathan Jaffe,Lennar,2,7,1,10,
2025-08-18,Scott Strazik,GE Vernova,11,24,5,40,
2025-08-18,William Demchak,PNC,14,21,5,40,
2025-08-18,Jennifer Rumsey,Cummins,8,27,5,40,
2025-08-18,Preston Feight,Paccar,8,29,2,39,
2025-08-18,Robert Bradway,Amgen,9,28,3,40,
2025-08-18,Matthew Lucey,PBF Energy,6,2,1,9,
2025-08-18,Pat Geraghty,GuideWell Mutual,2,7,0,9,
2025-08-18,Alex Chriss,PayPal,13,25,2,40,
2025-08-18,Sandy Douglas,United Natural Foods,35,5,0,40,
2025-08-18,Michael Creedon,Dollar Tree,3,35,2,40,
2025-08-18,Leon Topalian,Nucor,15,22,3,40,
2025-08-18,Roger Penske,Penske Automotive,18,21,1,40,
2025-08-18,Bom Kim,Coupang,10,29,1,40,
2025-08-18,Antonio Neri,Hewlett Packard,8,23,9,40,
2025-08-18,Harry Sideris,Duke Energy,35,4,0,39,
2025-08-18,Joseph Bae,KKR,20,18,2,40,
2025-08-18,Brian Robbins,Paramount Global,7,28,1,36,
2025-08-18,Michael Dastoor,Jabil,1,5,0,6,
2025-08-18,Daniel O'Day,Gilead Sciences,20,17,3,40,
2025-08-18,Tim Go,HF Sinclair,6,4,0,10,
2025-08-18,William Nash,CarMax,4,3,2,9,
2025-08-18,Michael Miebach,Mastercard,9,27,4,40,
2025-08-18,Lawrence Coben,NRG Energy,7,2,0,9,
2025-08-18,Sean Kerins,Arrow Electronics,3,12,0,15,
2025-08-18,Lorenzo Simonelli,Baker Hughes,16,20,4,40,
2025-08-18,Bob Jordan,Southwest Airlines,12,21,7,40,
2025-08-18,Peter Zaffino,American International,8,24,3,35,
2025-08-18,Gary Dickerson,Applied Materials,6,23,11,40,
2025-08-18,Vicki Hollub,Occidental Petroleum,19,17,3,39,
2025-08-18,Michael Manley,AutoNation,3,6,1,10,
2025-08-18,Christopher Womack,Southern,2,8,0,10,
2025-08-18,Christopher Swift,Hartford Insurance,6,4,0,10,
2025-08-18,Marc Rowan,Apollo Global Management,15,21,4,40,
2025-08-18,Rick Wurster,Charles Schwab,16,20,3,39,
2025-08-18,Chris Kempczinski,McDonald's,13,18,9,40,
2025-08-18,Carlos Abrams-Rivera,Kraft Heinz,12,21,7,40,
2025-08-18,Lisa Su,Advanced Micro Devices,17,18,5,40,
2025-08-18,William H Rogers Jr,Truist Financial,2,8,0,10,
2025-08-18,Kathleen Quirk,Freeport-McMoRan,14,18,3,35,
2025-08-18,Sanjay Mehrotra,Micron Technology,19,19,2,40,
2025-08-18,Anthony Capuano,Marriott International,12,24,4,40,
2025-08-18,David Gitlin,Carrier Global,18,21,1,40,
2025-08-18,John Ketchum,NextEra Energy,21,18,1,40,
2025-08-18,William M Brown,3M,2,8,0,10,
2025-08-18,John Doyle,Marsh & McLennan,12,8,1,21,
2025-08-18,Patricia Poppe,PG&E,8,15,2,25,
2025-08-18,Jim Vena,Union Pacific,18,21,0,39,
2025-08-18,Brian Doubles,Synchrony Financial,5,7,2,14,
2025-08-18,Rainer Blair,Danaher,6,14,1,21,
2025-08-18,Philip Gallagher,Avnet,1,5,0,6,
2025-08-18,Glenn Fogel,Booking s,0,4,1,5,
2025-08-18,Ezra Yacob,EOG Resources,23,14,0,37,
2025-08-18,Earl Austin,Quanta Services,3,3,2,8,
2025-08-18,Michael Shepherd,Discover Financial,9,14,2,25,
2025-08-18,Joseph Dominguez,Constellation Energy,15,9,1,25,
2025-08-18,William Stengel II,Genuine Parts,0,4,0,4,
2025-08-18,Christian Ulbrich,Jones Lang LaSalle,8,20,0,28,
2025-08-18,Raymond E Scott,Lear Corporation,6,3,0,9,
2025-08-18,Michael Rapino,Live Nation Entertainment,12,24,4,40,
2025-08-18,Heidi Petz,Sherwin-Williams,7,28,3,38,
2025-08-18,Calvin G Butler Jr,Exelon,6,5,0,11,
2025-08-18,Tony Spring,Macy's,11,26,3,40,
2025-08-18,Jeff Miller,Halliburton,16,20,4,40,
2025-08-18,Kevin Lobo,Stryker,12,26,2,40,
2025-08-18,Tony Cheng,Reinsurance of America,0,0,0,0,
2025-08-18,Ronald P O'Hanley,State Street,5,15,0,20,
2025-08-18,John Engel,WESCO International,5,9,1,15,
2025-08-18,Pierce Norton II,Oneok,5,3,1,9,
2025-08-18,Shantanu Narayen,Adobe,19,20,1,40,
2025-08-18,Bill Westrate,American Family Insurance,9,16,2,27,
2025-08-18,Chris Kubasik,L3Harris Technologies,5,13,1,19,
2025-08-18,James Conroy,Ross Stores,4,11,0,15,
2025-08-18,Christine Leahy,CDW,0,8,2,10,
2025-08-18,Saumya Sutaria,Tenet Healthcare,5,4,1,10,
2025-08-18,Bob Eddy,BJ's Wholesale Club,6,32,2,40,
2025-08-18,Mike Lyons,Fiserv,4,10,0,14,
2025-08-18,William Gifford,Altria,2,6,1,9,
2025-08-18,Laurence Fink,BlackRock,17,16,7,40,
2025-08-18,Thomas Polen,Becton Dickinson,7,3,0,10,
2025-08-18,Noel Wallace,Colgate-Palmolive,9,24,2,35,
2025-08-18,Michael Hsu,Kimberly-Clark,6,5,2,13,
2025-08-18,Daryl Kenningham,1 Automotive,8,21,1,30,
2025-08-18,Jennifer Parmentier,Parker-Hannifin,2,12,0,14,
2025-08-18,Jeffrey Harmening,General Mills,6,17,5,28,
2025-08-18,Ravi Kumar S,Cognizant Technology,9,25,3,37,
2025-08-18,William Fehrman,American Electric Power,4,6,0,10,
2025-08-18,Peter Arduini,GE HealthCare Technologies,6,11,0,17,
2025-08-18,Maria Black,Automatic Data Processing,4,5,0,9,
2025-08-18,Lourenco Goncalves,Cleveland-Cliffs,8,21,11,40,
2025-08-18,Daniel Amos,Aflac,3,3,3,9,
2025-08-18,Mark Stewart,Goodyear Tire & Rubber,4,34,2,40,
2025-08-18,Kevin Hogan,Corebridge Financial,6,11,0,17,
2025-08-18,Thomas Palmer,Newmont,5,5,0,10,
2025-08-18,Andrew Silvernail,International Paper,6,23,0,29,
2025-08-18,Philip Daniele III,AutoZone,0,1,0,1,
2025-08-18,Ellen Cooper,Lincoln National,4,6,0,10,
2025-08-18,Ryan Marshall,Pulte,7,6,8,21,
2025-08-18,James Cracchiolo,Ameriprise Financial,2,25,2,29,
2025-08-18,Andrew Clyde,Murphy USA,14,25,1,40,
2025-08-18,Jonas Prising,Manpower,9,6,1,16,
2025-08-18,David Bozeman,CH Robinson Worldwide,2,7,1,10,
2025-08-18,Timothy Knavish,PPG Industries,1,2,0,3,
2025-08-18,Pedro Pizarro,Edison International,15,8,17,40,
2025-08-18,Mark Millett,Steel Dynamics,15,3,0,18,
2025-08-18,Benjamin Tisch,Loews,2,7,0,9,
2025-08-18,Karsanbhai,Emerson Electric,10,18,3,31,
2025-08-18,John Zillmer,Aramark,8,16,2,26,
2025-08-18,William Hornbuckle,MGM Resorts International,5,25,1,31,
2025-08-18,James Burke,Vistra,6,3,0,9,
2025-08-18,David Hult,Asbury Automotive,8,31,1,40,
2025-08-18,DG Macpherson,WW Grainger,3,6,1,10,
2025-08-18,Eric Slifka,Global Partners,13,23,4,40,
2025-08-18,Bob Pragada,Jacobs Solutions,6,8,0,14,
2025-08-18,Charles Magro,Corteva,5,3,1,9,
2025-08-18,Rick Lanoha,Peter Kiewit Sons',0,2,0,2,
2025-08-18,Michael Mahoney,Boston Scientific,10,27,1,38,
2025-08-18,Brad Beckham,O'Reilly Automotive,5,15,1,21,
2025-08-18,Thomas Bell,Leidos,8,18,1,27,
2025-08-18,Thomas Gayner,Markel,4,10,2,16,
2025-08-18,Marc Bitzer,Whirlpool,11,15,14,40,
2025-08-18,Andrew McMahon,Guardian Life,5,13,0,18,
2025-08-18,Peter Jackson,Builders FirstSource,5,12,1,18,
2025-08-18,Michael Rhodes,Ally Financial,10,24,5,39,
2025-08-18,Matthew Meloy,Targa Resources,5,5,0,10,
2025-08-18,James Breuer,Fluor,1,2,1,4,
2025-08-18,Sasan Goodarzi,Intuit,10,26,4,40,
2025-08-18,Troy Rudd,AECOM,7,23,5,35,
2025-08-18,Penny Pennington,Edward Jones,6,29,5,40,
2025-08-18,Michael Bender,Kohl's,1,25,14,40,
2025-08-18,Beth Ford,Land O'Lakes,19,20,1,40,
2025-08-18,Deanna Strable-Soethout,Principal Financial,1,7,0,8,
2025-08-18,Robert Blue,Dominion Energy,27,10,2,39,
2025-08-18,Martin Schroeter,Kyndryl s,0,10,0,10,
2025-08-18,Jon Vander Ark,Republic Services,10,20,10,40,
2025-08-18,Clay Gaspar,Devon Energy,19,3,0,22,
2025-08-18,Christopher O'Herlihy,Illinois Tool Works,2,5,2,9,
2025-08-18,Michael O'Grady,Northern Trust,23,7,1,31,
2025-08-18,Jamie Whisnant,Auto-Owners Insurance,0,2,0,2,
2025-08-18,Marc Miller,Universal Health Services,3,20,3,26,
2025-08-18,Darryl Button,Pacific Life,1,6,0,7,
2025-08-18,Hamid Akhavan,EchoStar,4,25,11,40,
2025-08-18,Christophe Beck,Ecolab,18,22,0,40,
2025-08-18,Jack Fusco,Cheniere Energy,17,20,3,40,
2025-08-18,John Wren,Omnicom,9,21,10,40,
2025-08-18,Haviv Ilan,Texas Instruments,13,25,2,40,
2025-08-18,David Burritt,United States Steel,9,17,14,40,
2025-08-18,St√©phane de La Faverie,Est√©e Lauder,13,24,3,40,
2025-08-18,Raul Nicholas Vargas Ochoa,Farmers Insurance Exchange,0,0,0,0,
2025-08-18,Thibaut Mongon,Kenvue,8,29,3,40,
2025-08-18,Ari Bousbib,IQVIA s,0,0,0,0,
2025-08-18,Donald Allan,Stanley Black & Decker,10,29,1,40,
2025-08-18,Timothy Cofer,Keurig Dr Pepper,2,2,1,5,
2025-08-18,Matthew Flannery,United Rentals,32,3,0,35,
2025-08-18,Timothy Cawley,Consolidated Edison,5,5,0,10,
2025-08-18,Adam Norwitt,Amphenol,3,13,0,16,
2025-08-18,Brent Shafer,Baxter International,1,10,0,11,
2025-08-18,Kimberly Dang,Kinder Morgan,9,1,0,10,
2025-08-18,Erik Nordstrom,Nordstrom,7,27,5,39,
2025-08-18,Frank Holding,First Citizens BancShares,10,16,2,28,
2025-08-18,Paul Shoukry,Raymond James Financial,14,25,1,40,
2025-08-18,Timothy Archer,Lam Research,2,7,1,10,
2025-08-18,Harry Lawton III,Tractor Supply,1,1,0,2,
2025-08-18,Darren Rebelez,Casey's General Stores,15,23,2,40,
2025-08-18,Scott Smith,Viatris,7,3,0,10,
2025-08-18,James Blackledge,Mutual of Omaha Insurance,0,6,0,6,
2025-08-18,Anthony Guzzi,EMCOR,4,3,0,7,
2025-08-18,Joseph Hinrichs,CSX,5,9,1,15,
2025-08-18,Justin Jude,LKQ,4,6,1,11,
2025-08-18,Judith Marks,Otis Worldwide,3,3,0,6,
2025-08-18,David Bruton Smith,Sonic Automotive,4,9,9,22,
2025-08-18,Martina Cheung,S&P Global,11,24,0,35,
2025-08-18,Leonard Schleifer,Regeneron Pharmaceuticals,5,27,8,40,
2025-08-18,Joseph Fadool,BorgWarner,4,10,0,14,
2025-08-18,Lachlan Murdoch,Fox,5,29,6,40,
2025-08-18,Karla Lewis,Reliance,3,6,1,10,
2025-08-18,John Barrett,Western & Southern Financial,7,31,2,40,
2025-08-18,Scott Donnelly,Textron,9,28,3,40,
2025-08-18,Ariane Gorin,Expedia,9,29,1,39,
2025-08-18,Michael Nolan,Fidelity National Financial,4,0,0,4,
2025-08-18,Ernest Garcia III,Carvana,23,13,4,40,
2025-08-18,Raul Fernandez,DXC Technology,4,33,1,38,
2025-08-18,Robert Berkley,WR Berkley,8,28,4,40,
2025-08-18,Ren√© Jones,M&T Bank,12,24,4,40,
2025-08-18,Lauren Hobart,Dick's Sporting Goods,8,28,4,40,
2025-08-18,Robert Frenzel,Xcel Energy,4,2,1,7,
2025-08-18,Timothy Spence,Fifth Third Bancorp,5,5,0,10,
2025-08-18,Stephen Schwarzman,Blackstone,20,17,3,40,
2025-08-18,Walker Martin,Sempra,0,3,0,3,
2025-08-18,Timothy NeCastro,Erie Insurance,2,7,1,10,
2025-08-18,Wendell Weeks,Corning,14,24,2,40,
2025-08-18,Kathleen Johnson,Lumen Technologies,3,4,1,8,
2025-08-18,Brian Tierney,FirstEnergy,4,20,2,26,
2025-08-18,Adam Schechter,Labcorp,7,20,1,28,
2025-08-18,Tiang Yew Tan,Western Digital,2,0,0,2,
2025-08-18,Richard McKenney,Unum,4,5,0,9,
2025-08-18,Javier Rodriguez,DaVita,13,14,1,28,
2025-08-18,Steven Cahillane,Kellanova,2,7,0,9,
2025-08-18,Stanley Bergman,Henry Schein,11,28,1,40,
2025-08-18,Robert Sanchez,Ryder System,10,11,1,22,
2025-08-18,Tim Hingtgen,Community Health Systems,11,27,2,40,
2025-08-18,Avigal Soreq,Delek US,3,11,5,19,
2025-08-18,Gerardo Norcia,DTE Energy,7,2,0,9,
2025-08-18,Mark Pearson,Equitable,7,9,0,16,
2025-08-18,Lori Koch,DuPont,8,18,0,26,
2025-08-18,Rich Steinmeier,LPL Financial,24,14,2,40,
2025-08-18,Bruce Van Saun,Citizens Financial,12,26,2,40,
2025-08-18,Jos√© Mas,MasTec,7,14,2,23,
2025-08-18,Andr√©s Gluski,AES,16,23,0,39,
2025-08-18,Kevin Kwilinski,Berry Global,8,19,0,27,
2025-08-18,Mark George,Norfolk Southern,15,22,3,40,
2025-08-18,Eduardo Menezes,Air Products & Chemicals,2,7,1,10,
2025-08-18,Shelley Simpson,JB Hunt Transport Services,6,31,3,40,
2025-08-18,Daniel Fisher,Ball,3,20,4,27,
2025-08-18,Sean Connolly,Conagra Brands,7,31,2,40,
2025-08-18,Stephen Steinour,Huntington Bancshares,2,8,0,10,
2025-08-18,James Snee,Hormel Foods,3,29,1,33,
2025-08-18,Joseph Nolan,Eversource Energy,4,4,1,9,
2025-08-18,William Oplinger,Alcoa,6,18,6,30,
2025-08-18,Andrew Marsh,Entergy,3,5,0,8,
2025-08-18,Keith Demmings,Assurant,3,8,0,11,
2025-08-18,Sumit Singh,Chewy,15,21,4,40,
2025-08-18,Niraj Shah,Wayfair,9,24,7,40,
2025-08-18,Joseph Ferraro,Avis Budget,3,6,1,10,
2025-08-18,Jeffrey Sprecher,Intercontinental Exchange,13,24,3,40,
2025-08-18,Benito Minicucci,Alaska Air,3,5,1,9,
2025-08-18,Malcolm Wilson,GXO Logistics,7,23,0,30,
2025-08-18,Eric Hansotia,AGCO,17,20,1,38,
2025-08-18,Kathleen Mazzarella,Graybar Electric,1,9,0,10,
2025-08-18,Gavin Hattersley,Molson Coors Beverage,2,31,7,40,
2025-08-18,Patrick Gallagher,Arthur J Gallagher,12,26,2,40,
2025-08-18,Christopher Kastner,Huntington Ingalls Industries,2,4,0,6,
2025-08-18,Erik Fyrwald,International Flavors & Fragrances,7,7,2,16,
2025-08-18,Ricardo Cardenas,Darden Restaurants,4,4,1,9,
2025-08-18,Stephen Spray,Cincinnati Financial,1,5,4,10,
2025-08-18,Scott Boatwright,Chipotle Mexican Grill,6,29,5,40,
2025-08-18,Joey Wat,Yum China,13,24,3,40,
2025-08-18,Robert Goldstein,Las Vegas Sands,4,31,5,40,
2025-08-18,Kecia Steelman,Ulta Beauty,31,8,1,40,
2025-08-18,Thomas Reeg,Caesars Entertainment,4,6,0,10,
2025-08-18,Jon Rousseau,BrightSpring Health Services,20,19,1,40,
2025-08-18,William Krueger,Andersons,0,4,0,4,
2025-08-18,Michele Buck,Hershey,8,30,2,40,
2025-08-18,Christopher Nassetta,Hilton,15,22,3,40,
2025-08-18,Bruce Bodine,Mosaic,3,7,0,10,
2025-08-18,Brian Chesky,Airbnb,2,31,7,40,
2025-08-18,Kaes Van‚Äôt Hof,Diamondback Energy,24,13,2,39,
2025-08-18,Steven Vondran,American Tower,4,7,0,11,
2025-08-18,Reshma Kewalramani,Vertex Pharmaceuticals,21,16,3,40,
2025-08-18,William McDermott,ServiceNow,4,5,0,9,
2025-08-18,Brian Chambers,Owens Corning,3,12,1,16,
2025-08-18,Teresa Rasmussen,Thrivent Financial for Lutherans,3,2,0,5,
2025-08-18,Shane O'Kelly,Advance Auto Parts,14,23,3,40,
2025-08-18,Douglas Yearley,Toll Brothers,9,23,4,36,
2025-08-18,Jeffrey Lorberbaum,Mohawk Industries,10,5,1,16,
2025-08-18,Gregory Brown,Motorola Solutions,1,9,0,10,
2025-08-18,John Pfeifer,Oshkosh,6,26,4,36,
2025-08-18,Tony Xu,DoorDash,13,20,7,40,
2025-08-18,Edward Pesicka,Owens & Minor,2,30,2,34,
2025-08-18,Eugene Bredow,NVR,0,4,0,4,
2025-08-18,Philippe Krakowsky,Interpublic,15,21,4,40,
2025-08-18,Horacio Rozanski,Booz Allen Hamilton,16,19,5,40,
2025-08-18,Michael O‚ÄôSullivan,Burlington Stores,8,29,3,40,
2025-08-18,Daniel Wall,Expeditors International of Washington,4,3,0,7,
2025-08-18,Calvin McDonald,Lululemon athletica,9,31,0,40,
2025-08-18,Stephanie Ferris,Fidelity National Information,14,19,4,37,
2025-08-18,Richard Handler,Jefferies Financial,5,8,8,21,
2025-08-18,Alan Armstrong,Williams,23,13,4,40,
2025-08-18,Bracken Darrell,VF Corporation,8,28,4,40,
2025-08-18,Mikael Bratt,Autoliv,6,9,2,17,
2025-08-18,Rafael Santana,Westinghouse Air Brake Technologies,5,6,0,11,
2025-08-18,Ralph LaRossa,Public Service Enterprise,7,16,0,23,
2025-08-18,Jamie Iannone,Ebay,18,17,5,40,
2025-08-18,Scott Richardson,Celanese,8,28,4,40,
2025-08-18,Cameron Bready,Global Payments,8,29,3,40,
2025-08-18,Robert Thomson,News Corp,7,26,6,39,
2025-08-18,Robert Martin,THOR Industries,4,5,1,10,
2025-08-18,David Rawlinson II,QVC,6,13,2,21,
2025-08-18,Andrew Teno,Icahn Enterprises,5,6,0,11,
2025-08-18,William Newlands,Constellation Brands,0,2,2,4,
2025-08-18,James Davis,Quest Diagnostics,4,5,1,10,
2025-08-18,Richard Wallace,KLA,2,5,0,7,
2025-08-18,Julian Francis,QXO Building Products,0,0,0,0,
2025-08-18,John Christmann IV,APA,5,5,0,10,
2025-08-18,Gregory Roberts,A-Mark Precious Metals,2,2,1,5,
2025-08-18,Christopher Viehbacher,Biogen,0,27,2,29,
2025-08-18,Mick Beekhuizen,Campbell's,6,23,3,32,
2025-08-18,Christopher Caldwell,Concentrix,2,6,0,8,
2025-08-18,Todd Schneider,Cintas,11,17,1,29,
2025-08-18,Tony Sarsam,SpartanNash,16,22,2,40,
2025-08-18,John Venhuizen,Ace Hardware,16,23,1,40,
2025-08-18,Vincent Roche,Analog Devices,16,22,2,40,
2025-08-18,Mark Costa,Eastman Chemical,7,16,4,27,
2025-08-18,Milan Galik,Interactive Brokers,6,16,0,22,
2025-08-18,John Turner,Regions Financial,19,19,2,40,
2025-08-18,Joanna Geraghty,JetBlue Airways,18,16,6,40,
2025-08-18,Kristin Peck,Zoetis,11,18,1,30,
2025-08-18,Christopher Gorman,KeyCorp,4,6,0,10,
2025-08-18,Mark Bertolini,Oscar Health,13,18,8,39,
2025-08-18,Brendan McCracken,Ovintiv,6,5,1,12,
2025-08-18,Robert Steer,Seaboard,1,4,0,5,
2025-08-18,Gil West,Hertz,7,25,8,40,
2025-08-18,Robert Greenberg,Skechers,7,31,2,40,
2025-08-18,Dennis Mathew,Altice,5,25,7,37,
2025-08-18,Clay Williams,NOV,13,21,4,38,
2025-08-18,Michael Doss,Graphic Packaging,6,9,1,16,
2025-08-18,Deon Stander,Avery Dennison,0,11,0,11,
2025-08-18,Adaire Fox-Martin,Equinix,16,19,3,38,
2025-08-18,Joyce Mullen,Insight Enterprises,6,11,1,18,
2025-08-18,Jennifer Witz,Sirius XM,7,13,5,25,
2025-08-18,Stefan Larsson,PVH,9,25,6,40,
2025-08-18,Jason Wells,CenterPoint Energy,22,13,5,40,
2025-08-18,Scott Lauber,WEC Energy,0,0,0,0,
2025-08-18,Matthew Pine,Xylem,2,10,1,13,
2025-08-18,Jennifer Johnson,Franklin Resources,1,8,1,10,
2025-08-18,Vincent Sorgi,PPL,8,11,1,20,
2025-08-18,Carl Eschenbach,Workday,10,20,10,40,
2025-08-18,Richard Tobin,Dover,3,6,1,10,
2025-08-18,Mark Kowlzan,Packaging Corp of America,1,10,1,12,
2025-08-18,Scott Salmirs,ABM Industries,7,6,1,14,
2025-08-18,Gary Guthart,Intuitive Surgical,11,25,4,40,
2025-08-18,Carl Lindner lll,American Financial,0,0,0,0,
2025-08-18,Blake Moret,Rockwell Automation,13,27,0,40,
2025-08-18,Bryan Hanson,Solventum,7,10,2,19,
2025-08-18,Craig Smiddy,Old Republic International,3,6,1,10,
2025-08-18,Christopher Hilger,Securian Financial,0,5,1,6,
2025-08-18,Hamid Moghadam,Prologis,7,27,6,40,
2025-08-18,Mark Smucker,JM Smucker,10,24,6,40,
2025-08-18,Sheryl Palmer,Taylor Morrison Home,6,12,1,19,
2025-08-18,Mario Harik,XPO,8,31,1,40,
2025-08-18,Heather Lavallee,Voya Financial,6,10,2,18,
2025-08-18,Nikesh Arora,Palo Alto Networks,8,23,9,40,
2025-08-18,Giordano Albertazzi,Vertiv s,0,1,0,1,
2025-08-18,Shankh Mitra,Welltower,17,21,2,40,
2025-08-18,Mary Dillon,Foot Locker,11,24,5,40,
2025-08-18,William Monteleone,Par Pacific,2,6,2,10,
2025-08-18,Kevin Stein,TransDigm,9,9,2,20,
2025-08-18,Peter Matt,Commercial Metals,5,4,0,9,
2025-08-18,Robert Vitale,Post s,0,0,0,0,
2025-08-18,Keith Allman,Masco,6,9,1,16,
2025-08-18,Rusty Rush,Rush Enterprises,17,20,3,40,
2025-08-18,Stuart Bradie,KBR,14,17,4,35,
2025-08-18,Jack Sinclair,Sprouts Farmers Market,14,25,1,40,
2025-08-18,Laura Alber,Williams-Sonoma,11,23,6,40,
2025-08-18,Ivan Tornos,Zimmer Biomet s,1,2,0,3,
2025-08-18,John Mengucci,CACI International,21,17,2,40,
2025-08-18,Steve Sanghi,Microchip Technology,8,29,3,40,
2025-08-18,Albert Nahmad,Watsco,2,6,2,10,
2025-08-18,Christopher Peterson,Newell Brands,1,8,1,10,
2025-08-18,Arie Kotler,ARKO,5,23,0,28,
2025-08-18,Jure Sola,Sanmina,3,15,1,19,
2025-08-18,Andrew Wilson,Electronic Arts,15,17,8,40,
2025-08-18,David Gibbs,Yum Brands,2,37,1,40,
2025-08-18,Daniel Florness,Fastenal,3,6,1,10,
2025-08-18,Garrick Rochow,CMS Energy,12,3,0,15,
2025-08-18,Rodney Sacks,Monster Beverage,16,22,1,39,
2025-08-18,Mark Shapiro,Endeavor,5,34,1,40,
2025-08-18,Toni Townes-Whitley,Science Applications International,13,20,1,34,
2025-08-18,Mark Witkowski,Core & Main,1,6,1,8,
2025-08-18,John Plant,Howmet Aerospace,5,18,2,25,
2025-08-18,James Zallie,Ingredion,4,5,1,10,
2025-08-18,Thomas Hill,Vulcan Materials,4,8,2,14,
2025-08-19,Doug McMillon,Walmart,14,23,3,40,
2025-08-19,Andrew Jassy,Amazon,6,29,5,40,
2025-08-19,Stephen Hemsley,UnitedHealth,7,26,7,40,
2025-08-19,Tim Cook,Apple,20,18,2,40,
2025-08-19,David Joyner,CVS Health,7,29,4,40,
2025-08-19,Warren Buffett,Berkshire Hathaway,13,26,1,40,
2025-08-19,Sundar Pichai,Alphabet,18,17,5,40,
2025-08-19,Darren Woods,Exxon Mobil,12,20,7,39,
2025-08-19,Brian Tyler,McKesson,4,14,5,23,
2025-08-19,Robert Mauch,Cencora,4,6,0,10,
2025-08-19,Jamie Dimon,JPMorgan Chase,9,20,11,40,
2025-08-19,Ron Vachris,Costco,7,31,2,40,
2025-08-19,David Cordani,Cigna,22,15,3,40,
2025-08-19,Satya Nadella,Microsoft,15,15,10,40,
2025-08-19,Jason Hollar,Cardinal Health,13,23,4,40,
2025-08-19,Mike Wirth,Chevron,18,15,7,40,
2025-08-19,Brian Moynihan,Bank of America,5,25,10,40,
2025-08-19,Mary Barra,General Motors,11,26,3,40,
2025-08-19,Jim Farley,Ford Motor,14,20,6,40,
2025-08-19,Gail Boudreaux,Elevance Health,15,18,7,40,
2025-08-19,Jane Fraser,Citi,12,22,6,40,
2025-08-19,Mark Zuckerberg,Meta,15,19,6,40,
2025-08-19,Sarah London,Centene,12,20,8,40,
2025-08-19,Ted Decker,Home Depot,8,25,7,40,
2025-08-19,Priscilla Almodovar,Fannie Mae,10,16,13,39,
2025-08-19,Tim Wentworth,Walgreens,8,23,9,40,
2025-08-19,Ron Sargent,Kroger,5,21,14,40,
2025-08-19,Mark Lashier,Phillips 66,9,20,9,38,
2025-08-19,Maryann Mannen,Marathon Petroleum,6,14,1,21,
2025-08-19,Hans Vestberg,Verizon,17,20,3,40,
2025-08-19,Jensen Huang,Nvidia,12,19,9,40,
2025-08-19,David Solomon,Goldman Sachs,5,23,12,40,
2025-08-19,Charles Scharf,Wells Fargo,27,7,6,40,
2025-08-19,Lane Riggs,Valero Energy,14,9,0,23,
2025-08-19,Brian Roberts,Comcast,10,28,2,40,
2025-08-19,Jon Farney,State Farm,10,27,3,40,
2025-08-19,John Stankey,AT&T,11,25,4,40,
2025-08-19,Michael Hutchins,Freddie Mac,3,11,3,17,
2025-08-19,Jim Rechtin,Humana,18,18,4,40,
2025-08-19,Ted Pick,Morgan Stanley,17,20,3,40,
2025-08-19,Brian Cornell,Target,9,21,10,40,
2025-08-19,Philip Smith,StoneX,0,9,1,10,
2025-08-19,Elon Musk,Tesla,14,12,14,40,
2025-08-19,Michael Dell,Dell Technologies,12,25,3,40,
2025-08-19,Ramon Laguarta,PepsiCo,8,28,4,40,
2025-08-19,Bob Iger,Walt Disney,12,26,2,40,
2025-08-19,Carol Tom√©,UPS,8,21,11,40,
2025-08-19,Joaquin Duato,Johnson & Johnson,8,27,5,40,
2025-08-19,Rajesh Subramaniam,FedEx,10,24,0,34,
2025-08-19,Juan Luciano,Archer Daniels Midland,3,20,16,39,
2025-08-19,Jon Moeller,Procter & Gamble,5,29,6,40,
2025-08-19,Marvin Ellison,Lowe's,17,16,5,38,
2025-08-19,Thomas Long,Energy Transfer,9,0,1,10,
2025-08-19,Christopher Calio,RTX,6,11,0,17,
2025-08-19,Susan Morris,Albertsons,9,27,4,40,
2025-08-19,Kevin Hourican,Sysco,10,27,3,40,
2025-08-19,Tricia Griffith,Progressive,12,23,4,39,
2025-08-19,Stephen Squeri,American Express,15,23,2,40,
2025-08-19,James Taiclet,Lockheed Martin,12,18,10,40,
2025-08-19,Michel Khalaf,MetLife,12,18,0,30,
2025-08-19,Samuel Hazen,HCA Healthcare,9,6,0,15,
2025-08-19,Andrew Sullivan,Prudential Financial,14,24,0,38,
2025-08-19,Kelly Ortberg,Boeing,12,23,5,40,
2025-08-19,Joe Creed,Caterpillar,11,25,2,38,
2025-08-19,Robert M Davis,Merck,3,20,0,23,
2025-08-19,Thomas J Wilson,Allstate,1,11,1,13,
2025-08-19,Albert Bourla,Pfizer,20,12,8,40,
2025-08-19,Arvind Krishna,IBM,15,19,6,40,
2025-08-19,Craig DeSanto,New York Life Insurance,4,15,0,19,
2025-08-19,Ed Bastian,Delta Airlines,17,13,9,39,
2025-08-19,Kevin Murphy,Ferguson,8,24,4,36,
2025-08-19,Kirt Walker,Nationwide,14,17,2,33,
2025-08-19,Patrick Zammit,TD Synnex,9,15,0,24,
2025-08-19,Scott Kirby,United Airlines,33,4,3,40,
2025-08-19,Ryan Lance,ConocoPhillips,17,20,3,40,
2025-08-19,Ernie Herrman,TJX,17,22,1,40,
2025-08-19,Bob Michael,AbbVie,0,0,0,0,
2025-08-19,AJ Jim Teague,Enterprise Products Partners,6,8,0,14,
2025-08-19,Christopher Winfrey,Charter Communications,5,14,5,24,
2025-08-19,George Holm,Performance Food,11,22,2,35,
2025-08-19,Robert Isom,American Airlines,8,23,9,40,
2025-08-19,Richard Fairbank,Capital One,16,20,4,40,
2025-08-19,Chuck Robbins,Cisco Systems,14,22,4,40,
2025-08-19,Enrique Lores,HP,12,23,5,40,
2025-08-19,Donnie King,Tyson Foods,11,24,5,40,
2025-08-19,Lip-Bu Tan,Intel,3,24,12,39,
2025-08-19,Safra Catz,Oracle,11,21,8,40,
2025-08-19,Hock Tan,Broadcom,13,23,4,40,
2025-08-19,John May,Deere,9,27,4,40,
2025-08-19,Elliott Hill,Nike,12,24,4,40,
2025-08-19,Timothy M Sweeney,Liberty Mutual Insurance,14,0,0,14,
2025-08-19,Wilfred Chiang,Plains GP,1,1,0,2,
2025-08-19,Juan Andrade,USAA,5,15,0,20,
2025-08-19,Chris Boerner,Bristol-Myers Squibb,11,22,7,40,
2025-08-19,Paul Bay,Ingram Micro,10,25,5,40,
2025-08-19,Phebe Novakovic,General Dynamics,27,9,4,40,
2025-08-19,James Quincey,Coca-Cola,9,29,2,40,
2025-08-19,Thasunda Brown Duckett,TIAA,20,20,0,40,
2025-08-19,Alan Schnitzer,Travelers,14,18,8,40,
2025-08-19,David Ricks,Eli Lilly,8,22,10,40,
2025-08-19,Dara Khosrowshahi,Uber,14,21,5,40,
2025-08-19,Roger Crandall,Mass Mutual,3,7,0,10,
2025-08-19,Marc Casper,Thermo Fisher Scientific,13,24,3,40,
2025-08-19,Gunjan Kedia,US Bancorp,12,26,2,40,
2025-08-19,Michael Kasbar,World Kinect,2,10,0,12,
2025-08-19,Robert Ford,Abbott Laboratories,12,23,5,40,
2025-08-19,Corie Barry,Best Buy,38,2,0,40,
2025-08-19,Tim Gerend,Northwestern Mutual,14,25,1,40,
2025-08-19,Kathy Warden,Northrop Grumman,17,19,4,40,
2025-08-19,Joe Zubretsky,Molina Healthcare,8,7,4,19,
2025-08-19,Todd Vasos,Dollar General,6,21,13,40,
2025-08-19,Robin Vince,Bank of New York,19,17,4,40,
2025-08-19,David Zaslav,Warner Bros Discovery,7,22,11,40,
2025-08-19,Jay Debertin,CHS,4,8,3,15,
2025-08-19,Ted Sarandos,Netflix,13,25,2,40,
2025-08-19,Cristiano Amon,Qualcomm,11,27,1,39,
2025-08-19,Larry Culp,General Electric,11,26,3,40,
2025-08-19,Vimal Kapur,Honeywell,10,30,0,40,
2025-08-19,Marc Benioff,Salesforce,9,24,7,40,
2025-08-19,Jacek Olczak,Philip Morris,13,23,4,40,
2025-08-19,David Flitman,US Foods,2,7,0,9,
2025-08-19,Paul Romanowski,DR Horton,6,16,3,25,
2025-08-19,Bryan DeBoer,Lithia Motors,11,26,2,39,
2025-08-19,Dirk Van de Put,Mondelez,14,24,2,40,
2025-08-19,Brian Niccol,Starbucks,8,32,0,40,
2025-08-19,Ryan McInerney,Visa,15,21,4,40,
2025-08-19,Robert Sulentic,CBRE,1,7,1,9,
2025-08-19,Jonathan Jaffe,Lennar,1,8,1,10,
2025-08-19,Scott Strazik,GE Vernova,12,24,4,40,
2025-08-19,William Demchak,PNC,13,22,5,40,
2025-08-19,Jennifer Rumsey,Cummins,8,27,5,40,
2025-08-19,Preston Feight,Paccar,8,29,2,39,
2025-08-19,Robert Bradway,Amgen,9,28,3,40,
2025-08-19,Matthew Lucey,PBF Energy,5,2,1,8,
2025-08-19,Pat Geraghty,GuideWell Mutual,2,6,0,8,
2025-08-19,Alex Chriss,PayPal,12,26,2,40,
2025-08-19,Sandy Douglas,United Natural Foods,33,7,0,40,
2025-08-19,Michael Creedon,Dollar Tree,3,36,1,40,
2025-08-19,Leon Topalian,Nucor,15,22,3,40,
2025-08-19,Roger Penske,Penske Automotive,17,22,1,40,
2025-08-19,Bom Kim,Coupang,10,29,1,40,
2025-08-19,Antonio Neri,Hewlett Packard,8,23,9,40,
2025-08-19,Harry Sideris,Duke Energy,35,4,0,39,
2025-08-19,Joseph Bae,KKR,20,18,2,40,
2025-08-19,Brian Robbins,Paramount Global,8,27,1,36,
2025-08-19,Michael Dastoor,Jabil,2,6,0,8,
2025-08-19,Daniel O'Day,Gilead Sciences,18,19,3,40,
2025-08-19,Tim Go,HF Sinclair,6,4,0,10,
2025-08-19,William Nash,CarMax,4,2,2,8,
2025-08-19,Michael Miebach,Mastercard,10,26,4,40,
2025-08-19,Lawrence Coben,NRG Energy,7,2,0,9,
2025-08-19,Sean Kerins,Arrow Electronics,3,14,0,17,
2025-08-19,Lorenzo Simonelli,Baker Hughes,15,21,4,40,
2025-08-19,Bob Jordan,Southwest Airlines,9,23,8,40,
2025-08-19,Peter Zaffino,American International,8,29,3,40,
2025-08-19,Gary Dickerson,Applied Materials,8,21,11,40,
2025-08-19,Vicki Hollub,Occidental Petroleum,19,17,3,39,
2025-08-19,Michael Manley,AutoNation,3,6,1,10,
2025-08-19,Christopher Womack,Southern,2,7,0,9,
2025-08-19,Christopher Swift,Hartford Insurance,6,4,0,10,
2025-08-19,Marc Rowan,Apollo Global Management,16,20,4,40,
2025-08-19,Rick Wurster,Charles Schwab,14,21,4,39,
2025-08-19,Chris Kempczinski,McDonald's,13,19,8,40,
2025-08-19,Carlos Abrams-Rivera,Kraft Heinz,13,21,6,40,
2025-08-19,Lisa Su,Advanced Micro Devices,17,19,4,40,
2025-08-19,William H Rogers Jr,Truist Financial,2,7,1,10,
2025-08-19,Kathleen Quirk,Freeport-McMoRan,13,18,3,34,
2025-08-19,Sanjay Mehrotra,Micron Technology,20,18,2,40,
2025-08-19,Anthony Capuano,Marriott International,11,26,3,40,
2025-08-19,David Gitlin,Carrier Global,18,21,1,40,
2025-08-19,John Ketchum,NextEra Energy,22,17,1,40,
2025-08-19,William M Brown,3M,2,8,0,10,
2025-08-19,John Doyle,Marsh & McLennan,12,9,1,22,
2025-08-19,Patricia Poppe,PG&E,8,15,2,25,
2025-08-19,Jim Vena,Union Pacific,19,21,0,40,
2025-08-19,Brian Doubles,Synchrony Financial,5,7,2,14,
2025-08-19,Rainer Blair,Danaher,6,14,1,21,
2025-08-19,Philip Gallagher,Avnet,1,5,0,6,
2025-08-19,Glenn Fogel,Booking s,0,3,1,4,
2025-08-19,Ezra Yacob,EOG Resources,23,13,0,36,
2025-08-19,Earl Austin,Quanta Services,2,3,2,7,
2025-08-19,Michael Shepherd,Discover Financial,11,14,2,27,
2025-08-19,Joseph Dominguez,Constellation Energy,14,9,1,24,
2025-08-19,William Stengel II,Genuine Parts,0,4,0,4,
2025-08-19,Christian Ulbrich,Jones Lang LaSalle,10,20,0,30,
2025-08-19,Raymond E Scott,Lear Corporation,5,4,0,9,
2025-08-19,Michael Rapino,Live Nation Entertainment,13,23,4,40,
2025-08-19,Heidi Petz,Sherwin-Williams,7,28,3,38,
2025-08-19,Calvin G Butler Jr,Exelon,6,5,0,11,
2025-08-19,Tony Spring,Macy's,11,26,3,40,
2025-08-19,Jeff Miller,Halliburton,16,20,4,40,
2025-08-19,Kevin Lobo,Stryker,12,26,2,40,
2025-08-19,Tony Cheng,Reinsurance of America,0,0,0,0,
2025-08-19,Ronald P O'Hanley,State Street,5,15,0,20,
2025-08-19,John Engel,WESCO International,5,10,1,16,
2025-08-19,Pierce Norton II,Oneok,5,3,1,9,
2025-08-19,Shantanu Narayen,Adobe,19,20,1,40,
2025-08-19,Bill Westrate,American Family Insurance,9,15,2,26,
2025-08-19,Chris Kubasik,L3Harris Technologies,5,13,0,18,
2025-08-19,James Conroy,Ross Stores,5,12,0,17,
2025-08-19,Christine Leahy,CDW,1,9,2,12,
2025-08-19,Saumya Sutaria,Tenet Healthcare,4,4,1,9,
2025-08-19,Bob Eddy,BJ's Wholesale Club,6,31,3,40,
2025-08-19,Mike Lyons,Fiserv,4,10,0,14,
2025-08-19,William Gifford,Altria,2,6,1,9,
2025-08-19,Larry Fink,BlackRock,7,26,7,40,
2025-08-19,Thomas Polen,Becton Dickinson,7,3,0,10,
2025-08-19,Noel Wallace,Colgate-Palmolive,11,23,2,36,
2025-08-19,Michael Hsu,Kimberly-Clark,6,5,2,13,
2025-08-19,Daryl Kenningham,1 Automotive,8,20,1,29,
2025-08-19,Jennifer Parmentier,Parker-Hannifin,2,12,0,14,
2025-08-19,Jeffrey Harmening,General Mills,5,17,5,27,
2025-08-19,Ravi Kumar S,Cognizant Technology,10,25,3,38,
2025-08-19,William Fehrman,American Electric Power,4,6,0,10,
2025-08-19,Peter Arduini,GE HealthCare Technologies,6,12,0,18,
2025-08-19,Maria Black,Automatic Data Processing,5,5,0,10,
2025-08-19,Lourenco Goncalves,Cleveland-Cliffs,9,21,10,40,
2025-08-19,Dan Amos,Aflac,11,21,8,40,
2025-08-19,Mark Stewart,Goodyear Tire & Rubber,4,34,2,40,
2025-08-19,Kevin Hogan,Corebridge Financial,5,11,0,16,
2025-08-19,Thomas Palmer,Newmont,5,5,0,10,
2025-08-19,Andrew Silvernail,International Paper,6,23,0,29,
2025-08-19,Philip Daniele III,AutoZone,0,1,0,1,
2025-08-19,Ellen Cooper,Lincoln National,4,6,0,10,
2025-08-19,Ryan Marshall,Pulte,6,7,7,20,
2025-08-19,James Cracchiolo,Ameriprise Financial,2,25,2,29,
2025-08-19,Andrew Clyde,Murphy USA,14,25,1,40,
2025-08-19,Jonas Prising,Manpower,10,6,1,17,
2025-08-19,David Bozeman,CH Robinson Worldwide,2,7,1,10,
2025-08-19,Timothy Knavish,PPG Industries,1,2,0,3,
2025-08-19,Pedro Pizarro,Edison International,15,8,17,40,
2025-08-19,Mark Millett,Steel Dynamics,15,3,0,18,
2025-08-19,Benjamin Tisch,Loews,2,7,0,9,
2025-08-19,Karsanbhai,Emerson Electric,10,18,3,31,
2025-08-19,John Zillmer,Aramark,8,16,2,26,
2025-08-19,William Hornbuckle,MGM Resorts International,5,25,1,31,
2025-08-19,James Burke,Vistra,6,3,0,9,
2025-08-19,David Hult,Asbury Automotive,8,31,1,40,
2025-08-19,DG Macpherson,WW Grainger,2,7,1,10,
2025-08-19,Eric Slifka,Global Partners,13,22,5,40,
2025-08-19,Bob Pragada,Jacobs Solutions,6,8,0,14,
2025-08-19,Charles Magro,Corteva,5,3,1,9,
2025-08-19,Rick Lanoha,Peter Kiewit Sons',0,2,0,2,
2025-08-19,Michael Mahoney,Boston Scientific,10,28,0,38,
2025-08-19,Brad Beckham,O'Reilly Automotive,4,15,2,21,
2025-08-19,Thomas Bell,Leidos,9,19,1,29,
2025-08-19,Thomas Gayner,Markel,4,10,2,16,
2025-08-19,Marc Bitzer,Whirlpool,12,14,14,40,
2025-08-19,Andrew McMahon,Guardian Life,5,12,0,17,
2025-08-19,Peter Jackson,Builders FirstSource,5,12,1,18,
2025-08-19,Michael Rhodes,Ally Financial,10,25,5,40,
2025-08-19,Matthew Meloy,Targa Resources,5,5,0,10,
2025-08-19,James Breuer,Fluor,0,2,1,3,
2025-08-19,Sasan Goodarzi,Intuit,10,26,4,40,
2025-08-19,Troy Rudd,AECOM,7,24,5,36,
2025-08-19,Penny Pennington,Edward Jones,6,29,5,40,
2025-08-19,Michael Bender,Kohl's,1,24,15,40,
2025-08-19,Beth Ford,Land O'Lakes,19,20,1,40,
2025-08-19,Deanna Strable-Soethout,Principal Financial,1,7,0,8,
2025-08-19,Robert Blue,Dominion Energy,27,10,2,39,
2025-08-19,Martin Schroeter,Kyndryl s,0,10,0,10,
2025-08-19,Jon Vander Ark,Republic Services,10,20,10,40,
2025-08-19,Clay Gaspar,Devon Energy,18,3,0,21,
2025-08-19,Christopher O'Herlihy,Illinois Tool Works,3,5,2,10,
2025-08-19,Michael O'Grady,Northern Trust,22,6,1,29,
2025-08-19,Jamie Whisnant,Auto-Owners Insurance,0,2,0,2,
2025-08-19,Marc Miller,Universal Health Services,3,20,3,26,
2025-08-19,Darryl Button,Pacific Life,1,6,0,7,
2025-08-19,Hamid Akhavan,EchoStar,3,25,12,40,
2025-08-19,Christophe Beck,Ecolab,18,22,0,40,
2025-08-19,Jack Fusco,Cheniere Energy,17,20,3,40,
2025-08-19,John Wren,Omnicom,8,20,12,40,
2025-08-19,Haviv Ilan,Texas Instruments,11,27,2,40,
2025-08-19,David Burritt,United States Steel,8,17,15,40,
2025-08-19,St√©phane de La Faverie,Est√©e Lauder,13,25,2,40,
2025-08-19,Raul Nicholas Vargas Ochoa,Farmers Insurance Exchange,0,0,0,0,
2025-08-19,Thibaut Mongon,Kenvue,10,29,1,40,
2025-08-19,Ari Bousbib,IQVIA s,0,0,0,0,
2025-08-19,Donald Allan,Stanley Black & Decker,9,30,1,40,
2025-08-19,Timothy Cofer,Keurig Dr Pepper,2,2,1,5,
2025-08-19,Matthew Flannery,United Rentals,34,3,0,37,
2025-08-19,Timothy Cawley,Consolidated Edison,5,5,0,10,
2025-08-19,Adam Norwitt,Amphenol,6,19,0,25,
2025-08-19,Brent Shafer,Baxter International,1,11,0,12,
2025-08-19,Kimberly Dang,Kinder Morgan,9,1,0,10,
2025-08-19,Erik Nordstrom,Nordstrom,7,27,5,39,
2025-08-19,Frank Holding,First Citizens BancShares,10,15,2,27,
2025-08-19,Paul Shoukry,Raymond James Financial,14,25,1,40,
2025-08-19,Timothy Archer,Lam Research,2,7,1,10,
2025-08-19,Harry Lawton III,Tractor Supply,1,1,0,2,
2025-08-19,Darren Rebelez,Casey's General Stores,15,23,2,40,
2025-08-19,Scott Smith,Viatris,7,4,0,11,
2025-08-19,James Blackledge,Mutual of Omaha Insurance,0,6,0,6,
2025-08-19,Anthony Guzzi,EMCOR,4,3,0,7,
2025-08-19,Joseph Hinrichs,CSX,5,9,1,15,
2025-08-19,Justin Jude,LKQ,4,6,1,11,
2025-08-19,Judith Marks,Otis Worldwide,2,4,0,6,
2025-08-19,David Bruton Smith,Sonic Automotive,4,9,9,22,
2025-08-19,Martina Cheung,S&P Global,11,22,0,33,
2025-08-19,Leonard Schleifer,Regeneron Pharmaceuticals,5,27,8,40,
2025-08-19,Joseph Fadool,BorgWarner,4,10,0,14,
2025-08-19,Lachlan Murdoch,Fox,5,29,6,40,
2025-08-19,Karla Lewis,Reliance,3,5,1,9,
2025-08-19,John Barrett,Western & Southern Financial,8,30,2,40,
2025-08-19,Scott Donnelly,Textron,9,28,3,40,
2025-08-19,Ariane Gorin,Expedia,8,31,1,40,
2025-08-19,Michael Nolan,Fidelity National Financial,4,0,0,4,
2025-08-19,Ernest Garcia III,Carvana,23,13,4,40,
2025-08-19,Raul Fernandez,DXC Technology,4,33,1,38,
2025-08-19,Robert Berkley,WR Berkley,8,28,4,40,
2025-08-19,Ren√© Jones,M&T Bank,12,24,4,40,
2025-08-19,Lauren Hobart,Dick's Sporting Goods,9,27,4,40,
2025-08-19,Robert Frenzel,Xcel Energy,4,2,1,7,
2025-08-19,Timothy Spence,Fifth Third Bancorp,4,6,0,10,
2025-08-19,Stephen Schwarzman,Blackstone,20,17,3,40,
2025-08-19,Walker Martin,Sempra,0,2,0,2,
2025-08-19,Timothy NeCastro,Erie Insurance,3,6,1,10,
2025-08-19,Wendell Weeks,Corning,14,24,2,40,
2025-08-19,Kathleen Johnson,Lumen Technologies,4,3,1,8,
2025-08-19,Brian Tierney,FirstEnergy,4,24,2,30,
2025-08-19,Adam Schechter,Labcorp,7,20,1,28,
2025-08-19,Tiang Yew Tan,Western Digital,2,0,0,2,
2025-08-19,Richard McKenney,Unum,4,5,0,9,
2025-08-19,Javier Rodriguez,DaVita,13,14,1,28,
2025-08-19,Steven Cahillane,Kellanova,2,7,0,9,
2025-08-19,Stanley Bergman,Henry Schein,11,28,1,40,
2025-08-19,Robert Sanchez,Ryder System,10,10,1,21,
2025-08-19,Tim Hingtgen,Community Health Systems,11,27,2,40,
2025-08-19,Avigal Soreq,Delek US,3,10,5,18,
2025-08-19,Gerardo Norcia,DTE Energy,6,3,0,9,
2025-08-19,Mark Pearson,Equitable,8,9,0,17,
2025-08-19,Lori Koch,DuPont,8,19,0,27,
2025-08-19,Rich Steinmeier,LPL Financial,24,14,2,40,
2025-08-19,Bruce Van Saun,Citizens Financial,11,26,3,40,
2025-08-19,Jos√© Mas,MasTec,6,14,3,23,
2025-08-19,Andr√©s Gluski,AES,15,14,0,29,
2025-08-19,Kevin Kwilinski,Berry Global,8,19,0,27,
2025-08-19,Mark George,Norfolk Southern,16,21,3,40,
2025-08-19,Eduardo Menezes,Air Products & Chemicals,4,5,1,10,
2025-08-19,Shelley Simpson,JB Hunt Transport Services,6,31,3,40,
2025-08-19,Daniel Fisher,Ball,3,19,6,28,
2025-08-19,Sean Connolly,Conagra Brands,7,31,2,40,
2025-08-19,Stephen Steinour,Huntington Bancshares,2,8,0,10,
2025-08-19,James Snee,Hormel Foods,3,30,1,34,
2025-08-19,Joseph Nolan,Eversource Energy,4,4,1,9,
2025-08-19,William Oplinger,Alcoa,9,18,3,30,
2025-08-19,Andrew Marsh,Entergy,2,6,0,8,
2025-08-19,Keith Demmings,Assurant,3,8,0,11,
2025-08-19,Sumit Singh,Chewy,14,20,6,40,
2025-08-19,Niraj Shah,Wayfair,8,25,7,40,
2025-08-19,Joseph Ferraro,Avis Budget,3,6,1,10,
2025-08-19,Jeffrey Sprecher,Intercontinental Exchange,14,23,3,40,
2025-08-19,Benito Minicucci,Alaska Air,4,3,1,8,
2025-08-19,Malcolm Wilson,GXO Logistics,7,23,0,30,
2025-08-19,Eric Hansotia,AGCO,17,22,1,40,
2025-08-19,Kathleen Mazzarella,Graybar Electric,1,9,0,10,
2025-08-19,Gavin Hattersley,Molson Coors Beverage,3,31,6,40,
2025-08-19,Patrick Gallagher,Arthur J Gallagher,10,28,2,40,
2025-08-19,Christopher Kastner,Huntington Ingalls Industries,3,4,0,7,
2025-08-19,Erik Fyrwald,International Flavors & Fragrances,7,8,2,17,
2025-08-19,Ricardo Cardenas,Darden Restaurants,4,4,1,9,
2025-08-19,Stephen Spray,Cincinnati Financial,1,6,3,10,
2025-08-19,Scott Boatwright,Chipotle Mexican Grill,7,29,4,40,
2025-08-19,Joey Wat,Yum China,12,25,3,40,
2025-08-19,Robert Goldstein,Las Vegas Sands,4,31,5,40,
2025-08-19,Kecia Steelman,Ulta Beauty,32,7,1,40,
2025-08-19,Thomas Reeg,Caesars Entertainment,4,6,1,11,
2025-08-19,Jon Rousseau,BrightSpring Health Services,21,18,1,40,
2025-08-19,William Krueger,Andersons,0,4,0,4,
2025-08-19,Michele Buck,Hershey,9,29,2,40,
2025-08-19,Christopher Nassetta,Hilton,15,23,2,40,
2025-08-19,Bruce Bodine,Mosaic,3,7,0,10,
2025-08-19,Brian Chesky,Airbnb,2,29,9,40,
2025-08-19,Kaes Van‚Äôt Hof,Diamondback Energy,23,14,2,39,
2025-08-19,Steven Vondran,American Tower,4,7,0,11,
2025-08-19,Reshma Kewalramani,Vertex Pharmaceuticals,23,14,3,40,
2025-08-19,William McDermott,ServiceNow,3,6,0,9,
2025-08-19,Brian Chambers,Owens Corning,3,12,1,16,
2025-08-19,Teresa Rasmussen,Thrivent Financial for Lutherans,4,1,0,5,
2025-08-19,Shane O'Kelly,Advance Auto Parts,15,22,3,40,
2025-08-19,Douglas Yearley,Toll Brothers,10,26,4,40,
2025-08-19,Jeffrey Lorberbaum,Mohawk Industries,10,5,2,17,
2025-08-19,Gregory Brown,Motorola Solutions,1,9,0,10,
2025-08-19,John Pfeifer,Oshkosh,6,26,4,36,
2025-08-19,Tony Xu,DoorDash,13,20,7,40,
2025-08-19,Edward Pesicka,Owens & Minor,2,32,2,36,
2025-08-19,Eugene Bredow,NVR,0,4,0,4,
2025-08-19,Philippe Krakowsky,Interpublic,15,21,4,40,
2025-08-19,Horacio Rozanski,Booz Allen Hamilton,15,20,5,40,
2025-08-19,Michael O‚ÄôSullivan,Burlington Stores,9,28,3,40,
2025-08-19,Daniel Wall,Expeditors International of Washington,4,3,0,7,
2025-08-19,Calvin McDonald,Lululemon athletica,10,28,2,40,
2025-08-19,Stephanie Ferris,Fidelity National Information,14,20,4,38,
2025-08-19,Rich Handler,Jefferies Financial,13,13,2,28,
2025-08-19,Alan Armstrong,Williams,25,12,3,40,
2025-08-19,Bracken Darrell,VF Corporation,8,27,5,40,
2025-08-19,Mikael Bratt,Autoliv,7,8,2,17,
2025-08-19,Rafael Santana,Westinghouse Air Brake Technologies,5,6,0,11,
2025-08-19,Ralph LaRossa,Public Service Enterprise,7,16,0,23,
2025-08-19,Jamie Iannone,Ebay,18,18,4,40,
2025-08-19,Scott Richardson,Celanese,9,28,3,40,
2025-08-19,Cameron Bready,Global Payments,8,29,3,40,
2025-08-19,Robert Thomson,News Corp,6,28,5,39,
2025-08-19,Robert Martin,THOR Industries,4,5,1,10,
2025-08-19,David Rawlinson II,QVC,6,13,2,21,
2025-08-19,Andrew Teno,Icahn Enterprises,5,5,0,10,
2025-08-19,William Newlands,Constellation Brands,0,2,2,4,
2025-08-19,James Davis,Quest Diagnostics,4,5,1,10,
2025-08-19,Richard Wallace,KLA,2,5,0,7,
2025-08-19,Julian Francis,QXO Building Products,0,0,0,0,
2025-08-19,John Christmann IV,APA,5,4,1,10,
2025-08-19,Gregory Roberts,A-Mark Precious Metals,2,2,1,5,
2025-08-19,Christopher Viehbacher,Biogen,0,29,2,31,
2025-08-19,Mick Beekhuizen,Campbell's,6,23,3,32,
2025-08-19,Christopher Caldwell,Concentrix,2,5,0,7,
2025-08-19,Todd Schneider,Cintas,11,17,1,29,
2025-08-19,Tony Sarsam,SpartanNash,17,21,2,40,
2025-08-19,John Venhuizen,Ace Hardware,16,23,1,40,
2025-08-19,Vincent Roche,Analog Devices,15,23,2,40,
2025-08-19,Mark Costa,Eastman Chemical,7,16,4,27,
2025-08-19,Milan Galik,Interactive Brokers,5,14,0,19,
2025-08-19,John Turner,Regions Financial,19,19,2,40,
2025-08-19,Joanna Geraghty,JetBlue Airways,18,15,7,40,
2025-08-19,Kristin Peck,Zoetis,12,18,1,31,
2025-08-19,Christopher Gorman,KeyCorp,4,5,0,9,
2025-08-19,Mark Bertolini,Oscar Health,12,19,8,39,
2025-08-19,Brendan McCracken,Ovintiv,7,5,1,13,
2025-08-19,Robert Steer,Seaboard,1,4,0,5,
2025-08-19,Gil West,Hertz,7,25,8,40,
2025-08-19,Robert Greenberg,Skechers,7,31,2,40,
2025-08-19,Dennis Mathew,Altice,5,26,7,38,
2025-08-19,Clay Williams,NOV,13,22,4,39,
2025-08-19,Michael Doss,Graphic Packaging,6,8,2,16,
2025-08-19,Deon Stander,Avery Dennison,0,11,0,11,
2025-08-19,Adaire Fox-Martin,Equinix,16,20,4,40,
2025-08-19,Joyce Mullen,Insight Enterprises,6,11,1,18,
2025-08-19,Jennifer Witz,Sirius XM,8,13,5,26,
2025-08-19,Stefan Larsson,PVH,8,26,6,40,
2025-08-19,Jason P Wells,CenterPoint Energy,6,4,0,10,
2025-08-19,Scott Lauber,WEC Energy,15,6,0,21,
2025-08-19,Matthew Pine,Xylem,2,10,1,13,
2025-08-19,Jennifer Johnson,Franklin Resources,2,7,1,10,
2025-08-19,Vincent Sorgi,PPL,8,11,1,20,
2025-08-19,Carl Eschenbach,Workday,10,20,10,40,
2025-08-19,Richard Tobin,Dover,3,6,1,10,
2025-08-19,Mark Kowlzan,Packaging Corp of America,1,9,1,11,
2025-08-19,Scott Salmirs,ABM Industries,6,7,1,14,
2025-08-19,Gary Guthart,Intuitive Surgical,12,24,4,40,
2025-08-19,Carl Lindner lll,American Financial,0,0,0,0,
2025-08-19,Blake Moret,Rockwell Automation,12,27,1,40,
2025-08-19,Bryan Hanson,Solventum,6,11,2,19,
2025-08-19,Craig Smiddy,Old Republic International,2,6,1,9,
2025-08-19,Christopher Hilger,Securian Financial,0,5,1,6,
2025-08-19,Hamid Moghadam,Prologis,7,27,6,40,
2025-08-19,Mark Smucker,JM Smucker,10,23,7,40,
2025-08-19,Sheryl Palmer,Taylor Morrison Home,6,12,1,19,
2025-08-19,Mario Harik,XPO,7,32,1,40,
2025-08-19,Heather Lavallee,Voya Financial,7,9,2,18,
2025-08-19,Nikesh Arora,Palo Alto Networks,9,23,8,40,
2025-08-19,Giordano Albertazzi,Vertiv s,0,1,0,1,
2025-08-19,Shankh Mitra,Welltower,17,21,2,40,
2025-08-19,Mary Dillon,Foot Locker,11,24,5,40,
2025-08-19,William Monteleone,Par Pacific,1,7,2,10,
2025-08-19,Kevin Stein,TransDigm,10,9,2,21,
2025-08-19,Peter Matt,Commercial Metals,5,4,0,9,
2025-08-19,Robert Vitale,Post s,0,0,0,0,
2025-08-19,Keith Allman,Masco,6,9,1,16,
2025-08-19,Rusty Rush,Rush Enterprises,17,20,3,40,
2025-08-19,Stuart Bradie,KBR,14,18,4,36,
2025-08-19,Jack Sinclair,Sprouts Farmers Market,15,24,1,40,
2025-08-19,Laura Alber,Williams-Sonoma,10,24,6,40,
2025-08-19,Ivan Tornos,Zimmer Biomet s,1,2,0,3,
2025-08-19,John Mengucci,CACI International,21,17,2,40,
2025-08-19,Steve Sanghi,Microchip Technology,8,29,3,40,
2025-08-19,Albert Nahmad,Watsco,2,6,2,10,
2025-08-19,Christopher Peterson,Newell Brands,1,8,1,10,
2025-08-19,Arie Kotler,ARKO,5,24,1,30,
2025-08-19,Jure Sola,Sanmina,3,15,1,19,
2025-08-19,Andrew Wilson,Electronic Arts,15,15,10,40,
2025-08-19,David Gibbs,Yum Brands,2,36,2,40,
2025-08-19,Daniel Florness,Fastenal,3,5,1,9,
2025-08-19,Garrick Rochow,CMS Energy,12,3,0,15,
2025-08-19,Rodney Sacks,Monster Beverage,15,22,2,39,
2025-08-19,Mark Shapiro,Endeavor,4,35,1,40,
2025-08-19,Toni Townes-Whitley,Science Applications International,13,23,1,37,
2025-08-19,Mark Witkowski,Core & Main,1,7,1,9,
2025-08-19,John Plant,Howmet Aerospace,5,17,2,24,
2025-08-19,James Zallie,Ingredion,4,5,1,10,
2025-08-19,Thomas Hill,Vulcan Materials,4,7,2,13,
2025-08-20,Doug McMillon,Walmart,14,20,6,40,
2025-08-20,Andrew Jassy,Amazon,5,27,5,37,
2025-08-20,Stephen Hemsley,UnitedHealth,8,25,7,40,
2025-08-20,Tim Cook,Apple,19,21,0,40,
2025-08-20,David Joyner,CVS Health,7,29,4,40,
2025-08-20,Warren Buffett,Berkshire Hathaway,13,23,4,40,
2025-08-20,Sundar Pichai,Alphabet,16,17,7,40,
2025-08-20,Darren Woods,Exxon Mobil,11,21,7,39,
2025-08-20,Brian Tyler,McKesson,4,14,5,23,
2025-08-20,Robert Mauch,Cencora,4,6,0,10,
2025-08-20,Jamie Dimon,JPMorgan Chase,10,18,12,40,
2025-08-20,Ron Vachris,Costco,7,32,1,40,
2025-08-20,David Cordani,Cigna,22,15,3,40,
2025-08-20,Satya Nadella,Microsoft,18,15,7,40,
2025-08-20,Jason Hollar,Cardinal Health,13,23,4,40,
2025-08-20,Mike Wirth,Chevron,19,16,5,40,
2025-08-20,Brian Moynihan,Bank of America,5,28,7,40,
2025-08-20,Mary Barra,General Motors,12,24,4,40,
2025-08-20,Jim Farley,Ford Motor,13,22,5,40,
2025-08-20,Gail Boudreaux,Elevance Health,15,18,7,40,
2025-08-20,Jane Fraser,Citi,10,22,8,40,
2025-08-20,Mark Zuckerberg,Meta,11,22,7,40,
2025-08-20,Sarah London,Centene,11,22,7,40,
2025-08-20,Ted Decker,Home Depot,10,21,9,40,
2025-08-20,Priscilla Almodovar,Fannie Mae,10,17,12,39,
2025-08-20,Tim Wentworth,Walgreens,8,22,9,39,
2025-08-20,Ron Sargent,Kroger,5,21,14,40,
2025-08-20,Mark Lashier,Phillips 66,9,20,9,38,
2025-08-20,Maryann Mannen,Marathon Petroleum,6,14,1,21,
2025-08-20,Hans Vestberg,Verizon,17,19,4,40,
2025-08-20,Jensen Huang,Nvidia,15,19,6,40,
2025-08-20,David Solomon,Goldman Sachs,6,24,10,40,
2025-08-20,Charles Scharf,Wells Fargo,28,7,5,40,
2025-08-20,Lane Riggs,Valero Energy,14,9,0,23,
2025-08-20,Brian Roberts,Comcast,10,27,3,40,
2025-08-20,Jon Farney,State Farm,11,26,3,40,
2025-08-20,John Stankey,AT&T,10,25,5,40,
2025-08-20,Michael Hutchins,Freddie Mac,3,11,3,17,
2025-08-20,Jim Rechtin,Humana,18,18,4,40,
2025-08-20,Ted Pick,Morgan Stanley,16,21,3,40,
2025-08-20,Brian Cornell,Target,3,25,12,40,
2025-08-20,Philip Smith,StoneX,0,9,1,10,
2025-08-20,Elon Musk,Tesla,19,10,11,40,
2025-08-20,Michael Dell,Dell Technologies,13,24,3,40,
2025-08-20,Ramon Laguarta,PepsiCo,8,27,5,40,
2025-08-20,Bob Iger,Walt Disney,9,28,3,40,
2025-08-20,Carol Tom√©,UPS,9,20,11,40,
2025-08-20,Joaquin Duato,Johnson & Johnson,8,27,5,40,
2025-08-20,Rajesh Subramaniam,FedEx,10,24,0,34,
2025-08-20,Juan Luciano,Archer Daniels Midland,3,21,15,39,
2025-08-20,Jon Moeller,Procter & Gamble,5,29,6,40,
2025-08-20,Marvin Ellison,Lowe's,16,18,5,39,
2025-08-20,Thomas Long,Energy Transfer,9,0,1,10,
2025-08-20,Christopher Calio,RTX,0,0,0,0,
2025-08-20,Susan Morris,Albertsons,9,27,4,40,
2025-08-20,Kevin Hourican,Sysco,9,28,3,40,
2025-08-20,Tricia Griffith,Progressive,12,23,4,39,
2025-08-20,Stephen Squeri,American Express,14,25,1,40,
2025-08-20,James Taiclet,Lockheed Martin,13,18,9,40,
2025-08-20,Michel Khalaf,MetLife,12,18,0,30,
2025-08-20,Samuel Hazen,HCA Healthcare,9,6,0,15,
2025-08-20,Andrew Sullivan,Prudential Financial,14,24,0,38,
2025-08-20,Kelly Ortberg,Boeing,0,0,0,0,
2025-08-20,Joe Creed,Caterpillar,11,26,1,38,
2025-08-20,Robert M Davis,Merck,3,20,0,23,
2025-08-20,Thomas J Wilson,Allstate,1,10,1,12,
2025-08-20,Albert Bourla,Pfizer,20,12,8,40,
2025-08-20,Arvind Krishna,IBM,14,20,6,40,
2025-08-20,Craig DeSanto,New York Life Insurance,4,15,0,19,
2025-08-20,Ed Bastian,Delta Airlines,16,14,9,39,
2025-08-20,Kevin Murphy,Ferguson Enterprises,2,15,2,19,
2025-08-20,Kirt Walker,Nationwide,14,17,2,33,
2025-08-20,Patrick Zammit,TD Synnex,9,15,0,24,
2025-08-20,Scott Kirby,United Airlines,33,4,3,40,
2025-08-20,Ryan Lance,ConocoPhillips,16,21,3,40,
2025-08-20,Ernie Herrman,TJX,17,22,1,40,
2025-08-20,Bob Michael,AbbVie,0,0,0,0,
2025-08-20,AJ Jim Teague,Enterprise Products Partners,5,9,0,14,
2025-08-20,Christopher Winfrey,Charter Communications,5,13,5,23,
2025-08-20,George Holm,Performance Food,10,23,2,35,
2025-08-20,Robert Isom,American Airlines,6,25,9,40,
2025-08-20,Richard Fairbank,Capital One,17,20,3,40,
2025-08-20,Chuck Robbins,Cisco Systems,13,23,4,40,
2025-08-20,Enrique Lores,HP,13,22,5,40,
2025-08-20,Donnie King,Tyson Foods,10,24,6,40,
2025-08-20,Lip-Bu Tan,Intel,5,24,11,40,
2025-08-20,Safra Catz,Oracle,11,21,8,40,
2025-08-20,Hock Tan,Broadcom,13,23,4,40,
2025-08-20,John May,Deere,9,27,4,40,
2025-08-20,Elliott Hill,Nike,9,29,2,40,
2025-08-20,Timothy M Sweeney,Liberty Mutual Insurance,14,0,0,14,
2025-08-20,Wilfred Chiang,Plains GP,1,1,0,2,
2025-08-20,Juan Andrade,USAA,5,16,0,21,
2025-08-20,Chris Boerner,Bristol-Myers Squibb,11,22,7,40,
2025-08-20,Paul Bay,Ingram Micro,12,23,5,40,
2025-08-20,Phebe Novakovic,General Dynamics,26,10,4,40,
2025-08-20,James Quincey,Coca-Cola,10,28,2,40,
2025-08-20,Thasunda Brown Duckett,TIAA,17,22,0,39,
2025-08-20,Alan Schnitzer,Travelers,14,18,8,40,
2025-08-20,David Ricks,Eli Lilly,9,22,9,40,
2025-08-20,Dara Khosrowshahi,Uber,14,21,5,40,
2025-08-20,Roger Crandall,Mass Mutual,3,7,0,10,
2025-08-20,Marc Casper,Thermo Fisher Scientific,13,24,3,40,
2025-08-20,Gunjan Kedia,US Bancorp,11,27,2,40,
2025-08-20,Michael Kasbar,World Kinect,2,10,0,12,
2025-08-20,Robert Ford,Abbott Laboratories,12,23,5,40,
2025-08-20,Corie Barry,Best Buy,38,2,0,40,
2025-08-20,Tim Gerend,Northwestern Mutual,14,25,1,40,
2025-08-20,Kathy Warden,Northrop Grumman,17,18,5,40,
2025-08-20,Joe Zubretsky,Molina Healthcare,8,6,4,18,
2025-08-20,Todd Vasos,Dollar General,7,21,12,40,
2025-08-20,Robin Vince,Bank of New York,19,17,4,40,
2025-08-20,David Zaslav,Warner Bros Discovery,7,21,12,40,
2025-08-20,Jay Debertin,CHS,4,8,4,16,
2025-08-20,Ted Sarandos,Netflix,12,26,2,40,
2025-08-20,Cristiano Amon,Qualcomm,12,26,1,39,
2025-08-20,Larry Culp,General Electric,12,25,3,40,
2025-08-20,Vimal Kapur,Honeywell,10,30,0,40,
2025-08-20,Marc Benioff,Salesforce,8,25,7,40,
2025-08-20,Jacek Olczak,Philip Morris,14,22,4,40,
2025-08-20,David Flitman,US Foods,2,7,0,9,
2025-08-20,Paul Romanowski,DR Horton,6,15,3,24,
2025-08-20,Bryan DeBoer,Lithia Motors,11,26,2,39,
2025-08-20,Dirk Van de Put,Mondelez,13,23,4,40,
2025-08-20,Brian Niccol,Starbucks,8,32,0,40,
2025-08-20,Ryan McInerney,Visa,15,21,4,40,
2025-08-20,Robert Sulentic,CBRE,2,7,1,10,
2025-08-20,Jonathan Jaffe,Lennar,2,8,0,10,
2025-08-20,Scott Strazik,GE Vernova,12,25,3,40,
2025-08-20,William Demchak,PNC,13,22,5,40,
2025-08-20,Jennifer Rumsey,Cummins,8,27,5,40,
2025-08-20,Preston Feight,Paccar,8,28,2,38,
2025-08-20,Robert Bradway,Amgen,9,28,3,40,
2025-08-20,Matthew Lucey,PBF Energy,6,2,1,9,
2025-08-20,Pat Geraghty,GuideWell Mutual,2,6,0,8,
2025-08-20,Alex Chriss,PayPal,12,26,2,40,
2025-08-20,Sandy Douglas,United Natural Foods,33,7,0,40,
2025-08-20,Michael Creedon,Dollar Tree,3,35,2,40,
2025-08-20,Leon Topalian,Nucor,15,22,3,40,
2025-08-20,Roger Penske,Penske Automotive,18,21,1,40,
2025-08-20,Bom Kim,Coupang,10,29,1,40,
2025-08-20,Antonio Neri,Hewlett Packard,9,22,9,40,
2025-08-20,Harry Sideris,Duke Energy,36,3,0,39,
2025-08-20,Joseph Bae,KKR,20,18,2,40,
2025-08-20,Brian Robbins,Paramount Global,7,29,1,37,
2025-08-20,Michael Dastoor,Jabil,2,6,0,8,
2025-08-20,Daniel O'Day,Gilead Sciences,20,18,2,40,
2025-08-20,Tim Go,HF Sinclair,6,4,0,10,
2025-08-20,William Nash,CarMax,3,3,2,8,
2025-08-20,Michael Miebach,Mastercard,11,25,4,40,
2025-08-20,Lawrence Coben,NRG Energy,6,2,0,8,
2025-08-20,Sean Kerins,Arrow Electronics,3,15,0,18,
2025-08-20,Lorenzo Simonelli,Baker Hughes,16,20,4,40,
2025-08-20,Bob Jordan,Southwest Airlines,8,26,6,40,
2025-08-20,Peter Zaffino,American International,8,26,3,37,
2025-08-20,Gary Dickerson,Applied Materials,8,22,10,40,
2025-08-20,Vicki Hollub,Occidental Petroleum,19,17,3,39,
2025-08-20,Michael Manley,AutoNation,3,6,1,10,
2025-08-20,Christopher Womack,Southern Company,2,8,0,10,
2025-08-20,Christopher Swift,Hartford Insurance,6,4,0,10,
2025-08-20,Marc Rowan,Apollo Global Management,16,20,4,40,
2025-08-20,Rick Wurster,Charles Schwab,14,21,4,39,
2025-08-20,Chris Kempczinski,McDonald's,15,19,6,40,
2025-08-20,Carlos Abrams-Rivera,Kraft Heinz,12,21,7,40,
2025-08-20,Lisa Su,Advanced Micro Devices,17,19,4,40,
2025-08-20,William H Rogers Jr,Truist Financial,2,8,1,11,
2025-08-20,Kathleen Quirk,Freeport-McMoRan,13,18,3,34,
2025-08-20,Sanjay Mehrotra,Micron Technology,18,20,2,40,
2025-08-20,Anthony Capuano,Marriott International,12,25,3,40,
2025-08-20,David Gitlin,Carrier Global,17,22,1,40,
2025-08-20,John Ketchum,NextEra Energy,23,16,1,40,
2025-08-20,William M Brown,3M,2,8,0,10,
2025-08-20,John Doyle,Marsh & McLennan,13,9,1,23,
2025-08-20,Patricia Poppe,PG&E,8,15,2,25,
2025-08-20,Jim Vena,Union Pacific,19,21,0,40,
2025-08-20,Brian Doubles,Synchrony Financial,5,7,2,14,
2025-08-20,Rainer Blair,Danaher,6,15,1,22,
2025-08-20,Philip Gallagher,Avnet,1,5,0,6,
2025-08-20,Glenn Fogel,Booking s,0,3,1,4,
2025-08-20,Ezra Yacob,EOG Resources,23,13,0,36,
2025-08-20,Earl Austin,Quanta Services,2,3,2,7,
2025-08-20,Michael Shepherd,Discover Financial,10,14,2,26,
2025-08-20,Joseph Dominguez,Constellation Energy,15,9,1,25,
2025-08-20,William Stengel II,Genuine Parts,0,4,0,4,
2025-08-20,Christian Ulbrich,Jones Lang LaSalle,10,20,0,30,
2025-08-20,Raymond E Scott,Lear Corporation,5,4,0,9,
2025-08-20,Michael Rapino,Live Nation Entertainment,13,24,3,40,
2025-08-20,Heidi Petz,Sherwin-Williams,7,28,3,38,
2025-08-20,Calvin G Butler Jr,Exelon,6,5,0,11,
2025-08-20,Tony Spring,Macy's,12,26,2,40,
2025-08-20,Jeff Miller,Halliburton,16,20,4,40,
2025-08-20,Kevin Lobo,Stryker,12,25,3,40,
2025-08-20,Tony Cheng,Reinsurance of America,0,0,0,0,
2025-08-20,Ronald P O'Hanley,State Street,6,14,0,20,
2025-08-20,John Engel,WESCO International,5,10,1,16,
2025-08-20,Pierce Norton II,Oneok,5,3,1,9,
2025-08-20,Shantanu Narayen,Adobe,19,20,1,40,
2025-08-20,Bill Westrate,American Family Insurance,10,14,2,26,
2025-08-20,Chris Kubasik,L3Harris Technologies,5,12,0,17,
2025-08-20,James Conroy,Ross Stores,5,12,0,17,
2025-08-20,Christine Leahy,CDW,1,8,2,11,
2025-08-20,Saumya Sutaria,Tenet Healthcare,4,4,1,9,
2025-08-20,Bob Eddy,BJ's Wholesale Club,6,31,3,40,
2025-08-20,Mike Lyons,Fiserv,4,10,0,14,
2025-08-20,William Gifford,Altria,2,5,1,8,
2025-08-20,Larry Fink,BlackRock,7,27,6,40,
2025-08-20,Thomas Polen,Becton Dickinson,7,3,0,10,
2025-08-20,Noel Wallace,Colgate-Palmolive,10,19,2,31,
2025-08-20,Michael Hsu,Kimberly-Clark,5,6,2,13,
2025-08-20,Daryl Kenningham,1 Automotive,9,19,1,29,
2025-08-20,Jennifer Parmentier,Parker-Hannifin,2,12,0,14,
2025-08-20,Jeffrey Harmening,General Mills,5,16,5,26,
2025-08-20,Ravi Kumar S,Cognizant Technology,9,26,3,38,
2025-08-20,William Fehrman,American Electric Power,4,6,0,10,
2025-08-20,Peter Arduini,GE HealthCare Technologies,8,10,0,18,
2025-08-20,Maria Black,Automatic Data Processing,6,4,0,10,
2025-08-20,Lourenco Goncalves,Cleveland-Cliffs,7,22,11,40,
2025-08-20,Dan Amos,Aflac,10,22,8,40,
2025-08-20,Mark Stewart,Goodyear Tire & Rubber,4,34,2,40,
2025-08-20,Kevin Hogan,Corebridge Financial,5,12,0,17,
2025-08-20,Thomas Palmer,Newmont,5,5,0,10,
2025-08-20,Andrew Silvernail,International Paper,6,22,0,28,
2025-08-20,Philip Daniele III,AutoZone,0,2,0,2,
2025-08-20,Ellen Cooper,Lincoln National,4,7,0,11,
2025-08-20,Ryan Marshall,PulteGroup,12,17,11,40,
2025-08-20,James Cracchiolo,Ameriprise Financial,2,24,2,28,
2025-08-20,Andrew Clyde,Murphy USA,14,25,1,40,
2025-08-20,Jonas Prising,Manpower,10,6,1,17,
2025-08-20,David Bozeman,CH Robinson Worldwide,2,8,0,10,
2025-08-20,Timothy Knavish,PPG Industries,1,2,0,3,
2025-08-20,Pedro Pizarro,Edison International,15,8,17,40,
2025-08-20,Mark Millett,Steel Dynamics,15,3,0,18,
2025-08-20,Benjamin Tisch,Loews,2,7,0,9,
2025-08-20,Karsanbhai,Emerson Electric,10,18,3,31,
2025-08-20,John Zillmer,Aramark,8,15,2,25,
2025-08-20,William Hornbuckle,MGM Resorts International,5,25,1,31,
2025-08-20,James Burke,Vistra,6,3,0,9,
2025-08-20,David Hult,Asbury Automotive,9,30,1,40,
2025-08-20,DG Macpherson,WW Grainger,2,7,1,10,
2025-08-20,Eric Slifka,Global Partners,13,22,5,40,
2025-08-20,Bob Pragada,Jacobs Solutions,6,8,0,14,
2025-08-20,Charles Magro,Corteva,4,3,1,8,
2025-08-20,Rick Lanoha,Peter Kiewit Sons',0,1,0,1,
2025-08-20,Michael Mahoney,Boston Scientific,11,28,1,40,
2025-08-20,Brad Beckham,O'Reilly Automotive,5,14,2,21,
2025-08-20,Thomas Bell,Leidos,8,19,1,28,
2025-08-20,Thomas Gayner,Markel,4,10,2,16,
2025-08-20,Marc Bitzer,Whirlpool,13,13,14,40,
2025-08-20,Andrew McMahon,Guardian Life,5,13,0,18,
2025-08-20,Peter Jackson,Builders FirstSource,5,12,1,18,
2025-08-20,Michael Rhodes,Ally Financial,10,24,4,38,
2025-08-20,Matthew Meloy,Targa Resources,5,5,0,10,
2025-08-20,James Breuer,Fluor,0,2,1,3,
2025-08-20,Sasan Goodarzi,Intuit,10,26,4,40,
2025-08-20,Troy Rudd,AECOM,7,24,5,36,
2025-08-20,Penny Pennington,Edward Jones,7,28,5,40,
2025-08-20,Michael Bender,Kohl's,1,25,14,40,
2025-08-20,Beth Ford,Land O'Lakes,18,21,1,40,
2025-08-20,Deanna Strable-Soethout,Principal Financial,1,7,0,8,
2025-08-20,Robert Blue,Dominion Energy,27,10,2,39,
2025-08-20,Martin Schroeter,Kyndryl s,0,10,0,10,
2025-08-20,Jon Vander Ark,Republic Services,10,21,9,40,
2025-08-20,Clay Gaspar,Devon Energy,18,3,0,21,
2025-08-20,Christopher O'Herlihy,Illinois Tool Works,4,5,1,10,
2025-08-20,Michael O'Grady,Northern Trust,24,6,1,31,
2025-08-20,Jamie Whisnant,Auto-Owners Insurance,0,2,0,2,
2025-08-20,Marc Miller,Universal Health Services,3,21,3,27,
2025-08-20,Darryl Button,Pacific Life,1,6,0,7,
2025-08-20,Hamid Akhavan,EchoStar,2,20,8,30,
2025-08-20,Christophe Beck,Ecolab,18,22,0,40,
2025-08-20,Jack Fusco,Cheniere Energy,18,19,3,40,
2025-08-20,John Wren,Omnicom,10,19,11,40,
2025-08-20,Haviv Ilan,Texas Instruments,11,27,2,40,
2025-08-20,David Burritt,United States Steel,8,17,15,40,
2025-08-20,St√©phane de La Faverie,Est√©e Lauder,13,24,3,40,
2025-08-20,Raul Nicholas Vargas Ochoa,Farmers Insurance Exchange,0,0,0,0,
2025-08-20,Thibaut Mongon,Kenvue,9,30,1,40,
2025-08-20,Ari Bousbib,IQVIA s,0,0,0,0,
2025-08-20,Donald Allan,Stanley Black & Decker,9,30,1,40,
2025-08-20,Timothy Cofer,Keurig Dr Pepper,2,2,1,5,
2025-08-20,Matthew Flannery,United Rentals,34,3,0,37,
2025-08-20,Timothy Cawley,Consolidated Edison,5,5,0,10,
2025-08-20,Adam Norwitt,Amphenol,6,22,0,28,
2025-08-20,Brent Shafer,Baxter International,1,11,0,12,
2025-08-20,Kimberly Dang,Kinder Morgan,9,1,0,10,
2025-08-20,Erik Nordstrom,Nordstrom,7,27,5,39,
2025-08-20,Frank Holding,First Citizens BancShares,10,15,2,27,
2025-08-20,Paul Shoukry,Raymond James Financial,14,25,1,40,
2025-08-20,Timothy Archer,Lam Research,2,7,1,10,
2025-08-20,Harry Lawton III,Tractor Supply,1,2,0,3,
2025-08-20,Darren Rebelez,Casey's General Stores,15,23,2,40,
2025-08-20,Scott Smith,Viatris,7,4,0,11,
2025-08-20,James Blackledge,Mutual of Omaha Insurance,0,6,0,6,
2025-08-20,Anthony Guzzi,EMCOR,4,3,0,7,
2025-08-20,Joseph Hinrichs,CSX,5,9,1,15,
2025-08-20,Justin Jude,LKQ,4,6,1,11,
2025-08-20,Judith Marks,Otis Worldwide,2,3,0,5,
2025-08-20,David Bruton Smith,Sonic Automotive,4,8,9,21,
2025-08-20,Martina Cheung,S&P Global,11,22,0,33,
2025-08-20,Leonard Schleifer,Regeneron Pharmaceuticals,6,26,8,40,
2025-08-20,Joseph Fadool,BorgWarner,4,10,0,14,
2025-08-20,Lachlan Murdoch,Fox,6,28,6,40,
2025-08-20,Karla Lewis,Reliance,3,4,1,8,
2025-08-20,John Barrett,Western & Southern Financial,7,31,2,40,
2025-08-20,Scott Donnelly,Textron,9,25,2,36,
2025-08-20,Ariane Gorin,Expedia,8,31,1,40,
2025-08-20,Michael Nolan,Fidelity National Financial,3,0,0,3,
2025-08-20,Ernest Garcia III,Carvana,22,14,4,40,
2025-08-20,Raul Fernandez,DXC Technology,4,32,1,37,
2025-08-20,Robert Berkley,WR Berkley,10,27,3,40,
2025-08-20,Ren√© Jones,M&T Bank,13,23,4,40,
2025-08-20,Lauren Hobart,Dick's Sporting Goods,8,29,3,40,
2025-08-20,Robert Frenzel,Xcel Energy,4,2,1,7,
2025-08-20,Timothy Spence,Fifth Third Bancorp,5,5,0,10,
2025-08-20,Stephen Schwarzman,Blackstone,21,17,2,40,
2025-08-20,Walker Martin,Sempra,0,2,0,2,
2025-08-20,Timothy NeCastro,Erie Insurance,3,6,1,10,
2025-08-20,Wendell Weeks,Corning,14,24,2,40,
2025-08-20,Kathleen Johnson,Lumen Technologies,4,3,1,8,
2025-08-20,Brian Tierney,FirstEnergy,4,25,2,31,
2025-08-20,Adam Schechter,Labcorp,7,20,1,28,
2025-08-20,Tiang Yew Tan,Western Digital,2,1,0,3,
2025-08-20,Richard McKenney,Unum,4,5,0,9,
2025-08-20,Javier Rodriguez,DaVita,14,14,1,29,
2025-08-20,Steven Cahillane,Kellanova,2,7,0,9,
2025-08-20,Stanley Bergman,Henry Schein,11,28,1,40,
2025-08-20,Robert Sanchez,Ryder System,9,11,1,21,
2025-08-20,Tim Hingtgen,Community Health Systems,11,27,2,40,
2025-08-20,Avigal Soreq,Delek US,3,9,5,17,
2025-08-20,Gerardo Norcia,DTE Energy,6,3,0,9,
2025-08-20,Mark Pearson,Equitable,8,9,0,17,
2025-08-20,Lori Koch,DuPont,8,19,0,27,
2025-08-20,Rich Steinmeier,LPL Financial,24,14,2,40,
2025-08-20,Bruce Van Saun,Citizens Financial,11,26,3,40,
2025-08-20,Jos√© Mas,MasTec,6,14,3,23,
2025-08-20,Andr√©s Gluski,AES,17,22,0,39,
2025-08-20,Kevin Kwilinski,Berry Global,8,19,0,27,
2025-08-20,Mark George,Norfolk Southern,17,21,2,40,
2025-08-20,Eduardo Menezes,Air Products & Chemicals,4,5,1,10,
2025-08-20,Shelley Simpson,JB Hunt Transport Services,6,31,3,40,
2025-08-20,Daniel Fisher,Ball,3,19,6,28,
2025-08-20,Sean Connolly,Conagra Brands,6,32,2,40,
2025-08-20,Stephen Steinour,Huntington Bancshares,3,8,0,11,
2025-08-20,James Snee,Hormel Foods,3,30,1,34,
2025-08-20,Joseph Nolan,Eversource Energy,4,5,1,10,
2025-08-20,William Oplinger,Alcoa,9,17,3,29,
2025-08-20,Andrew Marsh,Entergy,2,6,0,8,
2025-08-20,Keith Demmings,Assurant,4,7,0,11,
2025-08-20,Sumit Singh,Chewy,14,21,5,40,
2025-08-20,Niraj Shah,Wayfair,8,24,8,40,
2025-08-20,Joseph Ferraro,Avis Budget,3,6,1,10,
2025-08-20,Jeffrey Sprecher,Intercontinental Exchange,15,24,1,40,
2025-08-20,Benito Minicucci,Alaska Air,3,5,1,9,
2025-08-20,Malcolm Wilson,GXO Logistics,8,22,0,30,
2025-08-20,Eric Hansotia,AGCO,16,23,1,40,
2025-08-20,Kathleen Mazzarella,Graybar Electric,1,7,1,9,
2025-08-20,Gavin Hattersley,Molson Coors Beverage,3,32,5,40,
2025-08-20,Patrick Gallagher,Arthur J Gallagher,11,27,2,40,
2025-08-20,Christopher Kastner,Huntington Ingalls Industries,3,4,0,7,
2025-08-20,Erik Fyrwald,International Flavors & Fragrances,7,7,2,16,
2025-08-20,Ricardo Cardenas,Darden Restaurants,4,4,1,9,
2025-08-20,Stephen Spray,Cincinnati Financial,1,6,3,10,
2025-08-20,Scott Boatwright,Chipotle Mexican Grill,6,28,6,40,
2025-08-20,Joey Wat,Yum China,12,26,2,40,
2025-08-20,Robert Goldstein,Las Vegas Sands,4,31,5,40,
2025-08-20,Kecia Steelman,Ulta Beauty,32,7,1,40,
2025-08-20,Thomas Reeg,Caesars Entertainment,5,6,0,11,
2025-08-20,Jon Rousseau,BrightSpring Health Services,21,18,1,40,
2025-08-20,William Krueger,Andersons,0,4,0,4,
2025-08-20,Michele Buck,Hershey,9,29,2,40,
2025-08-20,Christopher Nassetta,Hilton,14,23,3,40,
2025-08-20,Bruce Bodine,Mosaic,3,8,0,11,
2025-08-20,Brian Chesky,Airbnb,3,29,8,40,
2025-08-20,Kaes Van‚Äôt Hof,Diamondback Energy,23,14,2,39,
2025-08-20,Steven Vondran,American Tower,4,7,0,11,
2025-08-20,Reshma Kewalramani,Vertex Pharmaceuticals,23,14,3,40,
2025-08-20,William McDermott,ServiceNow,4,5,0,9,
2025-08-20,Brian Chambers,Owens Corning,4,10,1,15,
2025-08-20,Teresa Rasmussen,Thrivent Financial for Lutherans,4,1,0,5,
2025-08-20,Shane O'Kelly,Advance Auto Parts,15,22,3,40,
2025-08-20,Douglas Yearley,Toll Brothers,10,26,4,40,
2025-08-20,Jeffrey Lorberbaum,Mohawk Industries,9,5,1,15,
2025-08-20,Gregory Brown,Motorola Solutions,1,9,0,10,
2025-08-20,John Pfeifer,Oshkosh,6,27,3,36,
2025-08-20,Tony Xu,DoorDash,12,21,7,40,
2025-08-20,Edward Pesicka,Owens & Minor,3,33,2,38,
2025-08-20,Eugene Bredow,NVR,0,5,0,5,
2025-08-20,Philippe Krakowsky,Interpublic,15,21,4,40,
2025-08-20,Horacio Rozanski,Booz Allen Hamilton,16,19,5,40,
2025-08-20,Michael O‚ÄôSullivan,Burlington Stores,9,29,2,40,
2025-08-20,Daniel Wall,Expeditors International of Washington,4,3,0,7,
2025-08-20,Calvin McDonald,Lululemon athletica,10,28,2,40,
2025-08-20,Stephanie Ferris,Fidelity National Information,14,22,3,39,
2025-08-20,Rich Handler,Jefferies Financial,13,13,2,28,
2025-08-20,Alan Armstrong,Williams,22,15,3,40,
2025-08-20,Bracken Darrell,VF Corporation,8,27,5,40,
2025-08-20,Mikael Bratt,Autoliv,7,8,2,17,
2025-08-20,Rafael Santana,Westinghouse Air Brake Technologies,5,6,1,12,
2025-08-20,Ralph LaRossa,Public Service Enterprise,7,17,0,24,
2025-08-20,Jamie Iannone,Ebay,18,18,4,40,
2025-08-20,Scott Richardson,Celanese,8,28,4,40,
2025-08-20,Cameron Bready,Global Payments,8,29,3,40,
2025-08-20,Robert Thomson,News Corp,6,28,5,39,
2025-08-20,Robert Martin,THOR Industries,4,5,1,10,
2025-08-20,David Rawlinson II,QVC,6,13,2,21,
2025-08-20,Andrew Teno,Icahn Enterprises,5,5,0,10,
2025-08-20,William Newlands,Constellation Brands,0,2,2,4,
2025-08-20,James Davis,Quest Diagnostics,3,6,1,10,
2025-08-20,Richard Wallace,KLA,2,5,0,7,
2025-08-20,Julian Francis,QXO Building Products,0,0,0,0,
2025-08-20,John Christmann IV,APA,5,4,1,10,
2025-08-20,Gregory Roberts,A-Mark Precious Metals,2,2,1,5,
2025-08-20,Christopher Viehbacher,Biogen,0,27,2,29,
2025-08-20,Mick Beekhuizen,Campbell's,6,23,3,32,
2025-08-20,Christopher Caldwell,Concentrix,2,5,0,7,
2025-08-20,Todd Schneider,Cintas,12,17,1,30,
2025-08-20,Tony Sarsam,SpartanNash,17,21,2,40,
2025-08-20,John Venhuizen,Ace Hardware,16,23,1,40,
2025-08-20,Vincent Roche,Analog Devices,14,24,2,40,
2025-08-20,Mark Costa,Eastman Chemical,6,17,4,27,
2025-08-20,Milan Galik,Interactive Brokers,5,14,2,21,
2025-08-20,John Turner,Regions Financial,19,19,2,40,
2025-08-20,Joanna Geraghty,JetBlue Airways,18,15,7,40,
2025-08-20,Kristin Peck,Zoetis,12,18,1,31,
2025-08-20,Christopher Gorman,KeyCorp,4,6,0,10,
2025-08-20,Mark Bertolini,Oscar Health,13,18,8,39,
2025-08-20,Brendan McCracken,Ovintiv,6,5,1,12,
2025-08-20,Robert Steer,Seaboard,1,4,0,5,
2025-08-20,Gil West,Hertz,7,25,8,40,
2025-08-20,Robert Greenberg,Skechers,7,31,2,40,
2025-08-20,Dennis Mathew,Altice,6,25,7,38,
2025-08-20,Clay Williams,NOV,13,21,5,39,
2025-08-20,Michael Doss,Graphic Packaging,7,7,2,16,
2025-08-20,Deon Stander,Avery Dennison,0,11,0,11,
2025-08-20,Adaire Fox-Martin,Equinix,16,20,4,40,
2025-08-20,Joyce Mullen,Insight Enterprises,7,11,1,19,
2025-08-20,Jennifer Witz,Sirius XM,8,12,6,26,
2025-08-20,Stefan Larsson,PVH,8,26,6,40,
2025-08-20,Jason P Wells,CenterPoint Energy,6,4,0,10,
2025-08-20,Scott Lauber,WEC Energy,14,6,0,20,
2025-08-20,Matthew Pine,Xylem,2,9,1,12,
2025-08-20,Jennifer Johnson,Franklin Resources,2,7,1,10,
2025-08-20,Vincent Sorgi,PPL,8,11,1,20,
2025-08-20,Carl Eschenbach,Workday,11,20,9,40,
2025-08-20,Richard Tobin,Dover,3,6,1,10,
2025-08-20,Mark Kowlzan,Packaging Corp of America,1,9,1,11,
2025-08-20,Scott Salmirs,ABM Industries,6,7,1,14,
2025-08-20,Gary Guthart,Intuitive Surgical,12,24,4,40,
2025-08-20,Carl Lindner lll,American Financial,0,0,0,0,
2025-08-20,Blake Moret,Rockwell Automation,12,27,1,40,
2025-08-20,Bryan Hanson,Solventum,6,11,2,19,
2025-08-20,Craig Smiddy,Old Republic International,3,5,1,9,
2025-08-20,Christopher Hilger,Securian Financial,0,6,1,7,
2025-08-20,Hamid Moghadam,Prologis,7,27,6,40,
2025-08-20,Mark Smucker,JM Smucker,10,23,7,40,
2025-08-20,Sheryl Palmer,Taylor Morrison Home,7,12,1,20,
2025-08-20,Mario Harik,XPO,7,32,1,40,
2025-08-20,Heather Lavallee,Voya Financial,7,9,2,18,
2025-08-20,Nikesh Arora,Palo Alto Networks,9,23,8,40,
2025-08-20,Giordano Albertazzi,Vertiv s,0,1,0,1,
2025-08-20,Shankh Mitra,Welltower,17,21,2,40,
2025-08-20,Mary Dillon,Foot Locker,11,23,6,40,
2025-08-20,William Monteleone,Par Pacific,1,7,1,9,
2025-08-20,Kevin Stein,TransDigm,10,10,2,22,
2025-08-20,Peter Matt,Commercial Metals,5,4,0,9,
2025-08-20,Robert Vitale,Post s,0,0,0,0,
2025-08-20,Keith Allman,Masco,6,9,1,16,
2025-08-20,Rusty Rush,Rush Enterprises,17,20,3,40,
2025-08-20,Stuart Bradie,KBR,14,18,4,36,
2025-08-20,Jack Sinclair,Sprouts Farmers Market,16,23,1,40,
2025-08-20,Laura Alber,Williams-Sonoma,11,24,5,40,
2025-08-20,Ivan Tornos,Zimmer Biomet s,0,0,0,0,
2025-08-20,John Mengucci,CACI International,22,16,2,40,
2025-08-20,Steve Sanghi,Microchip Technology,9,28,3,40,
2025-08-20,Albert Nahmad,Watsco,2,6,2,10,
2025-08-20,Christopher Peterson,Newell Brands,2,7,1,10,
2025-08-20,Arie Kotler,ARKO,5,24,0,29,
2025-08-20,Jure Sola,Sanmina,3,14,1,18,
2025-08-20,Andrew Wilson,Electronic Arts,15,17,8,40,
2025-08-20,David Gibbs,Yum Brands,2,36,2,40,
2025-08-20,Daniel Florness,Fastenal,3,6,1,10,
2025-08-20,Garrick Rochow,CMS Energy,11,3,0,14,
2025-08-20,Rodney Sacks,Monster Beverage,14,23,2,39,
2025-08-20,Mark Shapiro,Endeavor,4,35,1,40,
2025-08-20,Toni Townes-Whitley,Science Applications International,13,22,1,36,
2025-08-20,Mark Witkowski,Core & Main,1,7,0,8,
2025-08-20,John Plant,Howmet Aerospace,5,17,2,24,
2025-08-20,James Zallie,Ingredion,3,6,1,10,
2025-08-20,Thomas Hill,Vulcan Materials,4,7,2,13,
2025-08-21,Doug McMillon,Walmart,16,19,5,40,
2025-08-21,Andrew Jassy,Amazon,4,31,5,40,
2025-08-21,Stephen Hemsley,UnitedHealth,7,26,7,40,
2025-08-21,Tim Cook,Apple,18,21,1,40,
2025-08-21,David Joyner,CVS Health,5,31,4,40,
2025-08-21,Warren Buffett,Berkshire Hathaway,11,24,5,40,
2025-08-21,Sundar Pichai,Alphabet,17,17,6,40,
2025-08-21,Darren Woods,Exxon Mobil,10,22,7,39,
2025-08-21,Brian Tyler,McKesson,4,16,4,24,
2025-08-21,Robert Mauch,Cencora,4,6,0,10,
2025-08-21,Jamie Dimon,JPMorgan Chase,9,19,12,40,
2025-08-21,Ron Vachris,Costco,7,32,1,40,
2025-08-21,David Cordani,Cigna,21,16,3,40,
2025-08-21,Satya Nadella,Microsoft,17,15,8,40,
2025-08-21,Jason Hollar,Cardinal Health,12,22,5,39,
2025-08-21,Mike Wirth,Chevron,21,16,3,40,
2025-08-21,Brian Moynihan,Bank of America,5,29,6,40,
2025-08-21,Mary Barra,General Motors,12,24,4,40,
2025-08-21,Jim Farley,Ford Motor,13,20,7,40,
2025-08-21,Gail Boudreaux,Elevance Health,15,18,7,40,
2025-08-21,Jane Fraser,Citi,9,22,9,40,
2025-08-21,Mark Zuckerberg,Meta,12,20,8,40,
2025-08-21,Sarah London,Centene,11,22,7,40,
2025-08-21,Ted Decker,Home Depot,10,21,9,40,
2025-08-21,Priscilla Almodovar,Fannie Mae,9,17,13,39,
2025-08-21,Tim Wentworth,Walgreens,8,21,10,39,
2025-08-21,Ron Sargent,Kroger,5,21,14,40,
2025-08-21,Mark Lashier,Phillips 66,9,20,9,38,
2025-08-21,Maryann Mannen,Marathon Petroleum,6,14,1,21,
2025-08-21,Hans Vestberg,Verizon,16,20,4,40,
2025-08-21,Jensen Huang,Nvidia,14,21,5,40,
2025-08-21,David Solomon,Goldman Sachs,6,23,11,40,
2025-08-21,Charles Scharf,Wells Fargo,29,8,3,40,
2025-08-21,Lane Riggs,Valero Energy,14,9,0,23,
2025-08-21,Brian Roberts,Comcast,10,27,3,40,
2025-08-21,Jon Farney,State Farm,10,26,4,40,
2025-08-21,John Stankey,AT&T,11,24,5,40,
2025-08-21,Michael Hutchins,Freddie Mac,3,12,3,18,
2025-08-21,Jim Rechtin,Humana,19,18,3,40,
2025-08-21,Ted Pick,Morgan Stanley,0,0,0,0,
2025-08-21,Michael Fiddelke,Target,10,25,5,40,
2025-08-21,Philip Smith,StoneX,0,10,1,11,
2025-08-21,Elon Musk,Tesla,12,15,13,40,
2025-08-21,Michael Dell,Dell Technologies,12,25,3,40,
2025-08-21,Ramon Laguarta,PepsiCo,8,29,3,40,
2025-08-21,Bob Iger,Walt Disney,9,28,3,40,
2025-08-21,Carol Tom√©,UPS,7,21,12,40,
2025-08-21,Joaquin Duato,Johnson & Johnson,8,27,5,40,
2025-08-21,Rajesh Subramaniam,FedEx,10,26,0,36,
2025-08-21,Juan Luciano,Archer Daniels Midland,3,20,14,37,
2025-08-21,Jon Moeller,Procter & Gamble,8,26,6,40,
2025-08-21,Marvin Ellison,Lowe's,15,19,5,39,
2025-08-21,Thomas Long,Energy Transfer,9,0,1,10,
2025-08-21,Christopher Calio,RTX,6,11,0,17,
2025-08-21,Susan Morris,Albertsons,9,27,4,40,
2025-08-21,Kevin Hourican,Sysco,9,28,3,40,
2025-08-21,Tricia Griffith,Progressive,12,23,4,39,
2025-08-21,Stephen Squeri,American Express,14,25,1,40,
2025-08-21,James Taiclet,Lockheed Martin,11,20,9,40,
2025-08-21,Michel Khalaf,MetLife,11,17,0,28,
2025-08-21,Samuel Hazen,HCA Healthcare,9,4,0,13,
2025-08-21,Andrew Sullivan,Prudential Financial,14,24,0,38,
2025-08-21,Kelly Ortberg,Boeing,14,22,4,40,
2025-08-21,Joe Creed,Caterpillar,11,25,2,38,
2025-08-21,Robert M Davis,Merck,4,19,0,23,
2025-08-21,Thomas J Wilson,Allstate,0,10,1,11,
2025-08-21,Albert Bourla,Pfizer,20,12,8,40,
2025-08-21,Arvind Krishna,IBM,15,19,6,40,
2025-08-21,Craig DeSanto,New York Life Insurance,3,15,0,18,
2025-08-21,Ed Bastian,Delta Airlines,18,12,9,39,
2025-08-21,Kevin Murphy,Ferguson Enterprises,3,15,2,20,
2025-08-21,Kirt Walker,Nationwide,14,17,2,33,
2025-08-21,Patrick Zammit,TD Synnex,11,15,0,26,
2025-08-21,Scott Kirby,United Airlines,34,3,3,40,
2025-08-21,Ryan Lance,ConocoPhillips,17,20,3,40,
2025-08-21,Ernie Herrman,TJX,15,23,2,40,
2025-08-21,Bob Michael,AbbVie,0,0,0,0,
2025-08-21,AJ Jim Teague,Enterprise Products Partners,5,7,0,12,
2025-08-21,Christopher Winfrey,Charter Communications,6,13,5,24,
2025-08-21,George Holm,Performance Food,10,23,2,35,
2025-08-21,Robert Isom,American Airlines,6,25,9,40,
2025-08-21,Richard Fairbank,Capital One,16,22,2,40,
2025-08-21,Chuck Robbins,Cisco Systems,12,25,3,40,
2025-08-21,Enrique Lores,HP,12,22,6,40,
2025-08-21,Donnie King,Tyson Foods,10,25,5,40,
2025-08-21,Lip-Bu Tan,Intel,5,24,11,40,
2025-08-21,Safra Catz,Oracle,10,22,8,40,
2025-08-21,Hock Tan,Broadcom,13,23,4,40,
2025-08-21,John May,Deere,8,28,4,40,
2025-08-21,Elliott Hill,Nike,14,22,4,40,
2025-08-21,Timothy M Sweeney,Liberty Mutual Insurance,14,0,0,14,
2025-08-21,Wilfred Chiang,Plains GP,1,1,0,2,
2025-08-21,Juan Andrade,USAA,5,16,0,21,
2025-08-21,Chris Boerner,Bristol-Myers Squibb,10,23,7,40,
2025-08-21,Paul Bay,Ingram Micro,12,23,5,40,
2025-08-21,Phebe Novakovic,General Dynamics,27,10,3,40,
2025-08-21,James Quincey,Coca-Cola,12,25,3,40,
2025-08-21,Thasunda Brown Duckett,TIAA,17,22,0,39,
2025-08-21,Alan Schnitzer,Travelers,14,18,8,40,
2025-08-21,David Ricks,Eli Lilly,10,21,9,40,
2025-08-21,Dara Khosrowshahi,Uber,13,21,6,40,
2025-08-21,Roger Crandall,Mass Mutual,3,7,0,10,
2025-08-21,Marc Casper,Thermo Fisher Scientific,12,25,3,40,
2025-08-21,Gunjan Kedia,US Bancorp,11,27,2,40,
2025-08-21,Michael Kasbar,World Kinect,2,10,0,12,
2025-08-21,Robert Ford,Abbott Laboratories,13,22,5,40,
2025-08-21,Corie Barry,Best Buy,38,2,0,40,
2025-08-21,Tim Gerend,Northwestern Mutual,14,25,1,40,
2025-08-21,Kathy Warden,Northrop Grumman,13,22,5,40,
2025-08-21,Joe Zubretsky,Molina Healthcare,10,6,4,20,
2025-08-21,Todd Vasos,Dollar General,6,22,12,40,
2025-08-21,Robin Vince,Bank of New York,18,18,4,40,
2025-08-21,David Zaslav,Warner Bros Discovery,6,22,12,40,
2025-08-21,Jay Debertin,CHS,4,8,4,16,
2025-08-21,Ted Sarandos,Netflix,13,24,3,40,
2025-08-21,Cristiano Amon,Qualcomm,11,26,2,39,
2025-08-21,Larry Culp,General Electric,12,25,3,40,
2025-08-21,Vimal Kapur,Honeywell,11,29,0,40,
2025-08-21,Marc Benioff,Salesforce,8,24,8,40,
2025-08-21,Jacek Olczak,Philip Morris,14,21,5,40,
2025-08-21,David Flitman,US Foods,2,7,0,9,
2025-08-21,Paul Romanowski,DR Horton,6,15,3,24,
2025-08-21,Bryan DeBoer,Lithia Motors,12,26,1,39,
2025-08-21,Dirk Van de Put,Mondelez,13,24,3,40,
2025-08-21,Brian Niccol,Starbucks,10,30,0,40,
2025-08-21,Ryan McInerney,Visa,16,20,4,40,
2025-08-21,Robert Sulentic,CBRE,1,7,1,9,
2025-08-21,Jonathan Jaffe,Lennar,1,9,0,10,
2025-08-21,Scott Strazik,GE Vernova,13,24,3,40,
2025-08-21,William Demchak,PNC,13,22,5,40,
2025-08-21,Jennifer Rumsey,Cummins,9,27,4,40,
2025-08-21,Preston Feight,Paccar,7,28,2,37,
2025-08-21,Robert Bradway,Amgen,10,27,3,40,
2025-08-21,Matthew Lucey,PBF Energy,5,2,1,8,
2025-08-21,Pat Geraghty,GuideWell Mutual,2,7,0,9,
2025-08-21,Alex Chriss,PayPal,13,25,2,40,
2025-08-21,Sandy Douglas,United Natural Foods,33,6,1,40,
2025-08-21,Michael Creedon,Dollar Tree,3,35,2,40,
2025-08-21,Leon Topalian,Nucor,15,22,3,40,
2025-08-21,Roger Penske,Penske Automotive,19,21,0,40,
2025-08-21,Bom Kim,Coupang,9,30,1,40,
2025-08-21,Antonio Neri,Hewlett Packard,9,22,9,40,
2025-08-21,Harry Sideris,Duke Energy,37,3,0,40,
2025-08-21,Joseph Bae,KKR,20,18,2,40,
2025-08-21,Brian Robbins,Paramount Global,8,28,0,36,
2025-08-21,Michael Dastoor,Jabil,2,6,0,8,
2025-08-21,Daniel O'Day,Gilead Sciences,20,18,2,40,
2025-08-21,Tim Go,HF Sinclair,6,4,0,10,
2025-08-21,William Nash,CarMax,3,3,2,8,
2025-08-21,Michael Miebach,Mastercard,10,26,4,40,
2025-08-21,Lawrence Coben,NRG Energy,7,2,0,9,
2025-08-21,Sean Kerins,Arrow Electronics,3,14,0,17,
2025-08-21,Lorenzo Simonelli,Baker Hughes,16,20,4,40,
2025-08-21,Bob Jordan,Southwest Airlines,10,23,7,40,
2025-08-21,Peter Zaffino,American International,8,29,3,40,
2025-08-21,Gary Dickerson,Applied Materials,7,21,12,40,
2025-08-21,Vicki Hollub,Occidental Petroleum,18,18,3,39,
2025-08-21,Michael Manley,AutoNation,3,5,1,9,
2025-08-21,Christopher Womack,Southern Company,2,8,0,10,
2025-08-21,Christopher Swift,Hartford Insurance,6,4,0,10,
2025-08-21,Marc Rowan,Apollo Global Management,15,21,4,40,
2025-08-21,Rick Wurster,Charles Schwab,14,21,4,39,
2025-08-21,Chris Kempczinski,McDonald's,14,18,8,40,
2025-08-21,Carlos Abrams-Rivera,Kraft Heinz,12,21,7,40,
2025-08-21,Lisa Su,Advanced Micro Devices,18,18,4,40,
2025-08-21,William H Rogers Jr,Truist Financial,2,7,1,10,
2025-08-21,Kathleen Quirk,Freeport-McMoRan,13,18,3,34,
2025-08-21,Sanjay Mehrotra,Micron Technology,17,21,2,40,
2025-08-21,Anthony Capuano,Marriott International,12,25,3,40,
2025-08-21,David Gitlin,Carrier Global,17,22,1,40,
2025-08-21,John Ketchum,NextEra Energy,21,18,1,40,
2025-08-21,William M Brown,3M,2,8,0,10,
2025-08-21,John Doyle,Marsh & McLennan,13,10,1,24,
2025-08-21,Patricia Poppe,PG&E,8,15,2,25,
2025-08-21,Jim Vena,Union Pacific,15,24,0,39,
2025-08-21,Brian Doubles,Synchrony Financial,5,7,2,14,
2025-08-21,Rainer Blair,Danaher,6,15,1,22,
2025-08-21,Philip Gallagher,Avnet,1,4,0,5,
2025-08-21,Glenn Fogel,Booking s,0,3,1,4,
2025-08-21,Ezra Yacob,EOG Resources,23,13,0,36,
2025-08-21,Earl Austin,Quanta Services,3,4,1,8,
2025-08-21,Michael Shepherd,Discover Financial,10,14,2,26,
2025-08-21,Joseph Dominguez,Constellation Energy,15,10,1,26,
2025-08-21,William Stengel II,Genuine Parts,0,4,0,4,
2025-08-21,Christian Ulbrich,Jones Lang LaSalle,10,21,0,31,
2025-08-21,Raymond E Scott,Lear Corporation,5,4,0,9,
2025-08-21,Michael Rapino,Live Nation Entertainment,14,23,3,40,
2025-08-21,Heidi Petz,Sherwin-Williams,7,28,3,38,
2025-08-21,Calvin G Butler Jr,Exelon,6,5,0,11,
2025-08-21,Tony Spring,Macy's,12,26,2,40,
2025-08-21,Jeff Miller,Halliburton,17,19,4,40,
2025-08-21,Kevin Lobo,Stryker,12,25,3,40,
2025-08-21,Tony Cheng,Reinsurance of America,0,0,0,0,
2025-08-21,Ronald P O'Hanley,State Street,5,14,0,19,
2025-08-21,John Engel,WESCO International,5,10,1,16,
2025-08-21,Pierce Norton II,Oneok,6,2,1,9,
2025-08-21,Shantanu Narayen,Adobe,19,20,1,40,
2025-08-21,Bill Westrate,American Family Insurance,12,14,2,28,
2025-08-21,Chris Kubasik,L3Harris Technologies,6,13,1,20,
2025-08-21,James Conroy,Ross Stores,5,12,0,17,
2025-08-21,Christine Leahy,CDW,1,7,2,10,
2025-08-21,Saumya Sutaria,Tenet Healthcare,5,4,1,10,
2025-08-21,Bob Eddy,BJ's Wholesale Club,6,31,3,40,
2025-08-21,Mike Lyons,Fiserv,4,11,0,15,
2025-08-21,William Gifford,Altria,2,6,1,9,
2025-08-21,Larry Fink,BlackRock,8,25,7,40,
2025-08-21,Thomas Polen,Becton Dickinson,7,3,0,10,
2025-08-21,Noel Wallace,Colgate-Palmolive,10,22,2,34,
2025-08-21,Michael Hsu,Kimberly-Clark,6,6,2,14,
2025-08-21,Daryl Kenningham,1 Automotive,10,20,1,31,
2025-08-21,Jennifer Parmentier,Parker-Hannifin,2,12,0,14,
2025-08-21,Jeffrey Harmening,General Mills,5,17,5,27,
2025-08-21,Ravi Kumar S,Cognizant Technology,9,27,3,39,
2025-08-21,William Fehrman,American Electric Power,4,6,0,10,
2025-08-21,Peter Arduini,GE HealthCare Technologies,8,10,0,18,
2025-08-21,Maria Black,Automatic Data Processing,6,4,0,10,
2025-08-21,Lourenco Goncalves,Cleveland-Cliffs,8,21,11,40,
2025-08-21,Dan Amos,Aflac,11,21,8,40,
2025-08-21,Mark Stewart,Goodyear Tire & Rubber,3,35,2,40,
2025-08-21,Kevin Hogan,Corebridge Financial,5,12,0,17,
2025-08-21,Thomas Palmer,Newmont,5,4,0,9,
2025-08-21,Andrew Silvernail,International Paper,6,22,0,28,
2025-08-21,Philip Daniele III,AutoZone,0,2,0,2,
2025-08-21,Ellen Cooper,Lincoln National,4,7,0,11,
2025-08-21,Ryan Marshall,PulteGroup,13,16,11,40,
2025-08-21,James Cracchiolo,Ameriprise Financial,2,24,2,28,
2025-08-21,Andrew Clyde,Murphy USA,14,25,1,40,
2025-08-21,Jonas Prising,Manpower,10,6,1,17,
2025-08-21,David Bozeman,CH Robinson Worldwide,2,7,1,10,
2025-08-21,Timothy Knavish,PPG Industries,1,2,0,3,
2025-08-21,Pedro Pizarro,Edison International,15,8,17,40,
2025-08-21,Mark Millett,Steel Dynamics,15,3,0,18,
2025-08-21,Benjamin Tisch,Loews,2,7,0,9,
2025-08-21,Karsanbhai,Emerson Electric,10,18,3,31,
2025-08-21,John Zillmer,Aramark,8,15,2,25,
2025-08-21,William Hornbuckle,MGM Resorts International,5,25,1,31,
2025-08-21,James Burke,Vistra,6,4,0,10,
2025-08-21,David Hult,Asbury Automotive,9,30,1,40,
2025-08-21,DG Macpherson,WW Grainger,2,7,1,10,
2025-08-21,Eric Slifka,Global Partners,13,22,5,40,
2025-08-21,Bob Pragada,Jacobs Solutions,6,8,0,14,
2025-08-21,Charles Magro,Corteva,4,3,1,8,
2025-08-21,Rick Lanoha,Peter Kiewit Sons',0,2,0,2,
2025-08-21,Michael Mahoney,Boston Scientific,10,29,1,40,
2025-08-21,Brad Beckham,O'Reilly Automotive,5,14,2,21,
2025-08-21,Thomas Bell,Leidos,8,19,1,28,
2025-08-21,Thomas Gayner,Markel Group,1,8,0,9,
2025-08-21,Marc Bitzer,Whirlpool,13,13,14,40,
2025-08-21,Andrew McMahon,Guardian Life,5,14,0,19,
2025-08-21,Peter Jackson,Builders FirstSource,5,12,1,18,
2025-08-21,Michael Rhodes,Ally Financial,10,24,4,38,
2025-08-21,Matthew Meloy,Targa Resources,4,6,0,10,
2025-08-21,James Breuer,Fluor,0,2,1,3,
2025-08-21,Sasan Goodarzi,Intuit,10,26,4,40,
2025-08-21,Troy Rudd,AECOM,7,24,5,36,
2025-08-21,Penny Pennington,Edward Jones,6,29,5,40,
2025-08-21,Michael Bender,Kohl's,1,26,13,40,
2025-08-21,Beth Ford,Land O'Lakes,18,20,2,40,
2025-08-21,Deanna Strable-Soethout,Principal Financial,1,6,0,7,
2025-08-21,Robert Blue,Dominion Energy,27,9,2,38,
2025-08-21,Martin Schroeter,Kyndryl s,0,7,0,7,
2025-08-21,Jon Vander Ark,Republic Services,10,19,11,40,
2025-08-21,Clay Gaspar,Devon Energy,19,3,0,22,
2025-08-21,Christopher O'Herlihy,Illinois Tool Works,4,4,2,10,
2025-08-21,Michael O'Grady,Northern Trust,25,6,1,32,
2025-08-21,Jamie Whisnant,Auto-Owners Insurance,0,2,0,2,
2025-08-21,Marc Miller,Universal Health Services,4,20,2,26,
2025-08-21,Darryl Button,Pacific Life,1,6,0,7,
2025-08-21,Hamid Akhavan,EchoStar,4,25,11,40,
2025-08-21,Christophe Beck,Ecolab,19,21,0,40,
2025-08-21,Jack Fusco,Cheniere Energy,20,17,3,40,
2025-08-21,John Wren,Omnicom,10,19,11,40,
2025-08-21,Haviv Ilan,Texas Instruments,11,26,3,40,
2025-08-21,David Burritt,United States Steel,7,18,15,40,
2025-08-21,St√©phane de La Faverie,Est√©e Lauder,12,23,5,40,
2025-08-21,Raul Nicholas Vargas Ochoa,Farmers Insurance Exchange,0,0,0,0,
2025-08-21,Thibaut Mongon,Kenvue,10,28,2,40,
2025-08-21,Ari Bousbib,IQVIA s,0,0,0,0,
2025-08-21,Donald Allan,Stanley Black & Decker,9,29,2,40,
2025-08-21,Timothy Cofer,Keurig Dr Pepper,2,2,1,5,
2025-08-21,Matthew Flannery,United Rentals,32,3,0,35,
2025-08-21,Timothy Cawley,Consolidated Edison,5,5,0,10,
2025-08-21,Adam Norwitt,Amphenol,5,19,0,24,
2025-08-21,Brent Shafer,Baxter International,1,11,0,12,
2025-08-21,Kimberly Dang,Kinder Morgan,9,1,0,10,
2025-08-21,Erik Nordstrom,Nordstrom,7,27,5,39,
2025-08-21,Frank Holding,First Citizens BancShares,10,14,2,26,
2025-08-21,Paul Shoukry,Raymond James Financial,14,25,1,40,
2025-08-21,Timothy Archer,Lam Research,2,7,1,10,
2025-08-21,Harry Lawton III,Tractor Supply,1,2,0,3,
2025-08-21,Darren Rebelez,Casey's General Stores,15,23,2,40,
2025-08-21,Scott Smith,Viatris,7,4,0,11,
2025-08-21,James Blackledge,Mutual of Omaha Insurance,0,6,0,6,
2025-08-21,Anthony Guzzi,EMCOR,4,3,0,7,
2025-08-21,Joseph Hinrichs,CSX,5,8,1,14,
2025-08-21,Justin Jude,LKQ,4,6,1,11,
2025-08-21,Judith Marks,Otis Worldwide,2,3,0,5,
2025-08-21,David Bruton Smith,Sonic Automotive,4,9,8,21,
2025-08-21,Martina Cheung,S&P Global,11,22,0,33,
2025-08-21,Leonard Schleifer,Regeneron Pharmaceuticals,6,26,8,40,
2025-08-21,Joseph Fadool,BorgWarner,4,9,0,13,
2025-08-21,Lachlan Murdoch,Fox,4,30,6,40,
2025-08-21,Karla Lewis,Reliance,4,4,1,9,
2025-08-21,John Barrett,Western & Southern Financial,7,31,2,40,
2025-08-21,Scott Donnelly,Textron,9,23,2,34,
2025-08-21,Ariane Gorin,Expedia,8,31,1,40,
2025-08-21,Michael Nolan,Fidelity National Financial,4,0,0,4,
2025-08-21,Ernest Garcia III,Carvana,22,14,4,40,
2025-08-21,Raul Fernandez,DXC Technology,4,32,1,37,
2025-08-21,Robert Berkley,WR Berkley,9,27,4,40,
2025-08-21,Ren√© Jones,M&T Bank,12,24,4,40,
2025-08-21,Lauren Hobart,Dick's Sporting Goods,8,29,3,40,
2025-08-21,Robert Frenzel,Xcel Energy,4,2,1,7,
2025-08-21,Timothy Spence,Fifth Third Bancorp,4,4,1,9,
2025-08-21,Stephen Schwarzman,Blackstone,19,17,4,40,
2025-08-21,Walker Martin,Sempra,0,2,0,2,
2025-08-21,Timothy NeCastro,Erie Insurance,3,6,1,10,
2025-08-21,Wendell Weeks,Corning,14,24,2,40,
2025-08-21,Kathleen Johnson,Lumen Technologies,4,3,1,8,
2025-08-21,Brian Tierney,FirstEnergy,4,25,2,31,
2025-08-21,Adam Schechter,Labcorp,7,20,1,28,
2025-08-21,Tiang Yew Tan,Western Digital,2,0,0,2,
2025-08-21,Richard McKenney,Unum,4,5,0,9,
2025-08-21,Javier Rodriguez,DaVita,14,15,1,30,
2025-08-21,Steven Cahillane,Kellanova,2,7,0,9,
2025-08-21,Stanley Bergman,Henry Schein,11,28,1,40,
2025-08-21,Robert Sanchez,Ryder System,9,11,1,21,
2025-08-21,Tim Hingtgen,Community Health Systems,11,27,2,40,
2025-08-21,Avigal Soreq,Delek US,3,8,5,16,
2025-08-21,Gerardo Norcia,DTE Energy,7,3,0,10,
2025-08-21,Mark Pearson,Equitable,7,9,0,16,
2025-08-21,Lori Koch,DuPont,7,19,0,26,
2025-08-21,Rich Steinmeier,LPL Financial,24,14,2,40,
2025-08-21,Bruce Van Saun,Citizens Financial,11,27,2,40,
2025-08-21,Jos√© Mas,MasTec,7,13,3,23,
2025-08-21,Andr√©s Gluski,AES,16,23,0,39,
2025-08-21,Kevin Kwilinski,Berry Global,8,19,0,27,
2025-08-21,Mark George,Norfolk Southern,19,19,2,40,
2025-08-21,Eduardo Menezes,Air Products & Chemicals,4,5,1,10,
2025-08-21,Shelley Simpson,JB Hunt Transport Services,5,32,3,40,
2025-08-21,Daniel Fisher,Ball,3,19,6,28,
2025-08-21,Sean Connolly,Conagra Brands,6,32,2,40,
2025-08-21,Stephen Steinour,Huntington Bancshares,4,7,0,11,
2025-08-21,James Snee,Hormel Foods,3,28,1,32,
2025-08-21,Joseph Nolan,Eversource Energy,4,5,1,10,
2025-08-21,William Oplinger,Alcoa,9,18,4,31,
2025-08-21,Andrew Marsh,Entergy,2,6,0,8,
2025-08-21,Keith Demmings,Assurant,4,7,0,11,
2025-08-21,Sumit Singh,Chewy,15,20,5,40,
2025-08-21,Niraj Shah,Wayfair,8,24,8,40,
2025-08-21,Joseph Ferraro,Avis Budget,3,6,1,10,
2025-08-21,Jeffrey Sprecher,Intercontinental Exchange,16,23,1,40,
2025-08-21,Benito Minicucci,Alaska Air,3,5,1,9,
2025-08-21,Malcolm Wilson,GXO Logistics,8,22,0,30,
2025-08-21,Eric Hansotia,AGCO,17,22,1,40,
2025-08-21,Kathleen Mazzarella,Graybar Electric,1,7,1,9,
2025-08-21,Gavin Hattersley,Molson Coors Beverage,5,30,5,40,
2025-08-21,Patrick Gallagher,Arthur J Gallagher,12,26,2,40,
2025-08-21,Christopher Kastner,Huntington Ingalls Industries,3,4,0,7,
2025-08-21,Erik Fyrwald,International Flavors & Fragrances,7,8,2,17,
2025-08-21,Ricardo Cardenas,Darden Restaurants,4,3,1,8,
2025-08-21,Stephen Spray,Cincinnati Financial,1,6,3,10,
2025-08-21,Scott Boatwright,Chipotle Mexican Grill,7,29,4,40,
2025-08-21,Joey Wat,Yum China,13,25,2,40,
2025-08-21,Robert Goldstein,Las Vegas Sands,4,31,5,40,
2025-08-21,Kecia Steelman,Ulta Beauty,31,8,1,40,
2025-08-21,Thomas Reeg,Caesars Entertainment,5,6,0,11,
2025-08-21,Jon Rousseau,BrightSpring Health Services,20,19,1,40,
2025-08-21,William Krueger,Andersons,0,4,0,4,
2025-08-21,Michele Buck,Hershey,9,29,2,40,
2025-08-21,Christopher Nassetta,Hilton,14,23,3,40,
2025-08-21,Bruce Bodine,Mosaic,2,7,0,9,
2025-08-21,Brian Chesky,Airbnb,1,31,8,40,
2025-08-21,Kaes Van‚Äôt Hof,Diamondback Energy,25,12,2,39,
2025-08-21,Steven Vondran,American Tower,4,7,0,11,
2025-08-21,Reshma Kewalramani,Vertex Pharmaceuticals,20,17,3,40,
2025-08-21,William McDermott,ServiceNow,4,5,0,9,
2025-08-21,Brian Chambers,Owens Corning,4,10,1,15,
2025-08-21,Teresa Rasmussen,Thrivent Financial for Lutherans,4,1,0,5,
2025-08-21,Shane O'Kelly,Advance Auto Parts,13,24,3,40,
2025-08-21,Douglas Yearley,Toll Brothers,10,25,5,40,
2025-08-21,Jeffrey Lorberbaum,Mohawk Industries,9,5,1,15,
2025-08-21,Gregory Brown,Motorola Solutions,1,8,0,9,
2025-08-21,John Pfeifer,Oshkosh,6,26,4,36,
2025-08-21,Tony Xu,DoorDash,13,21,6,40,
2025-08-21,Edward Pesicka,Owens & Minor,3,34,2,39,
2025-08-21,Eugene Bredow,NVR,0,5,0,5,
2025-08-21,Philippe Krakowsky,Interpublic,15,21,4,40,
2025-08-21,Horacio Rozanski,Booz Allen Hamilton,15,20,5,40,
2025-08-21,Michael O‚ÄôSullivan,Burlington Stores,9,29,2,40,
2025-08-21,Daniel Wall,Expeditors International of Washington,4,3,0,7,
2025-08-21,Calvin McDonald,Lululemon athletica,10,28,2,40,
2025-08-21,Stephanie Ferris,Fidelity National Information,14,22,3,39,
2025-08-21,Rich Handler,Jefferies Financial,13,13,2,28,
2025-08-21,Alan Armstrong,Williams,24,12,4,40,
2025-08-21,Bracken Darrell,VF Corporation,8,27,5,40,
2025-08-21,Mikael Bratt,Autoliv,7,8,2,17,
2025-08-21,Rafael Santana,Westinghouse Air Brake Technologies,5,6,1,12,
2025-08-21,Ralph LaRossa,Public Service Enterprise,7,17,0,24,
2025-08-21,Jamie Iannone,Ebay,18,17,5,40,
2025-08-21,Scott Richardson,Celanese,8,28,4,40,
2025-08-21,Cameron Bready,Global Payments,7,30,3,40,
2025-08-21,Robert Thomson,News Corp,7,28,5,40,
2025-08-21,Robert Martin,THOR Industries,4,5,1,10,
2025-08-21,David Rawlinson II,QVC,6,13,2,21,
2025-08-21,Andrew Teno,Icahn Enterprises,5,6,0,11,
2025-08-21,William Newlands,Constellation Brands,0,2,2,4,
2025-08-21,James Davis,Quest Diagnostics,4,5,1,10,
2025-08-21,Richard Wallace,KLA,4,4,0,8,
2025-08-21,Julian Francis,QXO Building Products,0,0,0,0,
2025-08-21,John Christmann IV,APA,6,4,0,10,
2025-08-21,Gregory Roberts,A-Mark Precious Metals,2,2,1,5,
2025-08-21,Christopher Viehbacher,Biogen,0,27,2,29,
2025-08-21,Mick Beekhuizen,Campbell's,6,23,4,33,
2025-08-21,Christopher Caldwell,Concentrix,2,5,0,7,
2025-08-21,Todd Schneider,Cintas,11,17,1,29,
2025-08-21,Tony Sarsam,SpartanNash,17,21,2,40,
2025-08-21,John Venhuizen,Ace Hardware,16,23,1,40,
2025-08-21,Vincent Roche,Analog Devices,15,23,2,40,
2025-08-21,Mark Costa,Eastman Chemical,6,19,3,28,
2025-08-21,Milan Galik,Interactive Brokers,6,16,1,23,
2025-08-21,John Turner,Regions Financial,20,18,2,40,
2025-08-21,Joanna Geraghty,JetBlue Airways,18,16,6,40,
2025-08-21,Kristin Peck,Zoetis,11,19,1,31,
2025-08-21,Christopher Gorman,KeyCorp,4,5,0,9,
2025-08-21,Mark Bertolini,Oscar Health,12,19,8,39,
2025-08-21,Brendan McCracken,Ovintiv,6,5,1,12,
2025-08-21,Robert Steer,Seaboard,1,4,0,5,
2025-08-21,Gil West,Hertz,7,27,6,40,
2025-08-21,Robert Greenberg,Skechers,6,32,2,40,
2025-08-21,Dennis Mathew,Altice,5,24,7,36,
2025-08-21,Clay Williams,NOV,13,21,4,38,
2025-08-21,Michael Doss,Graphic Packaging,7,7,2,16,
2025-08-21,Deon Stander,Avery Dennison,0,12,0,12,
2025-08-21,Adaire Fox-Martin,Equinix,16,20,4,40,
2025-08-21,Joyce Mullen,Insight Enterprises,6,11,1,18,
2025-08-21,Jennifer Witz,Sirius XM,9,10,5,24,
2025-08-21,Stefan Larsson,PVH,9,25,6,40,
2025-08-21,Jason P Wells,CenterPoint Energy,6,4,0,10,
2025-08-21,Scott Lauber,WEC Energy,13,6,0,19,
2025-08-21,Matthew Pine,Xylem,2,9,1,12,
2025-08-21,Jennifer Johnson,Franklin Resources,2,7,1,10,
2025-08-21,Vincent Sorgi,PPL,8,10,1,19,
2025-08-21,Carl Eschenbach,Workday,12,19,9,40,
2025-08-21,Richard Tobin,Dover,3,6,1,10,
2025-08-21,Mark Kowlzan,Packaging Corp of America,1,9,1,11,
2025-08-21,Scott Salmirs,ABM Industries,6,7,1,14,
2025-08-21,Gary Guthart,Intuitive Surgical,12,24,4,40,
2025-08-21,Carl Lindner lll,American Financial,0,0,0,0,
2025-08-21,Blake Moret,Rockwell Automation,11,28,1,40,
2025-08-21,Bryan Hanson,Solventum,7,11,2,20,
2025-08-21,Craig Smiddy,Old Republic International,3,5,1,9,
2025-08-21,Christopher Hilger,Securian Financial,0,6,1,7,
2025-08-21,Hamid Moghadam,Prologis,8,26,6,40,
2025-08-21,Mark Smucker,JM Smucker,10,23,7,40,
2025-08-21,Sheryl Palmer,Taylor Morrison Home,6,12,1,19,
2025-08-21,Mario Harik,XPO,7,32,1,40,
2025-08-21,Heather Lavallee,Voya Financial,7,10,2,19,
2025-08-21,Nikesh Arora,Palo Alto Networks,8,25,7,40,
2025-08-21,Giordano Albertazzi,Vertiv s,0,1,0,1,
2025-08-21,Shankh Mitra,Welltower,16,22,2,40,
2025-08-21,Mary Dillon,Foot Locker,10,25,5,40,
2025-08-21,William Monteleone,Par Pacific,1,6,2,9,
2025-08-21,Kevin Stein,TransDigm,11,10,2,23,
2025-08-21,Peter Matt,Commercial Metals,5,4,0,9,
2025-08-21,Robert Vitale,Post s,0,0,0,0,
2025-08-21,Keith Allman,Masco,6,9,1,16,
2025-08-21,Rusty Rush,Rush Enterprises,16,21,3,40,
2025-08-21,Stuart Bradie,KBR,13,16,4,33,
2025-08-21,Jack Sinclair,Sprouts Farmers Market,16,23,1,40,
2025-08-21,Laura Alber,Williams-Sonoma,10,25,5,40,
2025-08-21,Ivan Tornos,Zimmer Biomet s,1,2,0,3,
2025-08-21,John Mengucci,CACI International,22,16,2,40,
2025-08-21,Steve Sanghi,Microchip Technology,10,27,3,40,
2025-08-21,Albert Nahmad,Watsco,2,7,1,10,
2025-08-21,Christopher Peterson,Newell Brands,2,7,1,10,
2025-08-21,Arie Kotler,ARKO,6,23,0,29,
2025-08-21,Jure Sola,Sanmina,3,15,1,19,
2025-08-21,Andrew Wilson,Electronic Arts,15,18,7,40,
2025-08-21,David Gibbs,Yum Brands,3,35,2,40,
2025-08-21,Daniel Florness,Fastenal,2,6,1,9,
2025-08-21,Garrick Rochow,CMS Energy,11,3,0,14,
2025-08-21,Rodney Sacks,Monster Beverage,14,23,2,39,
2025-08-21,Mark Shapiro,Endeavor,4,35,1,40,
2025-08-21,Toni Townes-Whitley,Science Applications International,13,21,1,35,
2025-08-21,Mark Witkowski,Core & Main,1,7,0,8,
2025-08-21,John Plant,Howmet Aerospace,5,17,2,24,
2025-08-21,James Zallie,Ingredion,3,6,1,10,
2025-08-21,Thomas Hill,Vulcan Materials,4,8,2,14,
2025-08-22,Doug McMillon,Walmart,16,18,6,40,
2025-08-22,Andrew Jassy,Amazon,5,29,6,40,
2025-08-22,Stephen Hemsley,UnitedHealth,6,27,7,40,
2025-08-22,Tim Cook,Apple,18,21,1,40,
2025-08-22,David Joyner,CVS Health,7,29,4,40,
2025-08-22,Warren Buffett,Berkshire Hathaway,14,19,7,40,
2025-08-22,Sundar Pichai,Alphabet,17,15,8,40,
2025-08-22,Darren Woods,Exxon Mobil,9,24,6,39,
2025-08-22,Brian Tyler,McKesson,4,15,4,23,
2025-08-22,Robert Mauch,Cencora,5,5,0,10,
2025-08-22,Jamie Dimon,JPMorgan Chase,9,18,13,40,
2025-08-22,Ron Vachris,Costco,6,31,3,40,
2025-08-22,David Cordani,Cigna,22,15,3,40,
2025-08-22,Satya Nadella,Microsoft,16,16,8,40,
2025-08-22,Jason Hollar,Cardinal Health,12,22,5,39,
2025-08-22,Mike Wirth,Chevron,19,15,6,40,
2025-08-22,Brian Moynihan,Bank of America,7,26,7,40,
2025-08-22,Mary Barra,General Motors,12,24,4,40,
2025-08-22,Jim Farley,Ford Motor,12,22,6,40,
2025-08-22,Gail Boudreaux,Elevance Health,15,18,7,40,
2025-08-22,Jane Fraser,Citigroup,11,23,6,40,
2025-08-22,Mark Zuckerberg,Meta,17,20,3,40,
2025-08-22,Sarah London,Centene,11,20,9,40,
2025-08-22,Ted Decker,Home Depot,11,19,10,40,
2025-08-22,Priscilla Almodovar,Fannie Mae,9,17,13,39,
2025-08-22,Tim Wentworth,Walgreens,9,21,9,39,
2025-08-22,Ron Sargent,Kroger,5,21,14,40,
2025-08-22,Mark Lashier,Phillips 66,9,20,9,38,
2025-08-22,Maryann Mannen,Marathon Petroleum,6,13,1,20,
2025-08-22,Hans Vestberg,Verizon,17,20,3,40,
2025-08-22,Jensen Huang,Nvidia,12,24,4,40,
2025-08-22,David Solomon,Goldman Sachs,7,24,9,40,
2025-08-22,Charles Scharf,Wells Fargo,28,7,5,40,
2025-08-22,Lane Riggs,Valero Energy,15,8,0,23,
2025-08-22,Brian Roberts,Comcast,10,27,3,40,
2025-08-22,Jon Farney,State Farm,10,26,4,40,
2025-08-22,John Stankey,AT&T,10,24,6,40,
2025-08-22,Michael Hutchins,Freddie Mac,3,13,4,20,
2025-08-22,Jim Rechtin,Humana,19,18,3,40,
2025-08-22,Ted Pick,Morgan Stanley,16,21,3,40,
2025-08-22,Michael Fiddelke,Target,10,24,6,40,
2025-08-22,Philip Smith,StoneX,0,10,1,11,
2025-08-22,Elon Musk,Tesla,11,16,13,40,
2025-08-22,Michael Dell,Dell Technologies,11,24,5,40,
2025-08-22,Ramon Laguarta,PepsiCo,8,26,6,40,
2025-08-22,Bob Iger,Walt Disney,9,28,3,40,
2025-08-22,Carol Tom√©,UPS,7,20,13,40,
2025-08-22,Joaquin Duato,Johnson & Johnson,8,27,5,40,
2025-08-22,Rajesh Subramaniam,FedEx,11,26,0,37,
2025-08-22,Juan Luciano,Archer Daniels Midland,3,20,15,38,
2025-08-22,Jon Moeller,Procter & Gamble,6,27,7,40,
2025-08-22,Marvin Ellison,Lowe's,18,17,5,40,
2025-08-22,Thomas Long,Energy Transfer,9,0,1,10,
2025-08-22,Christopher Calio,RTX,6,11,0,17,
2025-08-22,Susan Morris,Albertsons,10,26,4,40,
2025-08-22,Kevin Hourican,Sysco,9,28,3,40,
2025-08-22,Tricia Griffith,Progressive,12,23,4,39,
2025-08-22,Stephen Squeri,American Express,13,26,1,40,
2025-08-22,James Taiclet,Lockheed Martin,11,20,9,40,
2025-08-22,Michel Khalaf,MetLife,11,17,0,28,
2025-08-22,Samuel Hazen,HCA Healthcare,9,5,0,14,
2025-08-22,Andrew Sullivan,Prudential Financial,14,23,0,37,
2025-08-22,Kelly Ortberg,Boeing,11,25,4,40,
2025-08-22,Joe Creed,Caterpillar,11,24,3,38,
2025-08-22,Robert M Davis,Merck,4,20,0,24,
2025-08-22,Thomas J Wilson,Allstate,0,9,1,10,
2025-08-22,Albert Bourla,Pfizer,20,12,8,40,
2025-08-22,Arvind Krishna,IBM,13,21,6,40,
2025-08-22,Craig DeSanto,New York Life Insurance,3,16,0,19,
2025-08-22,Ed Bastian,Delta Airlines,17,13,9,39,
2025-08-22,Kevin Murphy,Ferguson Enterprises,3,15,2,20,
2025-08-22,Kirt Walker,Nationwide,14,17,2,33,
2025-08-22,Patrick Zammit,TD Synnex,11,15,0,26,
2025-08-22,Scott Kirby,United Airlines,33,4,3,40,
2025-08-22,Ryan Lance,ConocoPhillips,17,20,3,40,
2025-08-22,Ernie Herrman,TJX,16,22,2,40,
2025-08-22,Bob Michael,AbbVie,0,0,0,0,
2025-08-22,AJ Jim Teague,Enterprise Products Partners,5,7,0,12,
2025-08-22,Christopher Winfrey,Charter Communications,6,15,5,26,
2025-08-22,George Holm,Performance Food,10,22,2,34,
2025-08-22,Robert Isom,American Airlines,7,26,7,40,
2025-08-22,Richard Fairbank,Capital One,15,21,4,40,
2025-08-22,Chuck Robbins,Cisco Systems,13,24,3,40,
2025-08-22,Enrique Lores,HP,11,23,6,40,
2025-08-22,Donnie King,Tyson Foods,10,26,4,40,
2025-08-22,Lip-Bu Tan,Intel,7,21,12,40,
2025-08-22,Safra Catz,Oracle,11,21,8,40,
2025-08-22,Hock Tan,Broadcom,13,22,5,40,
2025-08-22,John May,Deere,9,27,4,40,
2025-08-22,Elliott Hill,Nike,13,23,4,40,
2025-08-22,Timothy M Sweeney,Liberty Mutual Insurance,14,0,0,14,
2025-08-22,Wilfred Chiang,Plains GP,1,1,0,2,
2025-08-22,Juan Andrade,USAA,5,16,0,21,
2025-08-22,Chris Boerner,Bristol-Myers Squibb,10,23,7,40,
2025-08-22,Paul Bay,Ingram Micro,13,22,5,40,
2025-08-22,Phebe Novakovic,General Dynamics,28,9,3,40,
2025-08-22,James Quincey,Coca-Cola,9,28,3,40,
2025-08-22,Thasunda Brown Duckett,TIAA,17,22,0,39,
2025-08-22,Alan Schnitzer,Travelers,13,20,7,40,
2025-08-22,David Ricks,Eli Lilly,11,21,8,40,
2025-08-22,Dara Khosrowshahi,Uber,13,21,6,40,
2025-08-22,Roger Crandall,Mass Mutual,3,7,0,10,
2025-08-22,Marc Casper,Thermo Fisher Scientific,13,24,3,40,
2025-08-22,Gunjan Kedia,US Bancorp,12,26,2,40,
2025-08-22,Michael Kasbar,World Kinect,2,10,0,12,
2025-08-22,Robert Ford,Abbott Laboratories,12,23,5,40,
2025-08-22,Corie Barry,Best Buy,38,1,0,39,
2025-08-22,Tim Gerend,Northwestern Mutual,13,26,1,40,
2025-08-22,Kathy Warden,Northrop Grumman,17,19,4,40,
2025-08-22,Joe Zubretsky,Molina Healthcare,9,7,4,20,
2025-08-22,Todd Vasos,Dollar General,6,25,9,40,
2025-08-22,Robin Vince,Bank of New York,19,18,3,40,
2025-08-22,David Zaslav,Warner Bros Discovery,6,22,12,40,
2025-08-22,Jay Debertin,CHS,3,8,4,15,
2025-08-22,Ted Sarandos,Netflix,10,27,3,40,
2025-08-22,Cristiano Amon,Qualcomm,11,27,1,39,
2025-08-22,Larry Culp,General Electric,11,26,3,40,
2025-08-22,Vimal Kapur,Honeywell,11,29,0,40,
2025-08-22,Marc Benioff,Salesforce,9,23,8,40,
2025-08-22,Jacek Olczak,Philip Morris,14,21,5,40,
2025-08-22,David Flitman,US Foods,2,7,0,9,
2025-08-22,Paul Romanowski,DR Horton,6,15,3,24,
2025-08-22,Bryan DeBoer,Lithia Motors,13,25,1,39,
2025-08-22,Dirk Van de Put,Mondelez,12,25,3,40,
2025-08-22,Brian Niccol,Starbucks,12,28,0,40,
2025-08-22,Ryan McInerney,Visa,15,20,5,40,
2025-08-22,Robert Sulentic,CBRE,2,7,1,10,
2025-08-22,Jonathan Jaffe,Lennar,0,9,1,10,
2025-08-22,Scott Strazik,GE Vernova,14,23,3,40,
2025-08-22,William Demchak,PNC,14,21,5,40,
2025-08-22,Jennifer Rumsey,Cummins,9,27,4,40,
2025-08-22,Preston Feight,Paccar,7,27,2,36,
2025-08-22,Robert Bradway,Amgen,10,27,3,40,
2025-08-22,Matthew Lucey,PBF Energy,5,2,1,8,
2025-08-22,Pat Geraghty,GuideWell Mutual,2,7,0,9,
2025-08-22,Alex Chriss,PayPal,12,26,2,40,
2025-08-22,Sandy Douglas,United Natural Foods,33,6,1,40,
2025-08-22,Michael Creedon,Dollar Tree,4,34,2,40,
2025-08-22,Leon Topalian,Nucor,15,22,3,40,
2025-08-22,Roger Penske,Penske Automotive,18,21,1,40,
2025-08-22,Bom Kim,Coupang,10,29,1,40,
2025-08-22,Antonio Neri,Hewlett Packard,8,23,9,40,
2025-08-22,Harry Sideris,Duke Energy,37,3,0,40,
2025-08-22,Joseph Bae,KKR,20,18,2,40,
2025-08-22,Brian Robbins,Paramount Global,9,27,0,36,
2025-08-22,Michael Dastoor,Jabil,2,5,0,7,
2025-08-22,Daniel O'Day,Gilead Sciences,17,20,3,40,
2025-08-22,Tim Go,HF Sinclair,6,4,0,10,
2025-08-22,William Nash,CarMax,3,3,2,8,
2025-08-22,Michael Miebach,Mastercard,10,26,4,40,
2025-08-22,Lawrence Coben,NRG Energy,7,2,0,9,
2025-08-22,Sean Kerins,Arrow Electronics,3,15,0,18,
2025-08-22,Lorenzo Simonelli,Baker Hughes,15,21,4,40,
2025-08-22,Bob Jordan,Southwest Airlines,10,23,7,40,
2025-08-22,Peter Zaffino,American International,7,30,3,40,
2025-08-22,Gary Dickerson,Applied Materials,7,22,11,40,
2025-08-22,Vicki Hollub,Occidental Petroleum,19,17,3,39,
2025-08-22,Michael Manley,AutoNation,3,5,1,9,
2025-08-22,Christopher Womack,Southern Company,2,8,0,10,
2025-08-22,Christopher Swift,Hartford Insurance,5,5,0,10,
2025-08-22,Marc Rowan,Apollo Global Management,15,21,4,40,
2025-08-22,Rick Wurster,Charles Schwab,14,21,4,39,
2025-08-22,Chris Kempczinski,McDonald's,14,17,9,40,
2025-08-22,Carlos Abrams-Rivera,Kraft Heinz,13,21,6,40,
2025-08-22,Lisa Su,Advanced Micro Devices,19,18,3,40,
2025-08-22,William H Rogers Jr,Truist Financial,2,7,1,10,
2025-08-22,Kathleen Quirk,Freeport-McMoRan,13,17,3,33,
2025-08-22,Sanjay Mehrotra,Micron Technology,17,21,2,40,
2025-08-22,Anthony Capuano,Marriott International,12,24,4,40,
2025-08-22,David Gitlin,Carrier Global,16,23,1,40,
2025-08-22,John Ketchum,NextEra Energy,22,18,0,40,
2025-08-22,William M Brown,3M,2,8,0,10,
2025-08-22,John Doyle,Marsh & McLennan,13,9,1,23,
2025-08-22,Patricia Poppe,PG&E,8,14,2,24,
2025-08-22,Jim Vena,Union Pacific,19,21,0,40,
2025-08-22,Brian Doubles,Synchrony Financial,5,6,2,13,
2025-08-22,Rainer Blair,Danaher,6,15,1,22,
2025-08-22,Philip Gallagher,Avnet,1,3,0,4,
2025-08-22,Glenn Fogel,Booking s,0,3,1,4,
2025-08-22,Ezra Yacob,EOG Resources,23,13,0,36,
2025-08-22,Earl Austin,Quanta Services,3,4,1,8,
2025-08-22,Michael Shepherd,Discover Financial,9,14,2,25,
2025-08-22,Joseph Dominguez,Constellation Energy,14,11,1,26,
2025-08-22,William Stengel II,Genuine Parts,0,4,0,4,
2025-08-22,Christian Ulbrich,Jones Lang LaSalle,10,21,0,31,
2025-08-22,Raymond E Scott,Lear Corporation,5,4,0,9,
2025-08-22,Michael Rapino,Live Nation Entertainment,13,24,3,40,
2025-08-22,Heidi Petz,Sherwin-Williams,8,27,3,38,
2025-08-22,Calvin G Butler Jr,Exelon,6,5,0,11,
2025-08-22,Tony Spring,Macy's,12,26,2,40,
2025-08-22,Jeff Miller,Halliburton,13,21,6,40,
2025-08-22,Kevin Lobo,Stryker,13,24,3,40,
2025-08-22,Tony Cheng,Reinsurance of America,0,0,0,0,
2025-08-22,Ronald P O'Hanley,State Street,5,14,0,19,
2025-08-22,John Engel,WESCO International,5,10,1,16,
2025-08-22,Pierce Norton II,Oneok,6,3,0,9,
2025-08-22,Shantanu Narayen,Adobe,19,20,1,40,
2025-08-22,Bill Westrate,American Family Insurance,12,14,2,28,
2025-08-22,Chris Kubasik,L3Harris Technologies,7,13,1,21,
2025-08-22,James Conroy,Ross Stores,5,12,0,17,
2025-08-22,Christine Leahy,CDW,1,7,2,10,
2025-08-22,Saumya Sutaria,Tenet Healthcare,5,3,1,9,
2025-08-22,Bob Eddy,BJ's Wholesale Club,7,31,2,40,
2025-08-22,Mike Lyons,Fiserv,4,11,0,15,
2025-08-22,William Gifford,Altria,2,5,1,8,
2025-08-22,Larry Fink,BlackRock,8,24,8,40,
2025-08-22,Thomas Polen,Becton Dickinson,6,3,0,9,
2025-08-22,Noel Wallace,Colgate-Palmolive,10,18,2,30,
2025-08-22,Michael Hsu,Kimberly-Clark,6,6,2,14,
2025-08-22,Daryl Kenningham,1 Automotive,10,21,1,32,
2025-08-22,Jennifer Parmentier,Parker-Hannifin,2,12,0,14,
2025-08-22,Jeffrey Harmening,General Mills,6,16,4,26,
2025-08-22,Ravi Kumar S,Cognizant Technology,9,27,4,40,
2025-08-22,William Fehrman,American Electric Power,4,6,0,10,
2025-08-22,Peter Arduini,GE HealthCare Technologies,8,10,0,18,
2025-08-22,Maria Black,Automatic Data Processing,6,4,0,10,
2025-08-22,Lourenco Goncalves,Cleveland-Cliffs,8,21,11,40,
2025-08-22,Dan Amos,Aflac,13,19,8,40,
2025-08-22,Mark Stewart,Goodyear Tire & Rubber,4,34,2,40,
2025-08-22,Kevin Hogan,Corebridge Financial,5,12,0,17,
2025-08-22,Thomas Palmer,Newmont,6,4,0,10,
2025-08-22,Andrew Silvernail,International Paper,6,18,0,24,
2025-08-22,Philip Daniele III,AutoZone,0,2,0,2,
2025-08-22,Ellen Cooper,Lincoln National,3,8,0,11,
2025-08-22,Ryan Marshall,PulteGroup,13,16,11,40,
2025-08-22,James Cracchiolo,Ameriprise Financial,2,24,2,28,
2025-08-22,Andrew Clyde,Murphy USA,14,25,1,40,
2025-08-22,Jonas Prising,Manpower,9,7,1,17,
2025-08-22,David Bozeman,CH Robinson Worldwide,2,7,1,10,
2025-08-22,Timothy Knavish,PPG Industries,1,2,0,3,
2025-08-22,Pedro Pizarro,Edison International,15,8,17,40,
2025-08-22,Mark Millett,Steel Dynamics,16,2,0,18,
2025-08-22,Benjamin Tisch,Loews,1,7,0,8,
2025-08-22,Karsanbhai,Emerson Electric,10,18,2,30,
2025-08-22,John Zillmer,Aramark,8,15,2,25,
2025-08-22,William Hornbuckle,MGM Resorts International,5,25,1,31,
2025-08-22,James Burke,Vistra,6,4,0,10,
2025-08-22,David Hult,Asbury Automotive,10,29,1,40,
2025-08-22,DG Macpherson,WW Grainger,2,7,1,10,
2025-08-22,Eric Slifka,Global Partners,14,21,5,40,
2025-08-22,Bob Pragada,Jacobs Solutions,6,9,0,15,
2025-08-22,Charles Magro,Corteva,4,3,1,8,
2025-08-22,Rick Lanoha,Peter Kiewit Sons',0,2,0,2,
2025-08-22,Michael Mahoney,Boston Scientific,9,30,1,40,
2025-08-22,Brad Beckham,O'Reilly Automotive,5,15,1,21,
2025-08-22,Thomas Bell,Leidos,8,19,1,28,
2025-08-22,Thomas Gayner,Markel Group,1,9,0,10,
2025-08-22,Marc Bitzer,Whirlpool,12,13,15,40,
2025-08-22,Andrew McMahon,Guardian Life,5,14,0,19,
2025-08-22,Peter Jackson,Builders FirstSource,4,11,1,16,
2025-08-22,Michael Rhodes,Ally Financial,11,22,4,37,
2025-08-22,Matthew Meloy,Targa Resources,5,5,0,10,
2025-08-22,James Breuer,Fluor,0,2,1,3,
2025-08-22,Sasan Goodarzi,Intuit,10,26,4,40,
2025-08-22,Troy Rudd,AECOM,7,25,4,36,
2025-08-22,Penny Pennington,Edward Jones,7,28,5,40,
2025-08-22,Michael Bender,Kohl's,1,25,14,40,
2025-08-22,Beth Ford,Land O'Lakes,17,21,2,40,
2025-08-22,Deanna Strable-Soethout,Principal Financial,1,6,0,7,
2025-08-22,Robert Blue,Dominion Energy,27,9,2,38,
2025-08-22,Martin Schroeter,Kyndryl s,0,3,0,3,
2025-08-22,Jon Vander Ark,Republic Services,11,19,10,40,
2025-08-22,Clay Gaspar,Devon Energy,19,3,0,22,
2025-08-22,Christopher O'Herlihy,Illinois Tool Works,4,4,2,10,
2025-08-22,Michael O'Grady,Northern Trust,26,5,1,32,
2025-08-22,Jamie Whisnant,Auto-Owners Insurance,0,2,0,2,
2025-08-22,Marc Miller,Universal Health Services,4,22,2,28,
2025-08-22,Darryl Button,Pacific Life,0,7,0,7,
2025-08-22,Hamid Akhavan,EchoStar,4,25,11,40,
2025-08-22,Christophe Beck,Ecolab,19,21,0,40,
2025-08-22,Jack Fusco,Cheniere Energy,19,18,3,40,
2025-08-22,John Wren,Omnicom,10,20,10,40,
2025-08-22,Haviv Ilan,Texas Instruments,11,26,3,40,
2025-08-22,David Burritt,United States Steel,7,20,13,40,
2025-08-22,St√©phane de La Faverie,Est√©e Lauder,13,23,4,40,
2025-08-22,Raul Nicholas Vargas Ochoa,Farmers Insurance Exchange,0,0,0,0,
2025-08-22,Thibaut Mongon,Kenvue,9,29,2,40,
2025-08-22,Ari Bousbib,IQVIA s,0,0,0,0,
2025-08-22,Donald Allan,Stanley Black & Decker,9,29,2,40,
2025-08-22,Timothy Cofer,Keurig Dr Pepper,2,2,1,5,
2025-08-22,Matthew Flannery,United Rentals,31,3,0,34,
2025-08-22,Timothy Cawley,Consolidated Edison,4,6,0,10,
2025-08-22,Adam Norwitt,Amphenol,4,17,0,21,
2025-08-22,Brent Shafer,Baxter International,1,10,0,11,
2025-08-22,Kimberly Dang,Kinder Morgan,9,1,0,10,
2025-08-22,Erik Nordstrom,Nordstrom,7,27,5,39,
2025-08-22,Frank Holding,First Citizens BancShares,10,13,2,25,
2025-08-22,Paul Shoukry,Raymond James Financial,14,25,1,40,
2025-08-22,Timothy Archer,Lam Research,2,7,1,10,
2025-08-22,Harry Lawton III,Tractor Supply,1,1,0,2,
2025-08-22,Darren Rebelez,Casey's General Stores,15,23,2,40,
2025-08-22,Scott Smith,Viatris,7,4,0,11,
2025-08-22,James Blackledge,Mutual of Omaha Insurance,0,6,0,6,
2025-08-22,Anthony Guzzi,EMCOR,4,4,0,8,
2025-08-22,Joseph Hinrichs,CSX,5,8,1,14,
2025-08-22,Justin Jude,LKQ,4,6,1,11,
2025-08-22,Judith Marks,Otis Worldwide,2,4,0,6,
2025-08-22,David Bruton Smith,Sonic Automotive,4,9,8,21,
2025-08-22,Martina Cheung,S&P Global,11,23,0,34,
2025-08-22,Leonard Schleifer,Regeneron Pharmaceuticals,6,26,8,40,
2025-08-22,Joseph Fadool,BorgWarner,4,9,0,13,
2025-08-22,Lachlan Murdoch,Fox,5,29,6,40,
2025-08-22,Karla Lewis,Reliance,4,5,0,9,
2025-08-22,John Barrett,Western & Southern Financial,8,30,2,40,
2025-08-22,Scott Donnelly,Textron,9,28,3,40,
2025-08-22,Ariane Gorin,Expedia,8,30,1,39,
2025-08-22,Michael Nolan,Fidelity National Financial,4,0,0,4,
2025-08-22,Ernest Garcia III,Carvana,22,14,4,40,
2025-08-22,Raul Fernandez,DXC Technology,4,33,1,38,
2025-08-22,Robert Berkley,WR Berkley,9,27,4,40,
2025-08-22,Ren√© Jones,M&T Bank,11,24,5,40,
2025-08-22,Lauren Hobart,Dick's Sporting Goods,11,26,3,40,
2025-08-22,Robert Frenzel,Xcel Energy,4,2,1,7,
2025-08-22,Timothy Spence,Fifth Third Bancorp,4,4,1,9,
2025-08-22,Stephen Schwarzman,Blackstone,17,19,4,40,
2025-08-22,Walker Martin,Sempra,0,2,0,2,
2025-08-22,Timothy NeCastro,Erie Insurance,3,6,1,10,
2025-08-22,Wendell Weeks,Corning,15,23,2,40,
2025-08-22,Kathleen Johnson,Lumen Technologies,4,3,1,8,
2025-08-22,Brian Tierney,FirstEnergy,4,26,2,32,
2025-08-22,Adam Schechter,Labcorp,7,20,1,28,
2025-08-22,Tiang Yew Tan,Western Digital,2,1,0,3,
2025-08-22,Richard McKenney,Unum,4,5,0,9,
2025-08-22,Javier Rodriguez,DaVita,14,15,1,30,
2025-08-22,Steven Cahillane,Kellanova,2,7,0,9,
2025-08-22,Stanley Bergman,Henry Schein,11,28,1,40,
2025-08-22,Robert Sanchez,Ryder System,9,9,1,19,
2025-08-22,Tim Hingtgen,Community Health Systems,11,27,2,40,
2025-08-22,Avigal Soreq,Delek US,2,9,5,16,
2025-08-22,Gerardo Norcia,DTE Energy,7,3,0,10,
2025-08-22,Mark Pearson,Equitable,8,8,0,16,
2025-08-22,Lori Koch,DuPont,7,19,0,26,
2025-08-22,Rich Steinmeier,LPL Financial,24,14,2,40,
2025-08-22,Bruce Van Saun,Citizens Financial,11,27,2,40,
2025-08-22,Jos√© Mas,MasTec,7,14,3,24,
2025-08-22,Andr√©s Gluski,AES,19,20,0,39,
2025-08-22,Kevin Kwilinski,Berry Global,8,18,0,26,
2025-08-22,Mark George,Norfolk Southern,20,19,1,40,
2025-08-22,Eduardo Menezes,Air Products & Chemicals,5,4,1,10,
2025-08-22,Shelley Simpson,JB Hunt Transport Services,6,31,3,40,
2025-08-22,Daniel Fisher,Ball,3,20,6,29,
2025-08-22,Sean Connolly,Conagra Brands,5,33,2,40,
2025-08-22,Stephen Steinour,Huntington Bancshares,3,7,0,10,
2025-08-22,James Snee,Hormel Foods,3,29,1,33,
2025-08-22,Joseph Nolan,Eversource Energy,5,4,1,10,
2025-08-22,William Oplinger,Alcoa,9,18,4,31,
2025-08-22,Andrew Marsh,Entergy,2,6,0,8,
2025-08-22,Keith Demmings,Assurant,4,7,0,11,
2025-08-22,Sumit Singh,Chewy,15,21,4,40,
2025-08-22,Niraj Shah,Wayfair,9,23,8,40,
2025-08-22,Joseph Ferraro,Avis Budget,2,7,1,10,
2025-08-22,Jeffrey Sprecher,Intercontinental Exchange,15,23,2,40,
2025-08-22,Benito Minicucci,Alaska Air,4,4,1,9,
2025-08-22,Malcolm Wilson,GXO Logistics,7,22,0,29,
2025-08-22,Eric Hansotia,AGCO,17,20,1,38,
2025-08-22,Kathleen Mazzarella,Graybar Electric,1,7,1,9,
2025-08-22,Gavin Hattersley,Molson Coors Beverage,5,30,5,40,
2025-08-22,Patrick Gallagher,Arthur J Gallagher,8,30,2,40,
2025-08-22,Christopher Kastner,Huntington Ingalls Industries,3,4,1,8,
2025-08-22,Erik Fyrwald,International Flavors & Fragrances,6,8,2,16,
2025-08-22,Ricardo Cardenas,Darden Restaurants,4,3,1,8,
2025-08-22,Stephen Spray,Cincinnati Financial,1,6,3,10,
2025-08-22,Scott Boatwright,Chipotle Mexican Grill,7,28,5,40,
2025-08-22,Joey Wat,Yum China,14,24,2,40,
2025-08-22,Robert Goldstein,Las Vegas Sands,3,32,5,40,
2025-08-22,Kecia Steelman,Ulta Beauty,33,6,1,40,
2025-08-22,Thomas Reeg,Caesars Entertainment,5,6,1,12,
2025-08-22,Jon Rousseau,BrightSpring Health Services,21,18,1,40,
2025-08-22,William Krueger,Andersons,0,4,0,4,
2025-08-22,Michele Buck,Hershey,7,31,2,40,
2025-08-22,Christopher Nassetta,Hilton,13,23,4,40,
2025-08-22,Bruce Bodine,Mosaic,2,7,0,9,
2025-08-22,Brian Chesky,Airbnb,2,30,8,40,
2025-08-22,Kaes Van‚Äôt Hof,Diamondback Energy,25,12,2,39,
2025-08-22,Steven Vondran,American Tower,4,7,0,11,
2025-08-22,Reshma Kewalramani,Vertex Pharmaceuticals,21,16,3,40,
2025-08-22,William McDermott,ServiceNow,3,6,0,9,
2025-08-22,Brian Chambers,Owens Corning,3,11,1,15,
2025-08-22,Teresa Rasmussen,Thrivent Financial for Lutherans,4,1,0,5,
2025-08-22,Shane O'Kelly,Advance Auto Parts,13,24,3,40,
2025-08-22,Douglas Yearley,Toll Brothers,10,25,5,40,
2025-08-22,Jeffrey Lorberbaum,Mohawk Industries,10,5,1,16,
2025-08-22,Gregory Brown,Motorola Solutions,1,8,0,9,
2025-08-22,John Pfeifer,Oshkosh,6,25,5,36,
2025-08-22,Tony Xu,DoorDash,14,20,6,40,
2025-08-22,Edward Pesicka,Owens & Minor,3,35,2,40,
2025-08-22,Eugene Bredow,NVR,0,5,0,5,
2025-08-22,Philippe Krakowsky,Interpublic,15,21,4,40,
2025-08-22,Horacio Rozanski,Booz Allen Hamilton,16,19,5,40,
2025-08-22,Michael O‚ÄôSullivan,Burlington Stores,7,30,3,40,
2025-08-22,Daniel Wall,Expeditors International of Washington,4,3,0,7,
2025-08-22,Calvin McDonald,Lululemon athletica,10,28,2,40,
2025-08-22,Stephanie Ferris,Fidelity National Information,14,23,3,40,
2025-08-22,Rich Handler,Jefferies Financial,13,11,2,26,
2025-08-22,Alan Armstrong,Williams,23,14,3,40,
2025-08-22,Bracken Darrell,VF Corporation,8,27,5,40,
2025-08-22,Mikael Bratt,Autoliv,7,7,2,16,
2025-08-22,Rafael Santana,Westinghouse Air Brake Technologies,5,7,1,13,
2025-08-22,Ralph LaRossa,Public Service Enterprise,7,17,0,24,
2025-08-22,Jamie Iannone,Ebay,19,17,4,40,
2025-08-22,Scott Richardson,Celanese,6,21,3,30,
2025-08-22,Cameron Bready,Global Payments,7,30,3,40,
2025-08-22,Robert Thomson,News Corp,7,27,6,40,
2025-08-22,Robert Martin,THOR Industries,4,5,1,10,
2025-08-22,David Rawlinson II,QVC,6,13,2,21,
2025-08-22,Andrew Teno,Icahn Enterprises,5,6,0,11,
2025-08-22,William Newlands,Constellation Brands,0,2,2,4,
2025-08-22,James Davis,Quest Diagnostics,4,5,1,10,
2025-08-22,Richard Wallace,KLA,4,4,0,8,
2025-08-22,Julian Francis,QXO Building Products,0,0,0,0,
2025-08-22,John Christmann IV,APA,6,4,0,10,
2025-08-22,Gregory Roberts,A-Mark Precious Metals,2,2,1,5,
2025-08-22,Christopher Viehbacher,Biogen,0,27,2,29,
2025-08-22,Mick Beekhuizen,Campbell's,6,23,4,33,
2025-08-22,Christopher Caldwell,Concentrix,2,5,0,7,
2025-08-22,Todd Schneider,Cintas,11,18,1,30,
2025-08-22,Tony Sarsam,SpartanNash,16,22,2,40,
2025-08-22,John Venhuizen,Ace Hardware,15,24,1,40,
2025-08-22,Vincent Roche,Analog Devices,13,24,3,40,
2025-08-22,Mark Costa,Eastman Chemical,6,20,2,28,
2025-08-22,Milan Galik,Interactive Brokers,6,16,1,23,
2025-08-22,John Turner,Regions Financial,19,19,2,40,
2025-08-22,Joanna Geraghty,JetBlue Airways,18,16,6,40,
2025-08-22,Kristin Peck,Zoetis,11,19,1,31,
2025-08-22,Christopher Gorman,KeyCorp,4,6,0,10,
2025-08-22,Mark Bertolini,Oscar Health,12,19,8,39,
2025-08-22,Brendan McCracken,Ovintiv,6,5,1,12,
2025-08-22,Robert Steer,Seaboard,1,4,0,5,
2025-08-22,Gil West,Hertz,7,27,6,40,
2025-08-22,Robert Greenberg,Skechers,5,33,2,40,
2025-08-22,Dennis Mathew,Altice,5,25,7,37,
2025-08-22,Clay Williams,NOV,10,18,3,31,
2025-08-22,Michael Doss,Graphic Packaging,7,7,2,16,
2025-08-22,Deon Stander,Avery Dennison,0,12,0,12,
2025-08-22,Adaire Fox-Martin,Equinix,16,20,4,40,
2025-08-22,Joyce Mullen,Insight Enterprises,6,11,1,18,
2025-08-22,Jennifer Witz,Sirius XM,9,11,6,26,
2025-08-22,Stefan Larsson,PVH,10,24,6,40,
2025-08-22,Jason P Wells,CenterPoint Energy,6,4,0,10,
2025-08-22,Scott Lauber,WEC Energy,12,6,0,18,
2025-08-22,Matthew Pine,Xylem,2,9,1,12,
2025-08-22,Jennifer Johnson,Franklin Resources,2,7,1,10,
2025-08-22,Vincent Sorgi,PPL,8,10,1,19,
2025-08-22,Carl Eschenbach,Workday,11,20,9,40,
2025-08-22,Richard Tobin,Dover,3,6,1,10,
2025-08-22,Mark Kowlzan,Packaging Corp of America,1,10,1,12,
2025-08-22,Scott Salmirs,ABM Industries,6,6,1,13,
2025-08-22,Gary Guthart,Intuitive Surgical,12,24,4,40,
2025-08-22,Carl Lindner lll,American Financial,0,0,0,0,
2025-08-22,Blake Moret,Rockwell Automation,12,27,1,40,
2025-08-22,Bryan Hanson,Solventum,6,12,2,20,
2025-08-22,Craig Smiddy,Old Republic International,3,5,1,9,
2025-08-22,Christopher Hilger,Securian Financial,0,6,1,7,
2025-08-22,Hamid Moghadam,Prologis,9,26,5,40,
2025-08-22,Mark Smucker,JM Smucker,10,23,7,40,
2025-08-22,Sheryl Palmer,Taylor Morrison Home,6,13,1,20,
2025-08-22,Mario Harik,XPO,7,32,1,40,
2025-08-22,Heather Lavallee,Voya Financial,7,9,2,18,
2025-08-22,Nikesh Arora,Palo Alto Networks,8,24,8,40,
2025-08-22,Giordano Albertazzi,Vertiv s,0,1,0,1,
2025-08-22,Shankh Mitra,Welltower,17,21,2,40,
2025-08-22,Mary Dillon,Foot Locker,9,26,5,40,
2025-08-22,William Monteleone,Par Pacific,1,6,2,9,
2025-08-22,Kevin Stein,TransDigm,10,11,2,23,
2025-08-22,Peter Matt,Commercial Metals,6,4,0,10,
2025-08-22,Robert Vitale,Post s,0,0,0,0,
2025-08-22,Keith Allman,Masco,6,9,1,16,
2025-08-22,Rusty Rush,Rush Enterprises,16,21,3,40,
2025-08-22,Stuart Bradie,KBR,14,15,4,33,
2025-08-22,Jack Sinclair,Sprouts Farmers Market,15,24,1,40,
2025-08-22,Laura Alber,Williams-Sonoma,10,25,5,40,
2025-08-22,Ivan Tornos,Zimmer Biomet s,1,2,0,3,
2025-08-22,John Mengucci,CACI International,22,17,1,40,
2025-08-22,Steve Sanghi,Microchip Technology,9,28,3,40,
2025-08-22,Albert Nahmad,Watsco,2,6,1,9,
2025-08-22,Christopher Peterson,Newell Brands,2,7,1,10,
2025-08-22,Arie Kotler,ARKO,6,24,0,30,
2025-08-22,Jure Sola,Sanmina,3,16,1,20,
2025-08-22,Andrew Wilson,Electronic Arts,15,17,8,40,
2025-08-22,David Gibbs,Yum Brands,3,35,2,40,
2025-08-22,Daniel Florness,Fastenal,2,6,1,9,
2025-08-22,Garrick Rochow,CMS Energy,11,3,0,14,
2025-08-22,Rodney Sacks,Monster Beverage,14,23,2,39,
2025-08-22,Mark Shapiro,Endeavor,4,35,1,40,
2025-08-22,Toni Townes-Whitley,Science Applications International,13,21,1,35,
2025-08-22,Mark Witkowski,Core & Main,0,7,0,7,
2025-08-22,John Plant,Howmet Aerospace,5,16,2,23,
2025-08-22,James Zallie,Ingredion,3,6,1,10,
2025-08-22,Thomas Hill,Vulcan Materials,4,8,2,14,
2025-08-23,Doug McMillon,Walmart,16,17,7,40,
2025-08-23,Andrew Jassy,Amazon,5,29,6,40,
2025-08-23,Stephen Hemsley,UnitedHealth,8,25,6,39,
2025-08-23,Tim Cook,Apple,15,23,2,40,
2025-08-23,David Joyner,CVS Health,7,29,4,40,
2025-08-23,Warren Buffett,Berkshire Hathaway,12,20,7,39,
2025-08-23,Sundar Pichai,Alphabet,17,16,7,40,
2025-08-23,Darren Woods,Exxon Mobil,9,25,5,39,
2025-08-23,Brian Tyler,McKesson,4,16,4,24,
2025-08-23,Robert Mauch,Cencora,5,5,0,10,
2025-08-23,Jamie Dimon,JPMorgan Chase,10,17,13,40,
2025-08-23,Ron Vachris,Costco,6,32,2,40,
2025-08-23,David Cordani,Cigna,21,15,4,40,
2025-08-23,Satya Nadella,Microsoft,17,16,7,40,
2025-08-23,Jason Hollar,Cardinal Health,13,21,5,39,
2025-08-23,Mike Wirth,Chevron,19,16,5,40,
2025-08-23,Brian Moynihan,Bank of America,7,29,4,40,
2025-08-23,Mary Barra,General Motors,12,24,4,40,
2025-08-23,Jim Farley,Ford Motor,14,19,7,40,
2025-08-23,Gail Boudreaux,Elevance Health,16,17,7,40,
2025-08-23,Jane Fraser,Citigroup,12,22,6,40,
2025-08-23,Mark Zuckerberg,Meta,14,20,6,40,
2025-08-23,Sarah London,Centene,12,20,8,40,
2025-08-23,Ted Decker,Home Depot,11,21,8,40,
2025-08-23,Priscilla Almodovar,Fannie Mae,9,18,12,39,
2025-08-23,Tim Wentworth,Walgreens,10,20,9,39,
2025-08-23,Ron Sargent,Kroger,5,21,14,40,
2025-08-23,Mark Lashier,Phillips 66,9,21,8,38,
2025-08-23,Maryann Mannen,Marathon Petroleum,6,13,1,20,
2025-08-23,Hans Vestberg,Verizon,19,19,2,40,
2025-08-23,Jensen Huang,Nvidia,18,19,3,40,
2025-08-23,David Solomon,Goldman Sachs,6,24,10,40,
2025-08-23,Charles Scharf,Wells Fargo,29,6,5,40,
2025-08-23,Lane Riggs,Valero Energy,15,8,0,23,
2025-08-23,Brian Roberts,Comcast,10,27,3,40,
2025-08-23,Jon Farney,State Farm,10,26,4,40,
2025-08-23,John Stankey,AT&T,11,25,4,40,
2025-08-23,Michael Hutchins,Freddie Mac,3,12,4,19,
2025-08-23,Jim Rechtin,Humana,20,17,3,40,
2025-08-23,Ted Pick,Morgan Stanley,15,22,3,40,
2025-08-23,Michael Fiddelke,Target,9,25,6,40,
2025-08-23,Philip Smith,StoneX,0,9,1,10,
2025-08-23,Elon Musk,Tesla,11,15,14,40,
2025-08-23,Michael Dell,Dell Technologies,10,25,5,40,
2025-08-23,Ramon Laguarta,PepsiCo,8,27,5,40,
2025-08-23,Bob Iger,Walt Disney,9,28,3,40,
2025-08-23,Carol Tom√©,UPS,8,20,12,40,
2025-08-23,Joaquin Duato,Johnson & Johnson,9,27,4,40,
2025-08-23,Rajesh Subramaniam,FedEx,11,26,0,37,
2025-08-23,Juan Luciano,Archer Daniels Midland,4,20,14,38,
2025-08-23,Jon Moeller,Procter & Gamble,8,27,5,40,
2025-08-23,Marvin Ellison,Lowe's,16,19,5,40,
2025-08-23,Thomas Long,Energy Transfer,8,0,1,9,
2025-08-23,Christopher Calio,RTX,6,11,0,17,
2025-08-23,Susan Morris,Albertsons,11,26,3,40,
2025-08-23,Kevin Hourican,Sysco,9,28,3,40,
2025-08-23,Tricia Griffith,Progressive,12,23,4,39,
2025-08-23,Stephen Squeri,American Express,14,25,1,40,
2025-08-23,James Taiclet,Lockheed Martin,12,19,9,40,
2025-08-23,Michel Khalaf,MetLife,12,16,0,28,
2025-08-23,Samuel Hazen,HCA Healthcare,9,5,0,14,
2025-08-23,Andrew Sullivan,Prudential Financial,12,23,0,35,
2025-08-23,Kelly Ortberg,Boeing,11,25,4,40,
2025-08-23,Joe Creed,Caterpillar,10,27,3,40,
2025-08-23,Robert M Davis,Merck,4,20,0,24,
2025-08-23,Thomas J Wilson,Allstate,1,8,1,10,
2025-08-23,Albert Bourla,Pfizer,19,12,9,40,
2025-08-23,Arvind Krishna,IBM,13,21,6,40,
2025-08-23,Craig DeSanto,New York Life Insurance,3,16,0,19,
2025-08-23,Ed Bastian,Delta Airlines,16,13,10,39,
2025-08-23,Kevin Murphy,Ferguson Enterprises,3,15,2,20,
2025-08-23,Kirt Walker,Nationwide,14,17,2,33,
2025-08-23,Patrick Zammit,TD Synnex,10,15,0,25,
2025-08-23,Scott Kirby,United Airlines,31,5,4,40,
2025-08-23,Ryan Lance,ConocoPhillips,18,19,3,40,
2025-08-23,Ernie Herrman,TJX,15,23,2,40,
2025-08-23,Bob Michael,AbbVie,0,0,0,0,
2025-08-23,AJ Jim Teague,Enterprise Products Partners,5,6,0,11,
2025-08-23,Christopher Winfrey,Charter Communications,5,15,5,25,
2025-08-23,George Holm,Performance Food,10,22,2,34,
2025-08-23,Robert Isom,American Airlines,6,27,7,40,
2025-08-23,Richard Fairbank,Capital One,15,23,2,40,
2025-08-23,Chuck Robbins,Cisco Systems,15,22,3,40,
2025-08-23,Enrique Lores,HP,12,22,6,40,
2025-08-23,Donnie King,Tyson Foods,10,26,4,40,
2025-08-23,Lip-Bu Tan,Intel,12,21,7,40,
2025-08-23,Safra Catz,Oracle,11,22,7,40,
2025-08-23,Hock Tan,Broadcom,13,22,5,40,
2025-08-23,John May,Deere,9,27,4,40,
2025-08-23,Elliott Hill,Nike,14,22,4,40,
2025-08-23,Timothy M Sweeney,Liberty Mutual Insurance,14,0,0,14,
2025-08-23,Wilfred Chiang,Plains GP,2,1,0,3,
2025-08-23,Juan Andrade,USAA,5,16,0,21,
2025-08-23,Chris Boerner,Bristol-Myers Squibb,10,23,7,40,
2025-08-23,Paul Bay,Ingram Micro,12,23,5,40,
2025-08-23,Phebe Novakovic,General Dynamics,28,9,3,40,
2025-08-23,James Quincey,Coca-Cola,11,25,4,40,
2025-08-23,Thasunda Brown Duckett,TIAA,18,21,0,39,
2025-08-23,Alan Schnitzer,Travelers,15,18,7,40,
2025-08-23,David Ricks,Eli Lilly,10,20,10,40,
2025-08-23,Dara Khosrowshahi,Uber,14,20,6,40,
2025-08-23,Roger Crandall,Mass Mutual,4,6,0,10,
2025-08-23,Marc Casper,Thermo Fisher Scientific,13,24,3,40,
2025-08-23,Gunjan Kedia,US Bancorp,13,25,2,40,
2025-08-23,Michael Kasbar,World Kinect,2,10,0,12,
2025-08-23,Robert Ford,Abbott Laboratories,11,23,6,40,
2025-08-23,Corie Barry,Best Buy,38,1,0,39,
2025-08-23,Tim Gerend,Northwestern Mutual,13,26,1,40,
2025-08-23,Kathy Warden,Northrop Grumman,16,20,4,40,
2025-08-23,Joe Zubretsky,Molina Healthcare,8,7,4,19,
2025-08-23,Todd Vasos,Dollar General,6,22,12,40,
2025-08-23,Robin Vince,Bank of New York,18,19,3,40,
2025-08-23,David Zaslav,Warner Bros Discovery,7,21,12,40,
2025-08-23,Jay Debertin,CHS,3,8,4,15,
2025-08-23,Ted Sarandos,Netflix,10,27,3,40,
2025-08-23,Cristiano Amon,Qualcomm,11,27,1,39,
2025-08-23,Larry Culp,General Electric,11,26,3,40,
2025-08-23,Vimal Kapur,Honeywell,11,29,0,40,
2025-08-23,Marc Benioff,Salesforce,9,23,8,40,
2025-08-23,Jacek Olczak,Philip Morris,14,21,5,40,
2025-08-23,David Flitman,US Foods,1,8,0,9,
2025-08-23,Paul Romanowski,DR Horton,5,15,4,24,
2025-08-23,Bryan DeBoer,Lithia Motors,11,27,1,39,
2025-08-23,Dirk Van de Put,Mondelez,12,24,4,40,
2025-08-23,Brian Niccol,Starbucks,10,29,1,40,
2025-08-23,Ryan McInerney,Visa,16,20,4,40,
2025-08-23,Robert Sulentic,CBRE,1,7,1,9,
2025-08-23,Jonathan Jaffe,Lennar,0,9,1,10,
2025-08-23,Scott Strazik,GE Vernova,15,22,3,40,
2025-08-23,William Demchak,PNC,14,21,5,40,
2025-08-23,Jennifer Rumsey,Cummins,9,27,4,40,
2025-08-23,Preston Feight,Paccar,6,22,1,29,
2025-08-23,Robert Bradway,Amgen,10,27,3,40,
2025-08-23,Matthew Lucey,PBF Energy,6,2,1,9,
2025-08-23,Pat Geraghty,GuideWell Mutual,2,7,0,9,
2025-08-23,Alex Chriss,PayPal,12,26,2,40,
2025-08-23,Sandy Douglas,United Natural Foods,33,6,1,40,
2025-08-23,Michael Creedon,Dollar Tree,3,35,2,40,
2025-08-23,Leon Topalian,Nucor,15,22,3,40,
2025-08-23,Roger Penske,Penske Automotive,17,22,1,40,
2025-08-23,Bom Kim,Coupang,10,29,1,40,
2025-08-23,Antonio Neri,Hewlett Packard,8,24,8,40,
2025-08-23,Harry Sideris,Duke Energy,37,3,0,40,
2025-08-23,Joseph Bae,KKR,19,19,2,40,
2025-08-23,Brian Robbins,Paramount Global,7,30,0,37,
2025-08-23,Michael Dastoor,Jabil,1,6,0,7,
2025-08-23,Daniel O'Day,Gilead Sciences,16,21,3,40,
2025-08-23,Tim Go,HF Sinclair,6,4,0,10,
2025-08-23,William Nash,CarMax,3,4,2,9,
2025-08-23,Michael Miebach,Mastercard,11,25,4,40,
2025-08-23,Lawrence Coben,NRG Energy,7,2,0,9,
2025-08-23,Sean Kerins,Arrow Electronics,3,15,0,18,
2025-08-23,Lorenzo Simonelli,Baker Hughes,15,21,4,40,
2025-08-23,Bob Jordan,Southwest Airlines,11,22,7,40,
2025-08-23,Peter Zaffino,American International,7,21,3,31,
2025-08-23,Gary Dickerson,Applied Materials,8,22,10,40,
2025-08-23,Vicki Hollub,Occidental Petroleum,20,16,3,39,
2025-08-23,Michael Manley,AutoNation,3,6,1,10,
2025-08-23,Christopher Womack,Southern Company,2,8,0,10,
2025-08-23,Christopher Swift,Hartford Insurance,4,5,1,10,
2025-08-23,Marc Rowan,Apollo Global Management,16,20,4,40,
2025-08-23,Rick Wurster,Charles Schwab,14,21,4,39,
2025-08-23,Chris Kempczinski,McDonald's,14,18,8,40,
2025-08-23,Carlos Abrams-Rivera,Kraft Heinz,14,20,6,40,
2025-08-23,Lisa Su,Advanced Micro Devices,19,17,4,40,
2025-08-23,William H Rogers Jr,Truist Financial,2,7,1,10,
2025-08-23,Kathleen Quirk,Freeport-McMoRan,12,18,2,32,
2025-08-23,Sanjay Mehrotra,Micron Technology,16,23,1,40,
2025-08-23,Anthony Capuano,Marriott International,12,25,3,40,
2025-08-23,David Gitlin,Carrier Global,15,24,1,40,
2025-08-23,John Ketchum,NextEra Energy,23,17,0,40,
2025-08-23,William M Brown,3M,2,8,0,10,
2025-08-23,John Doyle,Marsh & McLennan,13,8,0,21,
2025-08-23,Patricia Poppe,PG&E,8,14,2,24,
2025-08-23,Jim Vena,Union Pacific,12,28,0,40,
2025-08-23,Brian Doubles,Synchrony Financial,5,6,2,13,
2025-08-23,Rainer Blair,Danaher,6,15,2,23,
2025-08-23,Philip Gallagher,Avnet,1,4,0,5,
2025-08-23,Glenn Fogel,Booking s,0,3,1,4,
2025-08-23,Ezra Yacob,EOG Resources,23,13,1,37,
2025-08-23,Earl Austin,Quanta Services,3,4,1,8,
2025-08-23,Michael Shepherd,Discover Financial,8,15,2,25,
2025-08-23,Joseph Dominguez,Constellation Energy,15,10,1,26,
2025-08-23,William Stengel II,Genuine Parts,0,4,0,4,
2025-08-23,Christian Ulbrich,Jones Lang LaSalle,10,21,0,31,
2025-08-23,Raymond E Scott,Lear Corporation,5,4,0,9,
2025-08-23,Michael Rapino,Live Nation Entertainment,14,23,3,40,
2025-08-23,Heidi Petz,Sherwin-Williams,8,26,3,37,
2025-08-23,Calvin G Butler Jr,Exelon,6,4,0,10,
2025-08-23,Tony Spring,Macy's,12,26,2,40,
2025-08-23,Jeff Miller,Halliburton,13,21,6,40,
2025-08-23,Kevin Lobo,Stryker,12,25,3,40,
2025-08-23,Tony Cheng,Reinsurance of America,0,0,0,0,
2025-08-23,Ronald P O'Hanley,State Street,5,14,0,19,
2025-08-23,John Engel,WESCO International,5,10,1,16,
2025-08-23,Pierce Norton II,Oneok,6,3,0,9,
2025-08-23,Shantanu Narayen,Adobe,19,20,1,40,
2025-08-23,Bill Westrate,American Family Insurance,12,14,2,28,
2025-08-23,Chris Kubasik,L3Harris Technologies,7,13,1,21,
2025-08-23,James Conroy,Ross Stores,5,11,0,16,
2025-08-23,Christine Leahy,CDW,1,8,2,11,
2025-08-23,Saumya Sutaria,Tenet Healthcare,4,4,1,9,
2025-08-23,Bob Eddy,BJ's Wholesale Club,7,31,2,40,
2025-08-23,Mike Lyons,Fiserv,5,10,0,15,
2025-08-23,William Gifford,Altria,2,6,1,9,
2025-08-23,Larry Fink,BlackRock,8,25,7,40,
2025-08-23,Thomas Polen,Becton Dickinson,7,3,0,10,
2025-08-23,Noel Wallace,Colgate-Palmolive,10,19,2,31,
2025-08-23,Michael Hsu,Kimberly-Clark,6,7,1,14,
2025-08-23,Daryl Kenningham,1 Automotive,10,21,1,32,
2025-08-23,Jennifer Parmentier,Parker-Hannifin,2,12,0,14,
2025-08-23,Jeffrey Harmening,General Mills,6,16,4,26,
2025-08-23,Ravi Kumar S,Cognizant Technology,9,26,4,39,
2025-08-23,William Fehrman,American Electric Power,3,7,0,10,
2025-08-23,Peter Arduini,GE HealthCare Technologies,8,10,0,18,
2025-08-23,Maria Black,Automatic Data Processing,6,4,0,10,
2025-08-23,Lourenco Goncalves,Cleveland-Cliffs,8,21,11,40,
2025-08-23,Dan Amos,Aflac,12,19,9,40,
2025-08-23,Mark Stewart,Goodyear Tire & Rubber,4,34,2,40,
2025-08-23,Kevin Hogan,Corebridge Financial,5,12,0,17,
2025-08-23,Thomas Palmer,Newmont,6,4,0,10,
2025-08-23,Andrew Silvernail,International Paper,6,20,0,26,
2025-08-23,Philip Daniele III,AutoZone,0,2,0,2,
2025-08-23,Ellen Cooper,Lincoln National,3,8,0,11,
2025-08-23,Ryan Marshall,PulteGroup,13,16,11,40,
2025-08-23,James Cracchiolo,Ameriprise Financial,2,24,2,28,
2025-08-23,Andrew Clyde,Murphy USA,13,26,1,40,
2025-08-23,Jonas Prising,Manpower,10,6,1,17,
2025-08-23,David Bozeman,CH Robinson Worldwide,2,7,1,10,
2025-08-23,Timothy Knavish,PPG Industries,1,3,0,4,
2025-08-23,Pedro Pizarro,Edison International,15,8,17,40,
2025-08-23,Mark Millett,Steel Dynamics,16,2,0,18,
2025-08-23,Benjamin Tisch,Loews,2,7,0,9,
2025-08-23,Karsanbhai,Emerson Electric,9,19,2,30,
2025-08-23,John Zillmer,Aramark,8,15,2,25,
2025-08-23,William Hornbuckle,MGM Resorts International,5,25,1,31,
2025-08-23,James Burke,Vistra,7,3,0,10,
2025-08-23,David Hult,Asbury Automotive,9,30,1,40,
2025-08-23,DG Macpherson,WW Grainger,2,7,1,10,
2025-08-23,Eric Slifka,Global Partners,15,21,4,40,
2025-08-23,Bob Pragada,Jacobs Solutions,6,9,0,15,
2025-08-23,Charles Magro,Corteva,3,3,1,7,
2025-08-23,Rick Lanoha,Peter Kiewit Sons',0,2,0,2,
2025-08-23,Michael Mahoney,Boston Scientific,10,28,2,40,
2025-08-23,Brad Beckham,O'Reilly Automotive,4,17,1,22,
2025-08-23,Thomas Bell,Leidos,8,18,2,28,
2025-08-23,Thomas Gayner,Markel Group,1,9,0,10,
2025-08-23,Marc Bitzer,Whirlpool,12,13,15,40,
2025-08-23,Andrew McMahon,Guardian Life,5,14,0,19,
2025-08-23,Peter Jackson,Builders FirstSource,5,11,1,17,
2025-08-23,Michael Rhodes,Ally Financial,11,23,4,38,
2025-08-23,Matthew Meloy,Targa Resources,4,6,0,10,
2025-08-23,James Breuer,Fluor,1,1,1,3,
2025-08-23,Sasan Goodarzi,Intuit,10,26,4,40,
2025-08-23,Troy Rudd,AECOM,8,25,4,37,
2025-08-23,Penny Pennington,Edward Jones,7,28,5,40,
2025-08-23,Michael Bender,Kohl's,1,27,12,40,
2025-08-23,Beth Ford,Land O'Lakes,17,21,2,40,
2025-08-23,Deanna Strable-Soethout,Principal Financial,1,6,0,7,
2025-08-23,Robert Blue,Dominion Energy,26,9,2,37,
2025-08-23,Martin Schroeter,Kyndryl s,0,3,0,3,
2025-08-23,Jon Vander Ark,Republic Services,11,18,11,40,
2025-08-23,Clay Gaspar,Devon Energy,19,3,0,22,
2025-08-23,Christopher O'Herlihy,Illinois Tool Works,4,4,2,10,
2025-08-23,Michael O'Grady,Northern Trust,26,5,1,32,
2025-08-23,Jamie Whisnant,Auto-Owners Insurance,0,2,0,2,
2025-08-23,Marc Miller,Universal Health Services,4,21,3,28,
2025-08-23,Darryl Button,Pacific Life,1,6,0,7,
2025-08-23,Hamid Akhavan,EchoStar,3,25,12,40,
2025-08-23,Christophe Beck,Ecolab,20,20,0,40,
2025-08-23,Jack Fusco,Cheniere Energy,20,17,3,40,
2025-08-23,John Wren,Omnicom,10,19,11,40,
2025-08-23,Haviv Ilan,Texas Instruments,11,26,3,40,
2025-08-23,David Burritt,United States Steel,7,20,13,40,
2025-08-23,St√©phane de La Faverie,Est√©e Lauder,12,24,4,40,
2025-08-23,Raul Nicholas Vargas Ochoa,Farmers Insurance Exchange,0,0,0,0,
2025-08-23,Thibaut Mongon,Kenvue,9,29,2,40,
2025-08-23,Ari Bousbib,IQVIA s,0,0,0,0,
2025-08-23,Donald Allan,Stanley Black & Decker,8,30,2,40,
2025-08-23,Timothy Cofer,Keurig Dr Pepper,2,2,1,5,
2025-08-23,Matthew Flannery,United Rentals,31,3,0,34,
2025-08-23,Timothy Cawley,Consolidated Edison,5,5,0,10,
2025-08-23,Adam Norwitt,Amphenol,4,16,0,20,
2025-08-23,Brent Shafer,Baxter International,1,10,0,11,
2025-08-23,Kimberly Dang,Kinder Morgan,9,1,0,10,
2025-08-23,Erik Nordstrom,Nordstrom,6,28,5,39,
2025-08-23,Frank Holding,First Citizens BancShares,10,13,2,25,
2025-08-23,Paul Shoukry,Raymond James Financial,14,25,1,40,
2025-08-23,Timothy Archer,Lam Research,2,7,1,10,
2025-08-23,Harry Lawton III,Tractor Supply,1,1,0,2,
2025-08-23,Darren Rebelez,Casey's General Stores,15,22,3,40,
2025-08-23,Scott Smith,Viatris,7,5,0,12,
2025-08-23,James Blackledge,Mutual of Omaha Insurance,0,6,0,6,
2025-08-23,Anthony Guzzi,EMCOR,4,4,0,8,
2025-08-23,Joseph Hinrichs,CSX,5,8,1,14,
2025-08-23,Justin Jude,LKQ,4,6,1,11,
2025-08-23,Judith Marks,Otis Worldwide,2,4,0,6,
2025-08-23,David Bruton Smith,Sonic Automotive,3,10,8,21,
2025-08-23,Martina Cheung,S&P Global,11,23,0,34,
2025-08-23,Leonard Schleifer,Regeneron Pharmaceuticals,6,27,7,40,
2025-08-23,Joseph Fadool,BorgWarner,4,9,0,13,
2025-08-23,Lachlan Murdoch,Fox,4,29,7,40,
2025-08-23,Karla Lewis,Reliance,4,5,1,10,
2025-08-23,John Barrett,Western & Southern Financial,8,30,2,40,
2025-08-23,Scott Donnelly,Textron,9,28,3,40,
2025-08-23,Ariane Gorin,Expedia,8,30,1,39,
2025-08-23,Michael Nolan,Fidelity National Financial,4,0,0,4,
2025-08-23,Ernest Garcia III,Carvana,24,12,4,40,
2025-08-23,Raul Fernandez,DXC Technology,4,27,1,32,
2025-08-23,Robert Berkley,WR Berkley,9,27,4,40,
2025-08-23,Ren√© Jones,M&T Bank,12,23,5,40,
2025-08-23,Lauren Hobart,Dick's Sporting Goods,11,25,4,40,
2025-08-23,Robert Frenzel,Xcel Energy,4,2,1,7,
2025-08-23,Timothy Spence,Fifth Third Bancorp,4,6,0,10,
2025-08-23,Stephen Schwarzman,Blackstone,17,19,4,40,
2025-08-23,Walker Martin,Sempra,0,2,0,2,
2025-08-23,Timothy NeCastro,Erie Insurance,3,6,1,10,
2025-08-23,Wendell Weeks,Corning,15,23,2,40,
2025-08-23,Kathleen Johnson,Lumen Technologies,3,4,1,8,
2025-08-23,Brian Tierney,FirstEnergy,4,26,2,32,
2025-08-23,Adam Schechter,Labcorp,7,19,1,27,
2025-08-23,Tiang Yew Tan,Western Digital,2,1,0,3,
2025-08-23,Richard McKenney,Unum,4,5,0,9,
2025-08-23,Javier Rodriguez,DaVita,14,15,1,30,
2025-08-23,Steven Cahillane,Kellanova,2,7,0,9,
2025-08-23,Stanley Bergman,Henry Schein,11,28,1,40,
2025-08-23,Robert Sanchez,Ryder System,9,8,1,18,
2025-08-23,Tim Hingtgen,Community Health Systems,11,27,2,40,
2025-08-23,Avigal Soreq,Delek US,3,9,4,16,
2025-08-23,Gerardo Norcia,DTE Energy,7,3,0,10,
2025-08-23,Mark Pearson,Equitable,7,9,0,16,
2025-08-23,Lori Koch,DuPont,7,19,0,26,
2025-08-23,Rich Steinmeier,LPL Financial,24,14,2,40,
2025-08-23,Bruce Van Saun,Citizens Financial,11,27,2,40,
2025-08-23,Jos√© Mas,MasTec,7,13,3,23,
2025-08-23,Andr√©s Gluski,AES,19,20,0,39,
2025-08-23,Kevin Kwilinski,Berry Global,8,18,0,26,
2025-08-23,Mark George,Norfolk Southern,19,20,1,40,
2025-08-23,Eduardo Menezes,Air Products & Chemicals,5,4,1,10,
2025-08-23,Shelley Simpson,JB Hunt Transport Services,6,31,3,40,
2025-08-23,Daniel Fisher,Ball,3,20,6,29,
2025-08-23,Sean Connolly,Conagra Brands,5,33,2,40,
2025-08-23,Stephen Steinour,Huntington Bancshares,4,7,0,11,
2025-08-23,James Snee,Hormel Foods,2,28,1,31,
2025-08-23,Joseph Nolan,Eversource Energy,4,4,1,9,
2025-08-23,William Oplinger,Alcoa,9,18,4,31,
2025-08-23,Andrew Marsh,Entergy,2,5,0,7,
2025-08-23,Keith Demmings,Assurant,4,7,0,11,
2025-08-23,Sumit Singh,Chewy,14,22,4,40,
2025-08-23,Niraj Shah,Wayfair,8,23,9,40,
2025-08-23,Joseph Ferraro,Avis Budget,3,6,1,10,
2025-08-23,Jeffrey Sprecher,Intercontinental Exchange,15,23,2,40,
2025-08-23,Benito Minicucci,Alaska Air,4,5,1,10,
2025-08-23,Malcolm Wilson,GXO Logistics,7,23,0,30,
2025-08-23,Eric Hansotia,AGCO,14,14,1,29,
2025-08-23,Kathleen Mazzarella,Graybar Electric,1,7,1,9,
2025-08-23,Gavin Hattersley,Molson Coors Beverage,5,31,4,40,
2025-08-23,Patrick Gallagher,Arthur J Gallagher,10,28,2,40,
2025-08-23,Christopher Kastner,Huntington Ingalls Industries,3,4,1,8,
2025-08-23,Erik Fyrwald,International Flavors & Fragrances,7,7,2,16,
2025-08-23,Ricardo Cardenas,Darden Restaurants,4,3,1,8,
2025-08-23,Stephen Spray,Cincinnati Financial,1,6,3,10,
2025-08-23,Scott Boatwright,Chipotle Mexican Grill,8,28,4,40,
2025-08-23,Joey Wat,Yum China,13,25,2,40,
2025-08-23,Robert Goldstein,Las Vegas Sands,3,32,5,40,
2025-08-23,Kecia Steelman,Ulta Beauty,33,6,1,40,
2025-08-23,Thomas Reeg,Caesars Entertainment,5,6,0,11,
2025-08-23,Jon Rousseau,BrightSpring Health Services,20,18,1,39,
2025-08-23,William Krueger,Andersons,0,4,0,4,
2025-08-23,Michele Buck,Hershey,8,30,2,40,
2025-08-23,Christopher Nassetta,Hilton,13,23,4,40,
2025-08-23,Bruce Bodine,Mosaic,2,7,0,9,
2025-08-23,Brian Chesky,Airbnb,2,30,8,40,
2025-08-23,Kaes Van‚Äôt Hof,Diamondback Energy,23,14,2,39,
2025-08-23,Steven Vondran,American Tower,4,7,0,11,
2025-08-23,Reshma Kewalramani,Vertex Pharmaceuticals,21,16,3,40,
2025-08-23,William McDermott,ServiceNow,4,5,0,9,
2025-08-23,Brian Chambers,Owens Corning,3,11,1,15,
2025-08-23,Teresa Rasmussen,Thrivent Financial for Lutherans,4,1,0,5,
2025-08-23,Shane O'Kelly,Advance Auto Parts,14,22,4,40,
2025-08-23,Douglas Yearley,Toll Brothers,10,25,5,40,
2025-08-23,Jeffrey Lorberbaum,Mohawk Industries,11,5,1,17,
2025-08-23,Gregory Brown,Motorola Solutions,2,7,0,9,
2025-08-23,John Pfeifer,Oshkosh,5,25,5,35,
2025-08-23,Tony Xu,DoorDash,14,20,6,40,
2025-08-23,Edward Pesicka,Owens & Minor,4,34,2,40,
2025-08-23,Eugene Bredow,NVR,0,5,0,5,
2025-08-23,Philippe Krakowsky,Interpublic,15,21,4,40,
2025-08-23,Horacio Rozanski,Booz Allen Hamilton,17,18,5,40,
2025-08-23,Michael O‚ÄôSullivan,Burlington Stores,7,30,3,40,
2025-08-23,Daniel Wall,Expeditors International of Washington,3,4,0,7,
2025-08-23,Calvin McDonald,Lululemon athletica,8,30,2,40,
2025-08-23,Stephanie Ferris,Fidelity National Information,14,22,3,39,
2025-08-23,Rich Handler,Jefferies Financial,13,11,2,26,
2025-08-23,Alan Armstrong,Williams,24,12,4,40,
2025-08-23,Bracken Darrell,VF Corporation,9,26,5,40,
2025-08-23,Mikael Bratt,Autoliv,6,9,2,17,
2025-08-23,Rafael Santana,Westinghouse Air Brake Technologies,4,6,1,11,
2025-08-23,Ralph LaRossa,Public Service Enterprise,7,17,0,24,
2025-08-23,Jamie Iannone,Ebay,21,14,5,40,
2025-08-23,Scott Richardson,Celanese,7,29,4,40,
2025-08-23,Cameron Bready,Global Payments,8,29,3,40,
2025-08-23,Robert Thomson,News Corp,8,28,4,40,
2025-08-23,Robert Martin,THOR Industries,4,5,1,10,
2025-08-23,David Rawlinson II,QVC,6,11,2,19,
2025-08-23,Andrew Teno,Icahn Enterprises,5,6,0,11,
2025-08-23,William Newlands,Constellation Brands,0,2,2,4,
2025-08-23,James Davis,Quest Diagnostics,4,5,1,10,
2025-08-23,Richard Wallace,KLA,3,3,0,6,
2025-08-23,Julian Francis,QXO Building Products,0,0,0,0,
2025-08-23,John Christmann IV,APA,6,4,0,10,
2025-08-23,Gregory Roberts,A-Mark Precious Metals,2,2,1,5,
2025-08-23,Christopher Viehbacher,Biogen,0,28,2,30,
2025-08-23,Mick Beekhuizen,Campbell's,6,23,4,33,
2025-08-23,Christopher Caldwell,Concentrix,2,5,0,7,
2025-08-23,Todd Schneider,Cintas,11,18,1,30,
2025-08-23,Tony Sarsam,SpartanNash,16,22,2,40,
2025-08-23,John Venhuizen,Ace Hardware,15,24,1,40,
2025-08-23,Vincent Roche,Analog Devices,13,25,2,40,
2025-08-23,Mark Costa,Eastman Chemical,6,20,2,28,
2025-08-23,Milan Galik,Interactive Brokers,6,16,1,23,
2025-08-23,John Turner,Regions Financial,20,18,2,40,
2025-08-23,Joanna Geraghty,JetBlue Airways,16,17,7,40,
2025-08-23,Kristin Peck,Zoetis,11,19,1,31,
2025-08-23,Christopher Gorman,KeyCorp,4,6,0,10,
2025-08-23,Mark Bertolini,Oscar Health,12,20,8,40,
2025-08-23,Brendan McCracken,Ovintiv,6,5,1,12,
2025-08-23,Robert Steer,Seaboard,1,4,0,5,
2025-08-23,Gil West,Hertz,7,27,6,40,
2025-08-23,Robert Greenberg,Skechers,5,33,2,40,
2025-08-23,Dennis Mathew,Altice,5,26,7,38,
2025-08-23,Clay Williams,NOV,11,22,5,38,
2025-08-23,Michael Doss,Graphic Packaging,5,8,2,15,
2025-08-23,Deon Stander,Avery Dennison,0,12,0,12,
2025-08-23,Adaire Fox-Martin,Equinix,16,20,4,40,
2025-08-23,Joyce Mullen,Insight Enterprises,6,11,1,18,
2025-08-23,Jennifer Witz,Sirius XM,9,11,7,27,
2025-08-23,Stefan Larsson,PVH,10,24,6,40,
2025-08-23,Jason P Wells,CenterPoint Energy,6,4,0,10,
2025-08-23,Scott Lauber,WEC Energy,13,5,0,18,
2025-08-23,Matthew Pine,Xylem,2,9,1,12,
2025-08-23,Jennifer Johnson,Franklin Resources,2,6,2,10,
2025-08-23,Vincent Sorgi,PPL,8,10,1,19,
2025-08-23,Carl Eschenbach,Workday,10,21,9,40,
2025-08-23,Richard Tobin,Dover,3,6,1,10,
2025-08-23,Mark Kowlzan,Packaging Corp of America,1,10,1,12,
2025-08-23,Scott Salmirs,ABM Industries,5,7,1,13,
2025-08-23,Gary Guthart,Intuitive Surgical,13,23,4,40,
2025-08-23,Carl Lindner lll,American Financial,0,0,0,0,
2025-08-23,Blake Moret,Rockwell Automation,12,27,1,40,
2025-08-23,Bryan Hanson,Solventum,5,13,2,20,
2025-08-23,Craig Smiddy,Old Republic International,3,5,1,9,
2025-08-23,Christopher Hilger,Securian Financial,0,6,1,7,
2025-08-23,Hamid Moghadam,Prologis,7,28,5,40,
2025-08-23,Mark Smucker,JM Smucker,10,22,8,40,
2025-08-23,Sheryl Palmer,Taylor Morrison Home,5,13,1,19,
2025-08-23,Mario Harik,XPO,7,32,1,40,
2025-08-23,Heather Lavallee,Voya Financial,7,10,1,18,
2025-08-23,Nikesh Arora,Palo Alto Networks,6,27,7,40,
2025-08-23,Giordano Albertazzi,Vertiv s,0,1,0,1,
2025-08-23,Shankh Mitra,Welltower,16,22,2,40,
2025-08-23,Mary Dillon,Foot Locker,10,25,5,40,
2025-08-23,William Monteleone,Par Pacific,1,6,2,9,
2025-08-23,Kevin Stein,TransDigm,10,11,2,23,
2025-08-23,Peter Matt,Commercial Metals,6,4,0,10,
2025-08-23,Robert Vitale,Post s,0,0,0,0,
2025-08-23,Keith Allman,Masco,6,9,1,16,
2025-08-23,Rusty Rush,Rush Enterprises,17,20,3,40,
2025-08-23,Stuart Bradie,KBR,14,14,4,32,
2025-08-23,Jack Sinclair,Sprouts Farmers Market,16,23,1,40,
2025-08-23,Laura Alber,Williams-Sonoma,11,24,5,40,
2025-08-23,Ivan Tornos,Zimmer Biomet s,1,2,0,3,
2025-08-23,John Mengucci,CACI International,21,17,2,40,
2025-08-23,Steve Sanghi,Microchip Technology,10,27,3,40,
2025-08-23,Albert Nahmad,Watsco,2,7,0,9,
2025-08-23,Christopher Peterson,Newell Brands,2,7,1,10,
2025-08-23,Arie Kotler,ARKO,6,25,0,31,
2025-08-23,Jure Sola,Sanmina,3,15,1,19,
2025-08-23,Andrew Wilson,Electronic Arts,14,18,8,40,
2025-08-23,David Gibbs,Yum Brands,2,36,2,40,
2025-08-23,Daniel Florness,Fastenal,2,6,1,9,
2025-08-23,Garrick Rochow,CMS Energy,10,3,0,13,
2025-08-23,Rodney Sacks,Monster Beverage,14,23,2,39,
2025-08-23,Mark Shapiro,Endeavor,4,34,2,40,
2025-08-23,Toni Townes-Whitley,Science Applications International,13,21,1,35,
2025-08-23,Mark Witkowski,Core & Main,0,8,0,8,
2025-08-23,John Plant,Howmet Aerospace,4,16,2,22,
2025-08-23,James Zallie,Ingredion,4,5,1,10,
2025-08-23,Thomas Hill,Vulcan Materials,4,8,2,14,
2025-08-24,Doug McMillon,Walmart,17,17,6,40,
2025-08-24,Andrew Jassy,Amazon,5,29,6,40,
2025-08-24,Stephen Hemsley,UnitedHealth,7,27,5,39,
2025-08-24,Tim Cook,Apple,16,22,2,40,
2025-08-24,David Joyner,CVS Health,7,29,4,40,
2025-08-24,Warren Buffett,Berkshire Hathaway,12,18,10,40,
2025-08-24,Sundar Pichai,Alphabet,17,17,6,40,
2025-08-24,Darren Woods,Exxon Mobil,11,23,6,40,
2025-08-24,Brian Tyler,McKesson,4,17,5,26,
2025-08-24,Robert Mauch,Cencora,4,6,0,10,
2025-08-24,Jamie Dimon,JPMorgan Chase,8,20,12,40,
2025-08-24,Ron Vachris,Costco,6,32,2,40,
2025-08-24,David Cordani,Cigna,22,14,4,40,
2025-08-24,Satya Nadella,Microsoft,18,16,6,40,
2025-08-24,Jason Hollar,Cardinal Health,11,22,6,39,
2025-08-24,Mike Wirth,Chevron,20,16,4,40,
2025-08-24,Brian Moynihan,Bank of America,9,27,4,40,
2025-08-24,Mary Barra,General Motors,12,25,3,40,
2025-08-24,Jim Farley,Ford Motor,13,19,8,40,
2025-08-24,Gail Boudreaux,Elevance Health,16,18,6,40,
2025-08-24,Jane Fraser,Citigroup,13,21,6,40,
2025-08-24,Mark Zuckerberg,Meta,12,21,7,40,
2025-08-24,Sarah London,Centene,12,19,9,40,
2025-08-24,Ted Decker,Home Depot,10,22,8,40,
2025-08-24,Priscilla Almodovar,Fannie Mae,10,17,12,39,
2025-08-24,Tim Wentworth,Walgreens,8,22,9,39,
2025-08-24,Ron Sargent,Kroger,5,22,13,40,
2025-08-24,Mark Lashier,Phillips 66,9,21,8,38,
2025-08-24,Maryann Mannen,Marathon Petroleum,6,13,1,20,
2025-08-24,Hans Vestberg,Verizon,16,20,4,40,
2025-08-24,Jensen Huang,Nvidia,16,21,3,40,
2025-08-24,David Solomon,Goldman Sachs,7,22,11,40,
2025-08-24,Charles Scharf,Wells Fargo,29,6,5,40,
2025-08-24,Lane Riggs,Valero Energy,15,8,0,23,
2025-08-24,Brian Roberts,Comcast,10,27,3,40,
2025-08-24,Jon Farney,State Farm,10,26,4,40,
2025-08-24,John Stankey,AT&T,11,26,3,40,
2025-08-24,Michael Hutchins,Freddie Mac,3,12,4,19,
2025-08-24,Jim Rechtin,Humana,20,17,3,40,
2025-08-24,Ted Pick,Morgan Stanley,16,21,3,40,
2025-08-24,Michael Fiddelke,Target,11,21,8,40,
2025-08-24,Philip Smith,StoneX,0,9,1,10,
2025-08-24,Elon Musk,Tesla,12,15,13,40,
2025-08-24,Michael Dell,Dell Technologies,10,26,4,40,
2025-08-24,Ramon Laguarta,PepsiCo,6,29,5,40,
2025-08-24,Bob Iger,Walt Disney,10,27,3,40,
2025-08-24,Carol Tom√©,UPS,8,21,11,40,
2025-08-24,Joaquin Duato,Johnson & Johnson,11,24,5,40,
2025-08-24,Rajesh Subramaniam,FedEx,10,27,0,37,
2025-08-24,Juan Luciano,Archer Daniels Midland,4,20,15,39,
2025-08-24,Jon Moeller,Procter & Gamble,7,29,4,40,
2025-08-24,Marvin Ellison,Lowe's,16,19,5,40,
2025-08-24,Thomas Long,Energy Transfer,8,0,1,9,
2025-08-24,Christopher Calio,RTX,6,11,0,17,
2025-08-24,Susan Morris,Albertsons,11,26,3,40,
2025-08-24,Kevin Hourican,Sysco,10,27,3,40,
2025-08-24,Tricia Griffith,Progressive,12,23,4,39,
2025-08-24,Stephen Squeri,American Express,15,24,1,40,
2025-08-24,James Taiclet,Lockheed Martin,11,20,9,40,
2025-08-24,Michel Khalaf,MetLife,13,16,0,29,
2025-08-24,Samuel Hazen,HCA Healthcare,9,5,0,14,
2025-08-24,Andrew Sullivan,Prudential Financial,12,23,0,35,
2025-08-24,Kelly Ortberg,Boeing,12,23,5,40,
2025-08-24,Joe Creed,Caterpillar,11,27,2,40,
2025-08-24,Robert M Davis,Merck,4,21,0,25,
2025-08-24,Thomas J Wilson,Allstate,1,8,1,10,
2025-08-24,Albert Bourla,Pfizer,19,11,10,40,
2025-08-24,Arvind Krishna,IBM,14,21,5,40,
2025-08-24,Craig DeSanto,New York Life Insurance,3,18,0,21,
2025-08-24,Ed Bastian,Delta Airlines,17,12,10,39,
2025-08-24,Kevin Murphy,Ferguson Enterprises,3,15,2,20,
2025-08-24,Kirt Walker,Nationwide,14,17,2,33,
2025-08-24,Patrick Zammit,TD Synnex,10,16,0,26,
2025-08-24,Scott Kirby,United Airlines,35,3,2,40,
2025-08-24,Ryan Lance,ConocoPhillips,18,19,3,40,
2025-08-24,Ernie Herrman,TJX,15,23,2,40,
2025-08-24,Bob Michael,AbbVie,0,0,0,0,
2025-08-24,AJ Jim Teague,Enterprise Products Partners,5,7,0,12,
2025-08-24,Christopher Winfrey,Charter Communications,5,15,5,25,
2025-08-24,George Holm,Performance Food,10,23,2,35,
2025-08-24,Robert Isom,American Airlines,6,27,7,40,
2025-08-24,Richard Fairbank,Capital One,16,22,2,40,
2025-08-24,Chuck Robbins,Cisco Systems,15,22,3,40,
2025-08-24,Enrique Lores,HP,12,23,5,40,
2025-08-24,Donnie King,Tyson Foods,11,25,4,40,
2025-08-24,Lip-Bu Tan,Intel,7,23,10,40,
2025-08-24,Safra Catz,Oracle,11,22,7,40,
2025-08-24,Hock Tan,Broadcom,12,22,6,40,
2025-08-24,John May,Deere,9,27,4,40,
2025-08-24,Elliott Hill,Nike,13,23,4,40,
2025-08-24,Timothy M Sweeney,Liberty Mutual Insurance,14,0,0,14,
2025-08-24,Wilfred Chiang,Plains GP,2,1,0,3,
2025-08-24,Juan Andrade,USAA,5,16,0,21,
2025-08-24,Chris Boerner,Bristol-Myers Squibb,10,23,7,40,
2025-08-24,Paul Bay,Ingram Micro,13,23,4,40,
2025-08-24,Phebe Novakovic,General Dynamics,28,9,3,40,
2025-08-24,James Quincey,Coca-Cola,10,28,2,40,
2025-08-24,Thasunda Brown Duckett,TIAA,17,23,0,40,
2025-08-24,Alan Schnitzer,Travelers,16,17,7,40,
2025-08-24,David Ricks,Eli Lilly,10,20,10,40,
2025-08-24,Dara Khosrowshahi,Uber,12,22,6,40,
2025-08-24,Roger Crandall,Mass Mutual,3,7,0,10,
2025-08-24,Marc Casper,Thermo Fisher Scientific,13,24,3,40,
2025-08-24,Gunjan Kedia,US Bancorp,13,25,2,40,
2025-08-24,Michael Kasbar,World Kinect,2,10,0,12,
2025-08-24,Robert Ford,Abbott Laboratories,12,23,5,40,
2025-08-24,Corie Barry,Best Buy,38,1,0,39,
2025-08-24,Tim Gerend,Northwestern Mutual,14,25,1,40,
2025-08-24,Kathy Warden,Northrop Grumman,16,20,4,40,
2025-08-24,Joe Zubretsky,Molina Healthcare,8,7,4,19,
2025-08-24,Todd Vasos,Dollar General,8,25,7,40,
2025-08-24,Robin Vince,Bank of New York,19,19,2,40,
2025-08-24,David Zaslav,Warner Bros Discovery,6,21,13,40,
2025-08-24,Jay Debertin,CHS,3,8,4,15,
2025-08-24,Ted Sarandos,Netflix,11,26,3,40,
2025-08-24,Cristiano Amon,Qualcomm,10,27,2,39,
2025-08-24,Larry Culp,General Electric,11,26,3,40,
2025-08-24,Vimal Kapur,Honeywell,12,28,0,40,
2025-08-24,Marc Benioff,Salesforce,10,23,7,40,
2025-08-24,Jacek Olczak,Philip Morris,14,21,5,40,
2025-08-24,David Flitman,US Foods,1,8,0,9,
2025-08-24,Paul Romanowski,DR Horton,5,14,4,23,
2025-08-24,Bryan DeBoer,Lithia Motors,12,26,1,39,
2025-08-24,Dirk Van de Put,Mondelez,11,25,4,40,
2025-08-24,Brian Niccol,Starbucks,11,28,1,40,
2025-08-24,Ryan McInerney,Visa,15,21,4,40,
2025-08-24,Robert Sulentic,CBRE,1,7,1,9,
2025-08-24,Jonathan Jaffe,Lennar,0,9,1,10,
2025-08-24,Scott Strazik,GE Vernova,14,23,3,40,
2025-08-24,William Demchak,PNC,13,22,5,40,
2025-08-24,Jennifer Rumsey,Cummins,9,27,4,40,
2025-08-24,Preston Feight,Paccar,8,27,2,37,
2025-08-24,Robert Bradway,Amgen,10,27,3,40,
2025-08-24,Matthew Lucey,PBF Energy,6,2,1,9,
2025-08-24,Pat Geraghty,GuideWell Mutual,2,6,0,8,
2025-08-24,Alex Chriss,PayPal,12,25,3,40,
2025-08-24,Sandy Douglas,United Natural Foods,33,6,1,40,
2025-08-24,Michael Creedon,Dollar Tree,3,34,3,40,
2025-08-24,Leon Topalian,Nucor,14,23,3,40,
2025-08-24,Roger Penske,Penske Automotive,18,21,1,40,
2025-08-24,Bom Kim,Coupang,11,28,1,40,
2025-08-24,Antonio Neri,Hewlett Packard,8,24,8,40,
2025-08-24,Harry Sideris,Duke Energy,36,4,0,40,
2025-08-24,Joseph Bae,KKR,19,19,2,40,
2025-08-24,Brian Robbins,Paramount Global,8,30,0,38,
2025-08-24,Michael Dastoor,Jabil,1,7,0,8,
2025-08-24,Daniel O'Day,Gilead Sciences,21,17,2,40,
2025-08-24,Tim Go,HF Sinclair,6,4,0,10,
2025-08-24,William Nash,CarMax,3,4,2,9,
2025-08-24,Michael Miebach,Mastercard,11,25,4,40,
2025-08-24,Lawrence Coben,NRG Energy,6,2,0,8,
2025-08-24,Sean Kerins,Arrow Electronics,3,15,0,18,
2025-08-24,Lorenzo Simonelli,Baker Hughes,16,20,4,40,
2025-08-24,Bob Jordan,Southwest Airlines,11,23,6,40,
2025-08-24,Peter Zaffino,American International,8,29,3,40,
2025-08-24,Gary Dickerson,Applied Materials,8,22,10,40,
2025-08-24,Vicki Hollub,Occidental Petroleum,19,16,4,39,
2025-08-24,Michael Manley,AutoNation,3,6,1,10,
2025-08-24,Christopher Womack,Southern Company,2,7,0,9,
2025-08-24,Christopher Swift,Hartford Insurance,4,5,1,10,
2025-08-24,Marc Rowan,Apollo Global Management,16,20,4,40,
2025-08-24,Rick Wurster,Charles Schwab,13,22,4,39,
2025-08-24,Chris Kempczinski,McDonald's,14,18,8,40,
2025-08-24,Carlos Abrams-Rivera,Kraft Heinz,14,20,6,40,
2025-08-24,Lisa Su,Advanced Micro Devices,18,18,4,40,
2025-08-24,William H Rogers Jr,Truist Financial,2,6,1,9,
2025-08-24,Kathleen Quirk,Freeport-McMoRan,11,18,2,31,
2025-08-24,Sanjay Mehrotra,Micron Technology,16,23,1,40,
2025-08-24,Anthony Capuano,Marriott International,12,25,3,40,
2025-08-24,David Gitlin,Carrier Global,15,24,1,40,
2025-08-24,John Ketchum,NextEra Energy,23,17,0,40,
2025-08-24,William M Brown,3M,2,8,0,10,
2025-08-24,John Doyle,Marsh & McLennan,11,7,0,18,
2025-08-24,Patricia Poppe,PG&E,8,16,2,26,
2025-08-24,Jim Vena,Union Pacific,19,21,0,40,
2025-08-24,Brian Doubles,Synchrony Financial,5,6,2,13,
2025-08-24,Rainer Blair,Danaher,6,15,2,23,
2025-08-24,Philip Gallagher,Avnet,1,4,0,5,
2025-08-24,Glenn Fogel,Booking s,0,3,1,4,
2025-08-24,Ezra Yacob,EOG Resources,23,13,1,37,
2025-08-24,Earl Austin,Quanta Services,3,4,1,8,
2025-08-24,Michael Shepherd,Discover Financial,7,16,2,25,
2025-08-24,Joseph Dominguez,Constellation Energy,14,11,1,26,
2025-08-24,William Stengel II,Genuine Parts,0,4,0,4,
2025-08-24,Christian Ulbrich,Jones Lang LaSalle,9,23,0,32,
2025-08-24,Raymond E Scott,Lear Corporation,5,4,0,9,
2025-08-24,Michael Rapino,Live Nation Entertainment,13,24,3,40,
2025-08-24,Heidi Petz,Sherwin-Williams,7,27,3,37,
2025-08-24,Calvin G Butler Jr,Exelon,6,4,0,10,
2025-08-24,Tony Spring,Macy's,12,26,2,40,
2025-08-24,Jeff Miller,Halliburton,11,23,6,40,
2025-08-24,Kevin Lobo,Stryker,13,24,3,40,
2025-08-24,Tony Cheng,Reinsurance of America,0,0,0,0,
2025-08-24,Ronald P O'Hanley,State Street,5,14,0,19,
2025-08-24,John Engel,WESCO International,5,10,1,16,
2025-08-24,Pierce Norton II,Oneok,6,3,0,9,
2025-08-24,Shantanu Narayen,Adobe,19,20,1,40,
2025-08-24,Bill Westrate,American Family Insurance,11,13,2,26,
2025-08-24,Chris Kubasik,L3Harris Technologies,7,12,1,20,
2025-08-24,James Conroy,Ross Stores,5,11,0,16,
2025-08-24,Christine Leahy,CDW,1,8,2,11,
2025-08-24,Saumya Sutaria,Tenet Healthcare,4,4,1,9,
2025-08-24,Bob Eddy,BJ's Wholesale Club,7,31,2,40,
2025-08-24,Mike Lyons,Fiserv,4,11,0,15,
2025-08-24,William Gifford,Altria,2,6,1,9,
2025-08-24,Larry Fink,BlackRock,7,25,8,40,
2025-08-24,Thomas Polen,Becton Dickinson,7,3,0,10,
2025-08-24,Noel Wallace,Colgate-Palmolive,11,20,2,33,
2025-08-24,Michael Hsu,Kimberly-Clark,6,8,0,14,
2025-08-24,Daryl Kenningham,1 Automotive,11,22,1,34,
2025-08-24,Jennifer Parmentier,Parker-Hannifin,2,12,0,14,
2025-08-24,Jeffrey Harmening,General Mills,5,17,4,26,
2025-08-24,Ravi Kumar S,Cognizant Technology,8,25,4,37,
2025-08-24,William Fehrman,American Electric Power,4,6,0,10,
2025-08-24,Peter Arduini,GE HealthCare Technologies,8,10,0,18,
2025-08-24,Maria Black,Automatic Data Processing,6,4,0,10,
2025-08-24,Lourenco Goncalves,Cleveland-Cliffs,8,21,11,40,
2025-08-24,Dan Amos,Aflac,12,19,9,40,
2025-08-24,Mark Stewart,Goodyear Tire & Rubber,5,32,3,40,
2025-08-24,Kevin Hogan,Corebridge Financial,5,12,0,17,
2025-08-24,Thomas Palmer,Newmont,6,4,0,10,
2025-08-24,Andrew Silvernail,International Paper,6,21,0,27,
2025-08-24,Philip Daniele III,AutoZone,0,2,0,2,
2025-08-24,Ellen Cooper,Lincoln National,2,8,0,10,
2025-08-24,Ryan Marshall,PulteGroup,8,14,10,32,
2025-08-24,James Cracchiolo,Ameriprise Financial,2,23,2,27,
2025-08-24,Andrew Clyde,Murphy USA,12,27,1,40,
2025-08-24,Jonas Prising,Manpower,9,6,1,16,
2025-08-24,David Bozeman,CH Robinson Worldwide,2,7,0,9,
2025-08-24,Timothy Knavish,PPG Industries,1,2,0,3,
2025-08-24,Pedro Pizarro,Edison International,14,9,17,40,
2025-08-24,Mark Millett,Steel Dynamics,17,2,0,19,
2025-08-24,Benjamin Tisch,Loews,2,6,0,8,
2025-08-24,Karsanbhai,Emerson Electric,9,19,2,30,
2025-08-24,John Zillmer,Aramark,8,15,2,25,
2025-08-24,William Hornbuckle,MGM Resorts International,5,25,1,31,
2025-08-24,James Burke,Vistra,7,3,0,10,
2025-08-24,David Hult,Asbury Automotive,9,30,1,40,
2025-08-24,DG Macpherson,WW Grainger,2,7,1,10,
2025-08-24,Eric Slifka,Global Partners,14,21,5,40,
2025-08-24,Bob Pragada,Jacobs Solutions,5,8,0,13,
2025-08-24,Charles Magro,Corteva,3,3,1,7,
2025-08-24,Rick Lanoha,Peter Kiewit Sons',0,2,0,2,
2025-08-24,Michael Mahoney,Boston Scientific,11,28,1,40,
2025-08-24,Brad Beckham,O'Reilly Automotive,4,17,2,23,
2025-08-24,Thomas Bell,Leidos,8,18,2,28,
2025-08-24,Thomas Gayner,Markel Group,1,9,0,10,
2025-08-24,Marc Bitzer,Whirlpool,13,12,15,40,
2025-08-24,Andrew McMahon,Guardian Life,5,15,0,20,
2025-08-24,Peter Jackson,Builders FirstSource,5,11,1,17,
2025-08-24,Michael Rhodes,Ally Financial,11,24,4,39,
2025-08-24,Matthew Meloy,Targa Resources,4,6,0,10,
2025-08-24,James Breuer,Fluor,1,1,1,3,
2025-08-24,Sasan Goodarzi,Intuit,9,27,4,40,
2025-08-24,Troy Rudd,AECOM,8,24,5,37,
2025-08-24,Penny Pennington,Edward Jones,7,28,5,40,
2025-08-24,Michael Bender,Kohl's,1,27,12,40,
2025-08-24,Beth Ford,Land O'Lakes,15,24,1,40,
2025-08-24,Deanna Strable-Soethout,Principal Financial,1,6,0,7,
2025-08-24,Robert Blue,Dominion Energy,25,10,2,37,
2025-08-24,Martin Schroeter,Kyndryl s,0,4,0,4,
2025-08-24,Jon Vander Ark,Republic Services,11,19,10,40,
2025-08-24,Clay Gaspar,Devon Energy,19,2,0,21,
2025-08-24,Christopher O'Herlihy,Illinois Tool Works,3,5,2,10,
2025-08-24,Michael O'Grady,Northern Trust,25,4,1,30,
2025-08-24,Jamie Whisnant,Auto-Owners Insurance,0,2,0,2,
2025-08-24,Marc Miller,Universal Health Services,4,21,2,27,
2025-08-24,Darryl Button,Pacific Life,1,6,0,7,
2025-08-24,Hamid Akhavan,EchoStar,4,25,11,40,
2025-08-24,Christophe Beck,Ecolab,18,22,0,40,
2025-08-24,Jack Fusco,Cheniere Energy,19,18,3,40,
2025-08-24,John Wren,Omnicom,10,20,10,40,
2025-08-24,Haviv Ilan,Texas Instruments,11,26,3,40,
2025-08-24,David Burritt,United States Steel,7,19,14,40,
2025-08-24,St√©phane de La Faverie,Est√©e Lauder,11,25,4,40,
2025-08-24,Raul Nicholas Vargas Ochoa,Farmers Insurance Exchange,0,0,0,0,
2025-08-24,Thibaut Mongon,Kenvue,9,29,2,40,
2025-08-24,Ari Bousbib,IQVIA s,0,0,0,0,
2025-08-24,Donald Allan,Stanley Black & Decker,8,30,2,40,
2025-08-24,Timothy Cofer,Keurig Dr Pepper,2,2,1,5,
2025-08-24,Matthew Flannery,United Rentals,30,3,0,33,
2025-08-24,Timothy Cawley,Consolidated Edison,5,5,0,10,
2025-08-24,Adam Norwitt,Amphenol,4,16,0,20,
2025-08-24,Brent Shafer,Baxter International,1,10,0,11,
2025-08-24,Kimberly Dang,Kinder Morgan,9,1,0,10,
2025-08-24,Erik Nordstrom,Nordstrom,7,27,5,39,
2025-08-24,Frank Holding,First Citizens BancShares,10,14,2,26,
2025-08-24,Paul Shoukry,Raymond James Financial,14,25,1,40,
2025-08-24,Timothy Archer,Lam Research,2,7,1,10,
2025-08-24,Harry Lawton III,Tractor Supply,1,1,0,2,
2025-08-24,Darren Rebelez,Casey's General Stores,15,22,3,40,
2025-08-24,Scott Smith,Viatris,7,5,0,12,
2025-08-24,James Blackledge,Mutual of Omaha Insurance,0,6,0,6,
2025-08-24,Anthony Guzzi,EMCOR,4,4,0,8,
2025-08-24,Joseph Hinrichs,CSX,5,8,1,14,
2025-08-24,Justin Jude,LKQ,4,6,1,11,
2025-08-24,Judith Marks,Otis Worldwide,3,4,0,7,
2025-08-24,David Bruton Smith,Sonic Automotive,3,10,9,22,
2025-08-24,Martina Cheung,S&P Global,11,23,0,34,
2025-08-24,Leonard Schleifer,Regeneron Pharmaceuticals,6,27,7,40,
2025-08-24,Joseph Fadool,BorgWarner,4,9,0,13,
2025-08-24,Lachlan Murdoch,Fox,6,27,7,40,
2025-08-24,Karla Lewis,Reliance,4,6,0,10,
2025-08-24,John Barrett,Western & Southern Financial,8,30,2,40,
2025-08-24,Scott Donnelly,Textron,9,28,3,40,
2025-08-24,Ariane Gorin,Expedia,8,30,1,39,
2025-08-24,Michael Nolan,Fidelity National Financial,4,0,0,4,
2025-08-24,Ernest Garcia III,Carvana,24,12,4,40,
2025-08-24,Raul Fernandez,DXC Technology,4,32,2,38,
2025-08-24,Robert Berkley,WR Berkley,10,26,4,40,
2025-08-24,Ren√© Jones,M&T Bank,12,23,5,40,
2025-08-24,Lauren Hobart,Dick's Sporting Goods,11,25,4,40,
2025-08-24,Robert Frenzel,Xcel Energy,4,2,1,7,
2025-08-24,Timothy Spence,Fifth Third Bancorp,4,4,1,9,
2025-08-24,Stephen Schwarzman,Blackstone,17,19,4,40,
2025-08-24,Walker Martin,Sempra,0,2,0,2,
2025-08-24,Timothy NeCastro,Erie Insurance,3,6,1,10,
2025-08-24,Wendell Weeks,Corning,15,23,2,40,
2025-08-24,Kathleen Johnson,Lumen Technologies,3,4,0,7,
2025-08-24,Brian Tierney,FirstEnergy,4,26,2,32,
2025-08-24,Adam Schechter,Labcorp,7,19,1,27,
2025-08-24,Tiang Yew Tan,Western Digital,3,0,0,3,
2025-08-24,Richard McKenney,Unum,4,5,0,9,
2025-08-24,Javier Rodriguez,DaVita,14,15,1,30,
2025-08-24,Steven Cahillane,Kellanova,2,7,0,9,
2025-08-24,Stanley Bergman,Henry Schein,11,28,1,40,
2025-08-24,Robert Sanchez,Ryder System,10,9,1,20,
2025-08-24,Tim Hingtgen,Community Health Systems,10,28,2,40,
2025-08-24,Avigal Soreq,Delek US,3,9,4,16,
2025-08-24,Gerardo Norcia,DTE Energy,7,3,0,10,
2025-08-24,Mark Pearson,Equitable,7,9,0,16,
2025-08-24,Lori Koch,DuPont,7,18,0,25,
2025-08-24,Rich Steinmeier,LPL Financial,24,14,2,40,
2025-08-24,Bruce Van Saun,Citizens Financial,11,27,2,40,
2025-08-24,Jos√© Mas,MasTec,6,14,2,22,
2025-08-24,Andr√©s Gluski,AES,19,20,0,39,
2025-08-24,Kevin Kwilinski,Berry Global,7,18,0,25,
2025-08-24,Mark George,Norfolk Southern,19,20,1,40,
2025-08-24,Eduardo Menezes,Air Products & Chemicals,5,4,1,10,
2025-08-24,Shelley Simpson,JB Hunt Transport Services,6,31,3,40,
2025-08-24,Daniel Fisher,Ball,3,21,5,29,
2025-08-24,Sean Connolly,Conagra Brands,6,32,2,40,
2025-08-24,Stephen Steinour,Huntington Bancshares,3,7,0,10,
2025-08-24,James Snee,Hormel Foods,2,28,1,31,
2025-08-24,Joseph Nolan,Eversource Energy,5,3,1,9,
2025-08-24,William Oplinger,Alcoa,9,19,4,32,
2025-08-24,Andrew Marsh,Entergy,2,6,0,8,
2025-08-24,Keith Demmings,Assurant,4,7,0,11,
2025-08-24,Sumit Singh,Chewy,14,22,4,40,
2025-08-24,Niraj Shah,Wayfair,9,23,8,40,
2025-08-24,Joseph Ferraro,Avis Budget,3,6,1,10,
2025-08-24,Jeffrey Sprecher,Intercontinental Exchange,15,23,2,40,
2025-08-24,Benito Minicucci,Alaska Air,3,5,1,9,
2025-08-24,Malcolm Wilson,GXO Logistics,7,24,0,31,
2025-08-24,Eric Hansotia,AGCO,17,22,1,40,
2025-08-24,Kathleen Mazzarella,Graybar Electric,1,6,1,8,
2025-08-24,Gavin Hattersley,Molson Coors Beverage,5,31,4,40,
2025-08-24,Patrick Gallagher,Arthur J Gallagher,10,28,2,40,
2025-08-24,Christopher Kastner,Huntington Ingalls Industries,3,4,1,8,
2025-08-24,Erik Fyrwald,International Flavors & Fragrances,6,8,2,16,
2025-08-24,Ricardo Cardenas,Darden Restaurants,4,2,1,7,
2025-08-24,Stephen Spray,Cincinnati Financial,2,5,3,10,
2025-08-24,Scott Boatwright,Chipotle Mexican Grill,7,28,5,40,
2025-08-24,Joey Wat,Yum China,12,26,2,40,
2025-08-24,Robert Goldstein,Las Vegas Sands,3,32,5,40,
2025-08-24,Kecia Steelman,Ulta Beauty,32,7,1,40,
2025-08-24,Thomas Reeg,Caesars Entertainment,6,5,0,11,
2025-08-24,Jon Rousseau,BrightSpring Health Services,21,18,1,40,
2025-08-24,William Krueger,Andersons,0,5,0,5,
2025-08-24,Michele Buck,Hershey,7,31,2,40,
2025-08-24,Christopher Nassetta,Hilton,13,23,4,40,
2025-08-24,Bruce Bodine,Mosaic,2,7,0,9,
2025-08-24,Brian Chesky,Airbnb,2,30,8,40,
2025-08-24,Kaes Van‚Äôt Hof,Diamondback Energy,23,14,2,39,
2025-08-24,Steven Vondran,American Tower,4,7,0,11,
2025-08-24,Reshma Kewalramani,Vertex Pharmaceuticals,22,15,3,40,
2025-08-24,William McDermott,ServiceNow,4,5,0,9,
2025-08-24,Brian Chambers,Owens Corning,3,11,1,15,
2025-08-24,Teresa Rasmussen,Thrivent Financial for Lutherans,3,2,0,5,
2025-08-24,Shane O'Kelly,Advance Auto Parts,13,22,5,40,
2025-08-24,Douglas Yearley,Toll Brothers,11,24,5,40,
2025-08-24,Jeffrey Lorberbaum,Mohawk Industries,11,5,1,17,
2025-08-24,Gregory Brown,Motorola Solutions,2,8,0,10,
2025-08-24,John Pfeifer,Oshkosh,6,25,4,35,
2025-08-24,Tony Xu,DoorDash,14,20,6,40,
2025-08-24,Edward Pesicka,Owens & Minor,4,34,2,40,
2025-08-24,Eugene Bredow,NVR,0,4,0,4,
2025-08-24,Philippe Krakowsky,Interpublic,16,21,3,40,
2025-08-24,Horacio Rozanski,Booz Allen Hamilton,16,19,5,40,
2025-08-24,Michael O‚ÄôSullivan,Burlington Stores,5,32,3,40,
2025-08-24,Daniel Wall,Expeditors International of Washington,3,4,0,7,
2025-08-24,Calvin McDonald,Lululemon athletica,8,30,2,40,
2025-08-24,Stephanie Ferris,Fidelity National Information,15,21,4,40,
2025-08-24,Rich Handler,Jefferies Financial,13,11,2,26,
2025-08-24,Alan Armstrong,Williams,24,12,4,40,
2025-08-24,Bracken Darrell,VF Corporation,10,26,4,40,
2025-08-24,Mikael Bratt,Autoliv,7,8,2,17,
2025-08-24,Rafael Santana,Westinghouse Air Brake Technologies,4,6,1,11,
2025-08-24,Ralph LaRossa,Public Service Enterprise,7,17,0,24,
2025-08-24,Jamie Iannone,Ebay,20,14,6,40,
2025-08-24,Scott Richardson,Celanese,5,19,2,26,
2025-08-24,Cameron Bready,Global Payments,8,29,3,40,
2025-08-24,Robert Thomson,News Corp,8,27,5,40,
2025-08-24,Robert Martin,THOR Industries,3,6,1,10,
2025-08-24,David Rawlinson II,QVC,6,11,2,19,
2025-08-24,Andrew Teno,Icahn Enterprises,4,5,0,9,
2025-08-24,William Newlands,Constellation Brands,0,2,2,4,
2025-08-24,James Davis,Quest Diagnostics,4,5,1,10,
2025-08-24,Richard Wallace,KLA,4,4,0,8,
2025-08-24,Julian Francis,QXO Building Products,0,0,0,0,
2025-08-24,John Christmann IV,APA,6,3,1,10,
2025-08-24,Gregory Roberts,A-Mark Precious Metals,2,3,1,6,
2025-08-24,Christopher Viehbacher,Biogen,0,28,2,30,
2025-08-24,Mick Beekhuizen,Campbell's,6,22,4,32,
2025-08-24,Christopher Caldwell,Concentrix,2,6,0,8,
2025-08-24,Todd Schneider,Cintas,12,18,1,31,
2025-08-24,Tony Sarsam,SpartanNash,18,20,2,40,
2025-08-24,John Venhuizen,Ace Hardware,15,24,1,40,
2025-08-24,Vincent Roche,Analog Devices,13,25,2,40,
2025-08-24,Mark Costa,Eastman Chemical,6,20,2,28,
2025-08-24,Milan Galik,Interactive Brokers,6,16,1,23,
2025-08-24,John Turner,Regions Financial,20,18,2,40,
2025-08-24,Joanna Geraghty,JetBlue Airways,17,17,6,40,
2025-08-24,Kristin Peck,Zoetis,11,19,1,31,
2025-08-24,Christopher Gorman,KeyCorp,4,6,0,10,
2025-08-24,Mark Bertolini,Oscar Health,12,20,8,40,
2025-08-24,Brendan McCracken,Ovintiv,6,5,1,12,
2025-08-24,Robert Steer,Seaboard,1,4,0,5,
2025-08-24,Gil West,Hertz,7,26,7,40,
2025-08-24,Robert Greenberg,Skechers,6,32,2,40,
2025-08-24,Dennis Mathew,Altice,4,26,7,37,
2025-08-24,Clay Williams,NOV,13,19,5,37,
2025-08-24,Michael Doss,Graphic Packaging,5,8,2,15,
2025-08-24,Deon Stander,Avery Dennison,0,12,0,12,
2025-08-24,Adaire Fox-Martin,Equinix,17,19,4,40,
2025-08-24,Joyce Mullen,Insight Enterprises,6,11,1,18,
2025-08-24,Jennifer Witz,Sirius XM,9,11,7,27,
2025-08-24,Stefan Larsson,PVH,12,22,6,40,
2025-08-24,Jason P Wells,CenterPoint Energy,6,4,0,10,
2025-08-24,Scott Lauber,WEC Energy,13,5,0,18,
2025-08-24,Matthew Pine,Xylem,2,9,1,12,
2025-08-24,Jennifer Johnson,Franklin Resources,2,5,2,9,
2025-08-24,Vincent Sorgi,PPL,8,10,1,19,
2025-08-24,Carl Eschenbach,Workday,11,20,9,40,
2025-08-24,Richard Tobin,Dover,3,5,1,9,
2025-08-24,Mark Kowlzan,Packaging Corp of America,1,10,1,12,
2025-08-24,Scott Salmirs,ABM Industries,6,7,1,14,
2025-08-24,Gary Guthart,Intuitive Surgical,13,24,3,40,
2025-08-24,Carl Lindner lll,American Financial,0,0,0,0,
2025-08-24,Blake Moret,Rockwell Automation,13,25,2,40,
2025-08-24,Bryan Hanson,Solventum,5,13,2,20,
2025-08-24,Craig Smiddy,Old Republic International,3,5,1,9,
2025-08-24,Christopher Hilger,Securian Financial,0,6,1,7,
2025-08-24,Hamid Moghadam,Prologis,7,28,5,40,
2025-08-24,Mark Smucker,JM Smucker,11,23,6,40,
2025-08-24,Sheryl Palmer,Taylor Morrison Home,6,12,1,19,
2025-08-24,Mario Harik,XPO,7,32,1,40,
2025-08-24,Heather Lavallee,Voya Financial,7,11,1,19,
2025-08-24,Nikesh Arora,Palo Alto Networks,7,26,7,40,
2025-08-24,Giordano Albertazzi,Vertiv s,0,1,0,1,
2025-08-24,Shankh Mitra,Welltower,16,22,2,40,
2025-08-24,Mary Dillon,Foot Locker,9,26,5,40,
2025-08-24,William Monteleone,Par Pacific,1,6,2,9,
2025-08-24,Kevin Stein,TransDigm,10,10,2,22,
2025-08-24,Peter Matt,Commercial Metals,6,4,0,10,
2025-08-24,Robert Vitale,Post s,0,0,0,0,
2025-08-24,Keith Allman,Masco,5,9,1,15,
2025-08-24,Rusty Rush,Rush Enterprises,16,21,3,40,
2025-08-24,Stuart Bradie,KBR,13,14,4,31,
2025-08-24,Jack Sinclair,Sprouts Farmers Market,14,25,1,40,
2025-08-24,Laura Alber,Williams-Sonoma,11,24,5,40,
2025-08-24,Ivan Tornos,Zimmer Biomet s,1,2,0,3,
2025-08-24,John Mengucci,CACI International,21,17,2,40,
2025-08-24,Steve Sanghi,Microchip Technology,9,28,3,40,
2025-08-24,Albert Nahmad,Watsco,2,7,0,9,
2025-08-24,Christopher Peterson,Newell Brands,2,7,1,10,
2025-08-24,Arie Kotler,ARKO,6,24,0,30,
2025-08-24,Jure Sola,Sanmina,3,14,1,18,
2025-08-24,Andrew Wilson,Electronic Arts,13,18,9,40,
2025-08-24,David Gibbs,Yum Brands,3,36,1,40,
2025-08-24,Daniel Florness,Fastenal,2,6,1,9,
2025-08-24,Garrick Rochow,CMS Energy,11,3,0,14,
2025-08-24,Rodney Sacks,Monster Beverage,14,23,2,39,
2025-08-24,Mark Shapiro,Endeavor,5,34,1,40,
2025-08-24,Toni Townes-Whitley,Science Applications International,12,22,1,35,
2025-08-24,Mark Witkowski,Core & Main,0,8,1,9,
2025-08-24,John Plant,Howmet Aerospace,4,14,1,19,
2025-08-24,James Zallie,Ingredion,3,6,1,10,
2025-08-24,Thomas Hill,Vulcan Materials,4,8,2,14,
2025-08-25,Doug McMillon,Walmart,16,18,6,40,
2025-08-25,Andrew Jassy,Amazon,6,28,6,40,
2025-08-25,Stephen Hemsley,UnitedHealth,7,28,5,40,
2025-08-25,Tim Cook,Apple,17,20,3,40,
2025-08-25,David Joyner,CVS Health,9,27,4,40,
2025-08-25,Warren Buffett,Berkshire Hathaway,10,19,11,40,
2025-08-25,Sundar Pichai,Alphabet,18,16,6,40,
2025-08-25,Darren Woods,Exxon Mobil,9,24,7,40,
2025-08-25,Brian Tyler,McKesson,4,17,5,26,
2025-08-25,Robert Mauch,Cencora,4,6,0,10,
2025-08-25,Jamie Dimon,JPMorgan Chase,10,16,14,40,
2025-08-25,Ron Vachris,Costco,6,32,2,40,
2025-08-25,David Cordani,Cigna,22,14,4,40,
2025-08-25,Satya Nadella,Microsoft,17,15,8,40,
2025-08-25,Jason Hollar,Cardinal Health,11,23,5,39,
2025-08-25,Mike Wirth,Chevron,17,18,5,40,
2025-08-25,Brian Moynihan,Bank of America,7,27,6,40,
2025-08-25,Mary Barra,General Motors,12,24,4,40,
2025-08-25,Jim Farley,Ford Motor,13,18,9,40,
2025-08-25,Gail Boudreaux,Elevance Health,15,18,7,40,
2025-08-25,Jane Fraser,Citigroup,11,23,6,40,
2025-08-25,Mark Zuckerberg,Meta,11,22,7,40,
2025-08-25,Sarah London,Centene,12,19,9,40,
2025-08-25,Ted Decker,Home Depot,10,21,9,40,
2025-08-25,Priscilla Almodovar,Fannie Mae,11,18,11,40,
2025-08-25,Tim Wentworth,Walgreens,8,22,9,39,
2025-08-25,Ron Sargent,Kroger,5,21,14,40,
2025-08-25,Mark Lashier,Phillips 66,8,22,8,38,
2025-08-25,Maryann Mannen,Marathon Petroleum,6,13,1,20,
2025-08-25,Hans Vestberg,Verizon,14,22,4,40,
2025-08-25,Jensen Huang,Nvidia,16,19,5,40,
2025-08-25,David Solomon,Goldman Sachs,8,22,9,39,
2025-08-25,Charles Scharf,Wells Fargo,30,6,4,40,
2025-08-25,Lane Riggs,Valero Energy,15,8,0,23,
2025-08-25,Brian Roberts,Comcast,11,26,3,40,
2025-08-25,Jon Farney,State Farm,10,26,4,40,
2025-08-25,John Stankey,AT&T,10,27,3,40,
2025-08-25,Michael Hutchins,Freddie Mac,3,12,3,18,
2025-08-25,Jim Rechtin,Humana,18,19,3,40,
2025-08-25,Ted Pick,Morgan Stanley,16,21,3,40,
2025-08-25,Michael Fiddelke,Target,12,21,7,40,
2025-08-25,Philip Smith,StoneX,0,10,1,11,
2025-08-25,Elon Musk,Tesla,15,13,12,40,
2025-08-25,Michael Dell,Dell Technologies,10,26,4,40,
2025-08-25,Ramon Laguarta,PepsiCo,7,27,6,40,
2025-08-25,Bob Iger,Walt Disney,10,27,3,40,
2025-08-25,Carol Tom√©,UPS,9,21,10,40,
2025-08-25,Joaquin Duato,Johnson & Johnson,12,23,5,40,
2025-08-25,Rajesh Subramaniam,FedEx,10,27,0,37,
2025-08-25,Juan Luciano,Archer Daniels Midland,3,21,13,37,
2025-08-25,Jon Moeller,Procter & Gamble,6,29,5,40,
2025-08-25,Marvin Ellison,Lowe's,16,18,6,40,
2025-08-25,Thomas Long,Energy Transfer,9,0,1,10,
2025-08-25,Christopher Calio,RTX,6,11,0,17,
2025-08-25,Susan Morris,Albertsons,10,27,3,40,
2025-08-25,Kevin Hourican,Sysco,9,28,3,40,
2025-08-25,Tricia Griffith,Progressive,12,23,4,39,
2025-08-25,Stephen Squeri,American Express,14,24,2,40,
2025-08-25,James Taiclet,Lockheed Martin,10,21,9,40,
2025-08-25,Michel Khalaf,MetLife,13,18,0,31,
2025-08-25,Samuel Hazen,HCA Healthcare,9,5,0,14,
2025-08-25,Andrew Sullivan,Prudential Financial,13,23,0,36,
2025-08-25,Kelly Ortberg,Boeing,12,24,4,40,
2025-08-25,Joe Creed,Caterpillar,11,27,2,40,
2025-08-25,Robert M Davis,Merck,4,21,0,25,
2025-08-25,Thomas J Wilson,Allstate,1,8,1,10,
2025-08-25,Albert Bourla,Pfizer,18,12,10,40,
2025-08-25,Arvind Krishna,IBM,13,21,6,40,
2025-08-25,Craig DeSanto,New York Life Insurance,3,17,0,20,
2025-08-25,Ed Bastian,Delta Airlines,16,13,10,39,
2025-08-25,Kevin Murphy,Ferguson Enterprises,3,15,2,20,
2025-08-25,Kirt Walker,Nationwide,14,17,2,33,
2025-08-25,Patrick Zammit,TD Synnex,11,15,0,26,
2025-08-25,Scott Kirby,United Airlines,33,4,3,40,
2025-08-25,Ryan Lance,ConocoPhillips,17,20,3,40,
2025-08-25,Ernie Herrman,TJX,14,24,2,40,
2025-08-25,Bob Michael,AbbVie,0,0,0,0,
2025-08-25,AJ Jim Teague,Enterprise Products Partners,4,7,0,11,
2025-08-25,Christopher Winfrey,Charter Communications,5,15,5,25,
2025-08-25,George Holm,Performance Food,10,23,2,35,
2025-08-25,Robert Isom,American Airlines,8,25,7,40,
2025-08-25,Richard Fairbank,Capital One,16,22,2,40,
2025-08-25,Chuck Robbins,Cisco Systems,15,22,3,40,
2025-08-25,Enrique Lores,HP,12,23,5,40,
2025-08-25,Donnie King,Tyson Foods,12,23,5,40,
2025-08-25,Lip-Bu Tan,Intel,8,21,11,40,
2025-08-25,Safra Catz,Oracle,10,23,7,40,
2025-08-25,Hock Tan,Broadcom,13,21,6,40,
2025-08-25,John May,Deere,8,27,5,40,
2025-08-25,Elliott Hill,Nike,12,24,4,40,
2025-08-25,Timothy M Sweeney,Liberty Mutual Insurance,14,0,0,14,
2025-08-25,Wilfred Chiang,Plains GP,1,1,0,2,
2025-08-25,Juan Andrade,USAA,5,16,0,21,
2025-08-25,Chris Boerner,Bristol-Myers Squibb,10,23,7,40,
2025-08-25,Paul Bay,Ingram Micro,13,23,4,40,
2025-08-25,Phebe Novakovic,General Dynamics,28,9,3,40,
2025-08-25,James Quincey,Coca-Cola,12,27,1,40,
2025-08-25,Thasunda Brown Duckett,TIAA,18,22,0,40,
2025-08-25,Alan Schnitzer,Travelers,15,18,7,40,
2025-08-25,David Ricks,Eli Lilly,11,22,7,40,
2025-08-25,Dara Khosrowshahi,Uber,12,24,4,40,
2025-08-25,Roger Crandall,Mass Mutual,2,7,0,9,
2025-08-25,Marc Casper,Thermo Fisher Scientific,15,22,3,40,
2025-08-25,Gunjan Kedia,US Bancorp,14,24,2,40,
2025-08-25,Michael Kasbar,World Kinect,2,10,0,12,
2025-08-25,Robert Ford,Abbott Laboratories,12,23,5,40,
2025-08-25,Corie Barry,Best Buy,38,1,0,39,
2025-08-25,Tim Gerend,Northwestern Mutual,14,25,1,40,
2025-08-25,Kathy Warden,Northrop Grumman,16,20,4,40,
2025-08-25,Joe Zubretsky,Molina Healthcare,8,7,4,19,
2025-08-25,Todd Vasos,Dollar General,8,21,11,40,
2025-08-25,Robin Vince,Bank of New York,19,18,3,40,
2025-08-25,David Zaslav,Warner Bros Discovery,7,21,12,40,
2025-08-25,Jay Debertin,CHS,3,8,4,15,
2025-08-25,Ted Sarandos,Netflix,11,27,2,40,
2025-08-25,Cristiano Amon,Qualcomm,13,26,1,40,
2025-08-25,Larry Culp,General Electric,11,26,3,40,
2025-08-25,Vimal Kapur,Honeywell,12,28,0,40,
2025-08-25,Marc Benioff,Salesforce,9,25,6,40,
2025-08-25,Jacek Olczak,Philip Morris,14,21,5,40,
2025-08-25,David Flitman,US Foods,1,8,0,9,
2025-08-25,Paul Romanowski,DR Horton,5,15,4,24,
2025-08-25,Bryan DeBoer,Lithia Motors,12,26,1,39,
2025-08-25,Dirk Van de Put,Mondelez,13,23,4,40,
2025-08-25,Brian Niccol,Starbucks,11,28,1,40,
2025-08-25,Ryan McInerney,Visa,17,19,4,40,
2025-08-25,Robert Sulentic,CBRE,1,7,1,9,
2025-08-25,Jonathan Jaffe,Lennar,0,9,1,10,
2025-08-25,Scott Strazik,GE Vernova,14,23,3,40,
2025-08-25,William Demchak,PNC,15,21,4,40,
2025-08-25,Jennifer Rumsey,Cummins,8,27,5,40,
2025-08-25,Preston Feight,Paccar,4,23,0,27,
2025-08-25,Robert Bradway,Amgen,9,29,2,40,
2025-08-25,Matthew Lucey,PBF Energy,7,2,0,9,
2025-08-25,Pat Geraghty,GuideWell Mutual,2,6,0,8,
2025-08-25,Alex Chriss,PayPal,13,24,3,40,
2025-08-25,Sandy Douglas,United Natural Foods,34,5,1,40,
2025-08-25,Michael Creedon,Dollar Tree,4,33,3,40,
2025-08-25,Leon Topalian,Nucor,15,23,2,40,
2025-08-25,Roger Penske,Penske Automotive,17,22,1,40,
2025-08-25,Bom Kim,Coupang,11,28,1,40,
2025-08-25,Antonio Neri,Hewlett Packard,8,24,8,40,
2025-08-25,Harry Sideris,Duke Energy,36,4,0,40,
2025-08-25,Joseph Bae,KKR,18,19,3,40,
2025-08-25,Brian Robbins,Paramount Global,6,29,1,36,
2025-08-25,Michael Dastoor,Jabil,2,7,0,9,
2025-08-25,Daniel O'Day,Gilead Sciences,20,18,2,40,
2025-08-25,Tim Go,HF Sinclair,6,3,0,9,
2025-08-25,William Nash,CarMax,4,4,2,10,
2025-08-25,Michael Miebach,Mastercard,11,25,4,40,
2025-08-25,Lawrence Coben,NRG Energy,6,2,0,8,
2025-08-25,Sean Kerins,Arrow Electronics,3,15,0,18,
2025-08-25,Lorenzo Simonelli,Baker Hughes,16,20,4,40,
2025-08-25,Bob Jordan,Southwest Airlines,9,23,8,40,
2025-08-25,Peter Zaffino,American International,8,29,3,40,
2025-08-25,Gary Dickerson,Applied Materials,8,22,10,40,
2025-08-25,Vicki Hollub,Occidental Petroleum,18,17,4,39,
2025-08-25,Michael Manley,AutoNation,3,6,1,10,
2025-08-25,Christopher Womack,Southern Company,2,7,0,9,
2025-08-25,Christopher Swift,Hartford Insurance,4,5,1,10,
2025-08-25,Marc Rowan,Apollo Global Management,17,19,4,40,
2025-08-25,Rick Wurster,Charles Schwab,14,21,4,39,
2025-08-25,Chris Kempczinski,McDonald's,15,17,8,40,
2025-08-25,Carlos Abrams-Rivera,Kraft Heinz,14,20,6,40,
2025-08-25,Lisa Su,Advanced Micro Devices,17,19,4,40,
2025-08-25,William H Rogers Jr,Truist Financial,2,6,1,9,
2025-08-25,Kathleen Quirk,Freeport-McMoRan,13,17,2,32,
2025-08-25,Sanjay Mehrotra,Micron Technology,17,22,1,40,
2025-08-25,Anthony Capuano,Marriott International,12,25,3,40,
2025-08-25,David Gitlin,Carrier Global,15,23,2,40,
2025-08-25,John Ketchum,NextEra Energy,23,17,0,40,
2025-08-25,William M Brown,3M,2,8,0,10,
2025-08-25,John Doyle,Marsh & McLennan,11,7,0,18,
2025-08-25,Patricia Poppe,PG&E,8,16,2,26,
2025-08-25,Jim Vena,Union Pacific,17,23,0,40,
2025-08-25,Brian Doubles,Synchrony Financial,5,6,2,13,
2025-08-25,Rainer Blair,Danaher,6,16,2,24,
2025-08-25,Philip Gallagher,Avnet,1,6,0,7,
2025-08-25,Glenn Fogel,Booking s,0,3,1,4,
2025-08-25,Ezra Yacob,EOG Resources,23,14,1,38,
2025-08-25,Earl Austin,Quanta Services,2,5,2,9,
2025-08-25,Michael Shepherd,Discover Financial,7,15,2,24,
2025-08-25,Joseph Dominguez,Constellation Energy,14,11,1,26,
2025-08-25,William Stengel II,Genuine Parts,0,4,0,4,
2025-08-25,Christian Ulbrich,Jones Lang LaSalle,10,23,0,33,
2025-08-25,Raymond E Scott,Lear Corporation,5,4,0,9,
2025-08-25,Michael Rapino,Live Nation Entertainment,14,23,3,40,
2025-08-25,Heidi Petz,Sherwin-Williams,7,27,3,37,
2025-08-25,Calvin G Butler Jr,Exelon,6,4,0,10,
2025-08-25,Tony Spring,Macy's,12,26,2,40,
2025-08-25,Jeff Miller,Halliburton,11,23,6,40,
2025-08-25,Kevin Lobo,Stryker,12,24,4,40,
2025-08-25,Tony Cheng,Reinsurance of America,0,0,0,0,
2025-08-25,Ronald P O'Hanley,State Street,6,14,0,20,
2025-08-25,John Engel,WESCO International,4,11,1,16,
2025-08-25,Pierce Norton II,Oneok,6,3,0,9,
2025-08-25,Shantanu Narayen,Adobe,19,20,1,40,
2025-08-25,Bill Westrate,American Family Insurance,11,13,2,26,
2025-08-25,Chris Kubasik,L3Harris Technologies,7,12,1,20,
2025-08-25,James Conroy,Ross Stores,5,10,0,15,
2025-08-25,Christine Leahy,CDW,1,8,2,11,
2025-08-25,Saumya Sutaria,Tenet Healthcare,4,4,1,9,
2025-08-25,Bob Eddy,BJ's Wholesale Club,7,31,2,40,
2025-08-25,Mike Lyons,Fiserv,3,12,0,15,
2025-08-25,William Gifford,Altria,2,6,1,9,
2025-08-25,Larry Fink,BlackRock,6,25,9,40,
2025-08-25,Thomas Polen,Becton Dickinson,7,3,0,10,
2025-08-25,Noel Wallace,Colgate-Palmolive,11,20,2,33,
2025-08-25,Michael Hsu,Kimberly-Clark,6,7,1,14,
2025-08-25,Daryl Kenningham,1 Automotive,11,22,1,34,
2025-08-25,Jennifer Parmentier,Parker-Hannifin,2,11,0,13,
2025-08-25,Jeffrey Harmening,General Mills,4,18,4,26,
2025-08-25,Ravi Kumar S,Cognizant Technology,9,26,4,39,
2025-08-25,William Fehrman,American Electric Power,4,6,0,10,
2025-08-25,Peter Arduini,GE HealthCare Technologies,7,10,0,17,
2025-08-25,Maria Black,Automatic Data Processing,2,8,0,10,
2025-08-25,Lourenco Goncalves,Cleveland-Cliffs,7,22,11,40,
2025-08-25,Dan Amos,Aflac,12,19,9,40,
2025-08-25,Mark Stewart,Goodyear Tire & Rubber,5,32,3,40,
2025-08-25,Kevin Hogan,Corebridge Financial,5,12,0,17,
2025-08-25,Thomas Palmer,Newmont,5,5,0,10,
2025-08-25,Andrew Silvernail,International Paper,6,21,0,27,
2025-08-25,Philip Daniele III,AutoZone,0,2,0,2,
2025-08-25,Ellen Cooper,Lincoln National,2,8,0,10,
2025-08-25,Ryan Marshall,PulteGroup,13,16,11,40,
2025-08-25,James Cracchiolo,Ameriprise Financial,2,23,2,27,
2025-08-25,Andrew Clyde,Murphy USA,13,26,1,40,
2025-08-25,Jonas Prising,Manpower,9,6,1,16,
2025-08-25,David Bozeman,CH Robinson Worldwide,2,7,0,9,
2025-08-25,Timothy Knavish,PPG Industries,1,3,0,4,
2025-08-25,Pedro Pizarro,Edison International,15,8,17,40,
2025-08-25,Mark Millett,Steel Dynamics,19,2,0,21,
2025-08-25,Benjamin Tisch,Loews,2,6,0,8,
2025-08-25,Karsanbhai,Emerson Electric,8,20,2,30,
2025-08-25,John Zillmer,Aramark,8,14,2,24,
2025-08-25,William Hornbuckle,MGM Resorts International,6,25,1,32,
2025-08-25,James Burke,Vistra,7,3,0,10,
2025-08-25,David Hult,Asbury Automotive,7,32,1,40,
2025-08-25,DG Macpherson,WW Grainger,2,7,1,10,
2025-08-25,Eric Slifka,Global Partners,14,20,6,40,
2025-08-25,Bob Pragada,Jacobs Solutions,5,8,0,13,
2025-08-25,Charles Magro,Corteva,4,3,1,8,
2025-08-25,Rick Lanoha,Peter Kiewit Sons',0,2,0,2,
2025-08-25,Michael Mahoney,Boston Scientific,10,28,2,40,
2025-08-25,Brad Beckham,O'Reilly Automotive,4,16,2,22,
2025-08-25,Thomas Bell,Leidos,8,18,2,28,
2025-08-25,Thomas Gayner,Markel Group,1,9,0,10,
2025-08-25,Marc Bitzer,Whirlpool,13,12,15,40,
2025-08-25,Andrew McMahon,Guardian Life,5,16,0,21,
2025-08-25,Peter Jackson,Builders FirstSource,5,11,1,17,
2025-08-25,Michael Rhodes,Ally Financial,11,24,5,40,
2025-08-25,Matthew Meloy,Targa Resources,4,6,0,10,
2025-08-25,James Breuer,Fluor,1,1,1,3,
2025-08-25,Sasan Goodarzi,Intuit,10,26,4,40,
2025-08-25,Troy Rudd,AECOM,8,26,5,39,
2025-08-25,Penny Pennington,Edward Jones,7,28,5,40,
2025-08-25,Michael Bender,Kohl's,1,26,13,40,
2025-08-25,Beth Ford,Land O'Lakes,15,23,2,40,
2025-08-25,Deanna Strable-Soethout,Principal Financial,1,5,0,6,
2025-08-25,Robert Blue,Dominion Energy,26,10,2,38,
2025-08-25,Martin Schroeter,Kyndryl s,0,3,0,3,
2025-08-25,Jon Vander Ark,Republic Services,9,20,11,40,
2025-08-25,Clay Gaspar,Devon Energy,17,3,0,20,
2025-08-25,Christopher O'Herlihy,Illinois Tool Works,4,5,1,10,
2025-08-25,Michael O'Grady,Northern Trust,25,3,1,29,
2025-08-25,Jamie Whisnant,Auto-Owners Insurance,0,2,0,2,
2025-08-25,Marc Miller,Universal Health Services,5,22,3,30,
2025-08-25,Darryl Button,Pacific Life,0,7,0,7,
2025-08-25,Hamid Akhavan,EchoStar,4,25,11,40,
2025-08-25,Christophe Beck,Ecolab,19,21,0,40,
2025-08-25,Jack Fusco,Cheniere Energy,18,19,3,40,
2025-08-25,John Wren,Omnicom,11,20,9,40,
2025-08-25,Haviv Ilan,Texas Instruments,10,27,3,40,
2025-08-25,David Burritt,United States Steel,8,17,15,40,
2025-08-25,St√©phane de La Faverie,Est√©e Lauder,12,24,4,40,
2025-08-25,Raul Nicholas Vargas Ochoa,Farmers Insurance Exchange,0,0,0,0,
2025-08-25,Thibaut Mongon,Kenvue,9,29,2,40,
2025-08-25,Ari Bousbib,IQVIA s,0,0,0,0,
2025-08-25,Donald Allan,Stanley Black & Decker,8,30,2,40,
2025-08-25,Timothy Cofer,Keurig Dr Pepper,2,3,1,6,
2025-08-25,Matthew Flannery,United Rentals,29,2,0,31,
2025-08-25,Timothy Cawley,Consolidated Edison,4,6,0,10,
2025-08-25,Adam Norwitt,Amphenol,2,17,0,19,
2025-08-25,Brent Shafer,Baxter International,1,10,0,11,
2025-08-25,Kimberly Dang,Kinder Morgan,9,1,0,10,
2025-08-25,Erik Nordstrom,Nordstrom,6,27,5,38,
2025-08-25,Frank Holding,First Citizens BancShares,9,14,2,25,
2025-08-25,Paul Shoukry,Raymond James Financial,14,26,0,40,
2025-08-25,Timothy Archer,Lam Research,2,7,1,10,
2025-08-25,Harry Lawton III,Tractor Supply,1,1,0,2,
2025-08-25,Darren Rebelez,Casey's General Stores,14,23,3,40,
2025-08-25,Scott Smith,Viatris,7,5,0,12,
2025-08-25,James Blackledge,Mutual of Omaha Insurance,0,6,0,6,
2025-08-25,Anthony Guzzi,EMCOR,4,4,0,8,
2025-08-25,Joseph Hinrichs,CSX,5,8,1,14,
2025-08-25,Justin Jude,LKQ,4,6,1,11,
2025-08-25,Judith Marks,Otis Worldwide,3,3,0,6,
2025-08-25,David Bruton Smith,Sonic Automotive,3,10,9,22,
2025-08-25,Martina Cheung,S&P Global,11,23,0,34,
2025-08-25,Leonard Schleifer,Regeneron Pharmaceuticals,6,27,7,40,
2025-08-25,Joseph Fadool,BorgWarner,4,9,0,13,
2025-08-25,Lachlan Murdoch,Fox,4,28,8,40,
2025-08-25,Karla Lewis,Reliance,4,5,0,9,
2025-08-25,John Barrett,Western & Southern Financial,8,30,2,40,
2025-08-25,Scott Donnelly,Textron,9,28,2,39,
2025-08-25,Ariane Gorin,Expedia,8,31,1,40,
2025-08-25,Michael Nolan,Fidelity National Financial,4,0,0,4,
2025-08-25,Ernest Garcia III,Carvana,24,12,4,40,
2025-08-25,Raul Fernandez,DXC Technology,3,28,2,33,
2025-08-25,Robert Berkley,WR Berkley,9,28,3,40,
2025-08-25,Ren√© Jones,M&T Bank,12,24,4,40,
2025-08-25,Lauren Hobart,Dick's Sporting Goods,11,25,4,40,
2025-08-25,Robert Frenzel,Xcel Energy,4,3,1,8,
2025-08-25,Timothy Spence,Fifth Third Bancorp,4,4,1,9,
2025-08-25,Stephen Schwarzman,Blackstone,14,21,5,40,
2025-08-25,Walker Martin,Sempra,0,2,0,2,
2025-08-25,Timothy NeCastro,Erie Insurance,3,6,1,10,
2025-08-25,Wendell Weeks,Corning,15,23,2,40,
2025-08-25,Kathleen Johnson,Lumen Technologies,2,5,0,7,
2025-08-25,Brian Tierney,FirstEnergy,4,27,2,33,
2025-08-25,Adam Schechter,Labcorp,7,20,1,28,
2025-08-25,Tiang Yew Tan,Western Digital,3,0,0,3,
2025-08-25,Richard McKenney,Unum,5,4,0,9,
2025-08-25,Javier Rodriguez,DaVita,14,15,1,30,
2025-08-25,Steven Cahillane,Kellanova,2,7,0,9,
2025-08-25,Stanley Bergman,Henry Schein,12,27,1,40,
2025-08-25,Robert Sanchez,Ryder System,11,8,1,20,
2025-08-25,Tim Hingtgen,Community Health Systems,10,28,2,40,
2025-08-25,Avigal Soreq,Delek US,3,9,5,17,
2025-08-25,Gerardo Norcia,DTE Energy,6,3,0,9,
2025-08-25,Mark Pearson,Equitable,7,9,0,16,
2025-08-25,Lori Koch,DuPont,7,19,0,26,
2025-08-25,Rich Steinmeier,LPL Financial,24,14,2,40,
2025-08-25,Bruce Van Saun,Citizens Financial,12,27,1,40,
2025-08-25,Jos√© Mas,MasTec,6,14,2,22,
2025-08-25,Andr√©s Gluski,AES,17,15,0,32,
2025-08-25,Kevin Kwilinski,Berry Global,7,18,0,25,
2025-08-25,Mark George,Norfolk Southern,19,19,2,40,
2025-08-25,Eduardo Menezes,Air Products & Chemicals,5,4,1,10,
2025-08-25,Shelley Simpson,JB Hunt Transport Services,6,31,3,40,
2025-08-25,Daniel Fisher,Ball,2,18,5,25,
2025-08-25,Sean Connolly,Conagra Brands,6,32,2,40,
2025-08-25,Stephen Steinour,Huntington Bancshares,4,6,0,10,
2025-08-25,James Snee,Hormel Foods,2,27,1,30,
2025-08-25,Joseph Nolan,Eversource Energy,5,3,1,9,
2025-08-25,William Oplinger,Alcoa,9,18,6,33,
2025-08-25,Andrew Marsh,Entergy,2,6,0,8,
2025-08-25,Keith Demmings,Assurant,4,7,0,11,
2025-08-25,Sumit Singh,Chewy,13,22,5,40,
2025-08-25,Niraj Shah,Wayfair,8,24,8,40,
2025-08-25,Joseph Ferraro,Avis Budget,3,6,1,10,
2025-08-25,Jeffrey Sprecher,Intercontinental Exchange,15,23,2,40,
2025-08-25,Benito Minicucci,Alaska Air,3,4,1,8,
2025-08-25,Malcolm Wilson,GXO Logistics,6,23,0,29,
2025-08-25,Eric Hansotia,AGCO,18,21,1,40,
2025-08-25,Kathleen Mazzarella,Graybar Electric,1,8,0,9,
2025-08-25,Gavin Hattersley,Molson Coors Beverage,5,31,4,40,
2025-08-25,Patrick Gallagher,Arthur J Gallagher,12,27,1,40,
2025-08-25,Christopher Kastner,Huntington Ingalls Industries,3,4,1,8,
2025-08-25,Erik Fyrwald,International Flavors & Fragrances,6,9,2,17,
2025-08-25,Ricardo Cardenas,Darden Restaurants,4,2,1,7,
2025-08-25,Stephen Spray,Cincinnati Financial,2,5,3,10,
2025-08-25,Scott Boatwright,Chipotle Mexican Grill,8,27,5,40,
2025-08-25,Joey Wat,Yum China,13,25,2,40,
2025-08-25,Robert Goldstein,Las Vegas Sands,3,32,5,40,
2025-08-25,Kecia Steelman,Ulta Beauty,31,8,1,40,
2025-08-25,Thomas Reeg,Caesars Entertainment,6,5,0,11,
2025-08-25,Jon Rousseau,BrightSpring Health Services,21,18,1,40,
2025-08-25,William Krueger,Andersons,0,5,0,5,
2025-08-25,Michele Buck,Hershey,8,30,2,40,
2025-08-25,Christopher Nassetta,Hilton,13,23,4,40,
2025-08-25,Bruce Bodine,Mosaic,2,7,0,9,
2025-08-25,Brian Chesky,Airbnb,2,30,8,40,
2025-08-25,Kaes Van‚Äôt Hof,Diamondback Energy,23,14,2,39,
2025-08-25,Steven Vondran,American Tower,4,7,0,11,
2025-08-25,Reshma Kewalramani,Vertex Pharmaceuticals,20,16,4,40,
2025-08-25,William McDermott,ServiceNow,5,4,0,9,
2025-08-25,Brian Chambers,Owens Corning,3,11,1,15,
2025-08-25,Teresa Rasmussen,Thrivent Financial for Lutherans,3,2,0,5,
2025-08-25,Shane O'Kelly,Advance Auto Parts,12,22,6,40,
2025-08-25,Douglas Yearley,Toll Brothers,11,24,5,40,
2025-08-25,Jeffrey Lorberbaum,Mohawk Industries,11,5,1,17,
2025-08-25,Gregory Brown,Motorola Solutions,2,8,0,10,
2025-08-25,John Pfeifer,Oshkosh,7,23,5,35,
2025-08-25,Tony Xu,DoorDash,14,18,8,40,
2025-08-25,Edward Pesicka,Owens & Minor,4,33,2,39,
2025-08-25,Eugene Bredow,NVR,0,5,0,5,
2025-08-25,Philippe Krakowsky,Interpublic,16,21,3,40,
2025-08-25,Horacio Rozanski,Booz Allen Hamilton,15,20,5,40,
2025-08-25,Michael O‚ÄôSullivan,Burlington Stores,9,28,3,40,
2025-08-25,Daniel Wall,Expeditors International of Washington,4,4,0,8,
2025-08-25,Calvin McDonald,Lululemon athletica,8,29,3,40,
2025-08-25,Stephanie Ferris,Fidelity National Information,14,21,3,38,
2025-08-25,Rich Handler,Jefferies Financial,13,10,2,25,
2025-08-25,Alan Armstrong,Williams,24,12,4,40,
2025-08-25,Bracken Darrell,VF Corporation,10,27,3,40,
2025-08-25,Mikael Bratt,Autoliv,5,9,2,16,
2025-08-25,Rafael Santana,Westinghouse Air Brake Technologies,2,6,1,9,
2025-08-25,Ralph LaRossa,Public Service Enterprise,6,16,0,22,
2025-08-25,Jamie Iannone,Ebay,19,16,5,40,
2025-08-25,Scott Richardson,Celanese,7,29,4,40,
2025-08-25,Cameron Bready,Global Payments,8,29,3,40,
2025-08-25,Robert Thomson,News Corp,8,27,5,40,
2025-08-25,Robert Martin,THOR Industries,4,5,1,10,
2025-08-25,David Rawlinson II,QVC,7,11,2,20,
2025-08-25,Andrew Teno,Icahn Enterprises,4,6,0,10,
2025-08-25,William Newlands,Constellation Brands,0,2,2,4,
2025-08-25,James Davis,Quest Diagnostics,5,5,0,10,
2025-08-25,Richard Wallace,KLA,3,4,0,7,
2025-08-25,Julian Francis,QXO Building Products,0,0,0,0,
2025-08-25,John Christmann IV,APA,6,3,1,10,
2025-08-25,Gregory Roberts,A-Mark Precious Metals,2,4,1,7,
2025-08-25,Christopher Viehbacher,Biogen,0,29,2,31,
2025-08-25,Mick Beekhuizen,Campbell's,7,22,4,33,
2025-08-25,Christopher Caldwell,Concentrix,2,5,0,7,
2025-08-25,Todd Schneider,Cintas,11,18,1,30,
2025-08-25,Tony Sarsam,SpartanNash,18,20,2,40,
2025-08-25,John Venhuizen,Ace Hardware,14,24,2,40,
2025-08-25,Vincent Roche,Analog Devices,14,23,2,39,
2025-08-25,Mark Costa,Eastman Chemical,5,19,4,28,
2025-08-25,Milan Galik,Interactive Brokers,6,17,1,24,
2025-08-25,John Turner,Regions Financial,19,19,2,40,
2025-08-25,Joanna Geraghty,JetBlue Airways,16,19,5,40,
2025-08-25,Kristin Peck,Zoetis,11,19,1,31,
2025-08-25,Christopher Gorman,KeyCorp,4,6,0,10,
2025-08-25,Mark Bertolini,Oscar Health,13,19,8,40,
2025-08-25,Brendan McCracken,Ovintiv,5,5,1,11,
2025-08-25,Robert Steer,Seaboard,1,4,0,5,
2025-08-25,Gil West,Hertz,7,26,7,40,
2025-08-25,Robert Greenberg,Skechers,6,32,2,40,
2025-08-25,Dennis Mathew,Altice,4,28,7,39,
2025-08-25,Clay Williams,NOV,13,20,4,37,
2025-08-25,Michael Doss,Graphic Packaging,6,7,2,15,
2025-08-25,Deon Stander,Avery Dennison,0,12,0,12,
2025-08-25,Adaire Fox-Martin,Equinix,16,20,4,40,
2025-08-25,Joyce Mullen,Insight Enterprises,6,11,1,18,
2025-08-25,Jennifer Witz,Sirius XM,9,10,6,25,
2025-08-25,Stefan Larsson,PVH,12,23,5,40,
2025-08-25,Jason P Wells,CenterPoint Energy,6,4,0,10,
2025-08-25,Scott Lauber,WEC Energy,14,5,0,19,
2025-08-25,Matthew Pine,Xylem,2,9,1,12,
2025-08-25,Jennifer Johnson,Franklin Resources,2,5,2,9,
2025-08-25,Vincent Sorgi,PPL,8,10,1,19,
2025-08-25,Carl Eschenbach,Workday,11,20,9,40,
2025-08-25,Richard Tobin,Dover,3,6,1,10,
2025-08-25,Mark Kowlzan,Packaging Corp of America,0,9,1,10,
2025-08-25,Scott Salmirs,ABM Industries,6,8,1,15,
2025-08-25,Gary Guthart,Intuitive Surgical,13,24,3,40,
2025-08-25,Carl Lindner lll,American Financial,0,0,0,0,
2025-08-25,Blake Moret,Rockwell Automation,13,25,2,40,
2025-08-25,Bryan Hanson,Solventum,6,11,3,20,
2025-08-25,Craig Smiddy,Old Republic International,3,6,1,10,
2025-08-25,Christopher Hilger,Securian Financial,0,7,1,8,
2025-08-25,Hamid Moghadam,Prologis,7,28,5,40,
2025-08-25,Mark Smucker,JM Smucker,10,23,7,40,
2025-08-25,Sheryl Palmer,Taylor Morrison Home,6,12,1,19,
2025-08-25,Mario Harik,XPO,8,31,1,40,
2025-08-25,Heather Lavallee,Voya Financial,6,11,1,18,
2025-08-25,Nikesh Arora,Palo Alto Networks,6,27,7,40,
2025-08-25,Giordano Albertazzi,Vertiv s,0,1,0,1,
2025-08-25,Shankh Mitra,Welltower,16,22,2,40,
2025-08-25,Mary Dillon,Foot Locker,9,25,6,40,
2025-08-25,William Monteleone,Par Pacific,1,6,2,9,
2025-08-25,Kevin Stein,TransDigm,11,10,1,22,
2025-08-25,Peter Matt,Commercial Metals,6,4,0,10,
2025-08-25,Robert Vitale,Post s,0,0,0,0,
2025-08-25,Keith Allman,Masco,5,9,1,15,
2025-08-25,Rusty Rush,Rush Enterprises,16,21,3,40,
2025-08-25,Stuart Bradie,KBR,14,14,4,32,
2025-08-25,Jack Sinclair,Sprouts Farmers Market,15,24,1,40,
2025-08-25,Laura Alber,Williams-Sonoma,11,24,5,40,
2025-08-25,Ivan Tornos,Zimmer Biomet s,1,2,0,3,
2025-08-25,John Mengucci,CACI International,21,17,2,40,
2025-08-25,Steve Sanghi,Microchip Technology,9,27,4,40,
2025-08-25,Albert Nahmad,Watsco,2,7,0,9,
2025-08-25,Christopher Peterson,Newell Brands,2,7,1,10,
2025-08-25,Arie Kotler,ARKO,6,24,0,30,
2025-08-25,Jure Sola,Sanmina,3,14,1,18,
2025-08-25,Andrew Wilson,Electronic Arts,13,17,10,40,
2025-08-25,David Gibbs,Yum Brands,2,36,2,40,
2025-08-25,Daniel Florness,Fastenal,2,7,0,9,
2025-08-25,Garrick Rochow,CMS Energy,10,3,0,13,
2025-08-25,Rodney Sacks,Monster Beverage,13,24,2,39,
2025-08-25,Mark Shapiro,Endeavor,6,33,1,40,
2025-08-25,Toni Townes-Whitley,Science Applications International,12,22,1,35,
2025-08-25,Mark Witkowski,Core & Main,0,8,1,9,
2025-08-25,John Plant,Howmet Aerospace,4,14,1,19,
2025-08-25,James Zallie,Ingredion,4,5,1,10,
2025-08-25,Thomas Hill,Vulcan Materials,4,8,2,14,
2025-08-26,Doug McMillon,Walmart,15,19,6,40,
2025-08-26,Andrew Jassy,Amazon,5,29,6,40,
2025-08-26,Stephen Hemsley,UnitedHealth,8,26,6,40,
2025-08-26,Tim Cook,Apple,17,22,1,40,
2025-08-26,David Joyner,CVS Health,8,28,4,40,
2025-08-26,Warren Buffett,Berkshire Hathaway,9,23,8,40,
2025-08-26,Sundar Pichai,Alphabet,18,15,7,40,
2025-08-26,Darren Woods,Exxon Mobil,11,22,7,40,
2025-08-26,Brian Tyler,McKesson,4,17,5,26,
2025-08-26,Robert Mauch,Cencora,4,6,0,10,
2025-08-26,Jamie Dimon,JPMorgan Chase,8,17,15,40,
2025-08-26,Ron Vachris,Costco,7,31,2,40,
2025-08-26,David Cordani,Cigna,21,15,4,40,
2025-08-26,Satya Nadella,Microsoft,16,17,7,40,
2025-08-26,Jason Hollar,Cardinal Health,14,21,5,40,
2025-08-26,Mike Wirth,Chevron,16,16,8,40,
2025-08-26,Brian Moynihan,Bank of America,6,27,7,40,
2025-08-26,Mary Barra,General Motors,12,25,3,40,
2025-08-26,Jim Farley,Ford Motor,12,22,6,40,
2025-08-26,Gail Boudreaux,Elevance Health,16,17,7,40,
2025-08-26,Jane Fraser,Citigroup,12,22,6,40,
2025-08-26,Mark Zuckerberg,Meta,12,23,5,40,
2025-08-26,Sarah London,Centene,12,19,9,40,
2025-08-26,Ted Decker,Home Depot,10,24,6,40,
2025-08-26,Priscilla Almodovar,Fannie Mae,11,19,10,40,
2025-08-26,Tim Wentworth,Walgreens,7,22,10,39,
2025-08-26,Ron Sargent,Kroger,5,21,14,40,
2025-08-26,Mark Lashier,Phillips 66,10,21,7,38,
2025-08-26,Maryann Mannen,Marathon Petroleum,6,13,0,19,
2025-08-26,Hans Vestberg,Verizon,16,19,5,40,
2025-08-26,Jensen Huang,Nvidia,10,27,3,40,
2025-08-26,David Solomon,Goldman Sachs,9,24,7,40,
2025-08-26,Charles Scharf,Wells Fargo,31,6,3,40,
2025-08-26,Lane Riggs,Valero Energy,15,7,0,22,
2025-08-26,Brian Roberts,Comcast,11,26,3,40,
2025-08-26,Jon Farney,State Farm,9,27,4,40,
2025-08-26,John Stankey,AT&T,9,27,3,39,
2025-08-26,Michael Hutchins,Freddie Mac,3,12,3,18,
2025-08-26,Jim Rechtin,Humana,18,18,4,40,
2025-08-26,Ted Pick,Morgan Stanley,16,22,2,40,
2025-08-26,Michael Fiddelke,Target,11,22,7,40,
2025-08-26,Philip Smith,StoneX,0,10,1,11,
2025-08-26,Elon Musk,Tesla,15,14,11,40,
2025-08-26,Michael Dell,Dell Technologies,11,24,5,40,
2025-08-26,Ramon Laguarta,PepsiCo,7,26,7,40,
2025-08-26,Bob Iger,Walt Disney,9,28,3,40,
2025-08-26,Carol Tom√©,UPS,8,22,10,40,
2025-08-26,Joaquin Duato,Johnson & Johnson,11,24,5,40,
2025-08-26,Rajesh Subramaniam,FedEx,11,27,0,38,
2025-08-26,Juan Luciano,Archer Daniels Midland,3,21,14,38,
2025-08-26,Jon Moeller,Procter & Gamble,5,28,7,40,
2025-08-26,Marvin Ellison,Lowe's,17,18,5,40,
2025-08-26,Thomas Long,Energy Transfer,8,0,1,9,
2025-08-26,Christopher Calio,RTX,7,11,0,18,
2025-08-26,Susan Morris,Albertsons,12,25,3,40,
2025-08-26,Kevin Hourican,Sysco,9,27,4,40,
2025-08-26,Tricia Griffith,Progressive,12,23,4,39,
2025-08-26,Stephen Squeri,American Express,13,25,2,40,
2025-08-26,James Taiclet,Lockheed Martin,12,18,10,40,
2025-08-26,Michel Khalaf,MetLife,12,17,0,29,
2025-08-26,Samuel Hazen,HCA Healthcare,9,5,0,14,
2025-08-26,Andrew Sullivan,Prudential Financial,13,23,0,36,
2025-08-26,Kelly Ortberg,Boeing,10,26,4,40,
2025-08-26,Joe Creed,Caterpillar,11,27,2,40,
2025-08-26,Robert M Davis,Merck,4,20,0,24,
2025-08-26,Thomas J Wilson,Allstate,0,9,1,10,
2025-08-26,Albert Bourla,Pfizer,19,13,8,40,
2025-08-26,Arvind Krishna,IBM,13,21,6,40,
2025-08-26,Craig DeSanto,New York Life Insurance,3,17,0,20,
2025-08-26,Ed Bastian,Delta Airlines,16,13,10,39,
2025-08-26,Kevin Murphy,Ferguson Enterprises,3,15,2,20,
2025-08-26,Kirt Walker,Nationwide,14,17,2,33,
2025-08-26,Patrick Zammit,TD Synnex,12,15,0,27,
2025-08-26,Scott Kirby,United Airlines,32,4,4,40,
2025-08-26,Ryan Lance,ConocoPhillips,17,20,3,40,
2025-08-26,Ernie Herrman,TJX,15,23,2,40,
2025-08-26,Bob Michael,AbbVie,0,0,0,0,
2025-08-26,AJ Jim Teague,Enterprise Products Partners,3,8,0,11,
2025-08-26,Christopher Winfrey,Charter Communications,5,15,5,25,
2025-08-26,George Holm,Performance Food,11,23,2,36,
2025-08-26,Robert Isom,American Airlines,8,25,7,40,
2025-08-26,Richard Fairbank,Capital One,14,22,4,40,
2025-08-26,Chuck Robbins,Cisco Systems,15,23,2,40,
2025-08-26,Enrique Lores,HP,13,22,5,40,
2025-08-26,Donnie King,Tyson Foods,11,25,4,40,
2025-08-26,Lip-Bu Tan,Intel,15,15,10,40,
2025-08-26,Safra Catz,Oracle,10,23,7,40,
2025-08-26,Hock Tan,Broadcom,13,21,6,40,
2025-08-26,John May,Deere,9,26,5,40,
2025-08-26,Elliott Hill,Nike,13,23,4,40,
2025-08-26,Timothy M Sweeney,Liberty Mutual Insurance,14,0,0,14,
2025-08-26,Wilfred Chiang,Plains GP,1,1,0,2,
2025-08-26,Juan Andrade,USAA,5,16,0,21,
2025-08-26,Chris Boerner,Bristol-Myers Squibb,10,23,7,40,
2025-08-26,Paul Bay,Ingram Micro,13,23,4,40,
2025-08-26,Phebe Novakovic,General Dynamics,28,9,3,40,
2025-08-26,James Quincey,Coca-Cola,11,28,1,40,
2025-08-26,Thasunda Brown Duckett,TIAA,20,20,0,40,
2025-08-26,Alan Schnitzer,Travelers,15,18,7,40,
2025-08-26,David Ricks,Eli Lilly,11,21,8,40,
2025-08-26,Dara Khosrowshahi,Uber,11,23,6,40,
2025-08-26,Roger Crandall,Mass Mutual,2,7,0,9,
2025-08-26,Marc Casper,Thermo Fisher Scientific,15,23,2,40,
2025-08-26,Gunjan Kedia,US Bancorp,13,25,2,40,
2025-08-26,Michael Kasbar,World Kinect,2,10,0,12,
2025-08-26,Robert Ford,Abbott Laboratories,13,23,4,40,
2025-08-26,Corie Barry,Best Buy,39,1,0,40,
2025-08-26,Tim Gerend,Northwestern Mutual,13,26,1,40,
2025-08-26,Kathy Warden,Northrop Grumman,16,20,4,40,
2025-08-26,Joe Zubretsky,Molina Healthcare,8,8,4,20,
2025-08-26,Todd Vasos,Dollar General,6,23,11,40,
2025-08-26,Robin Vince,Bank of New York,19,18,3,40,
2025-08-26,David Zaslav,Warner Bros Discovery,5,22,13,40,
2025-08-26,Jay Debertin,CHS,3,8,4,15,
2025-08-26,Ted Sarandos,Netflix,12,26,2,40,
2025-08-26,Cristiano Amon,Qualcomm,13,26,1,40,
2025-08-26,Larry Culp,General Electric,11,26,3,40,
2025-08-26,Vimal Kapur,Honeywell,12,28,0,40,
2025-08-26,Marc Benioff,Salesforce,9,24,7,40,
2025-08-26,Jacek Olczak,Philip Morris,14,22,4,40,
2025-08-26,David Flitman,US Foods,1,8,0,9,
2025-08-26,Paul Romanowski,DR Horton,6,15,4,25,
2025-08-26,Bryan DeBoer,Lithia Motors,11,27,1,39,
2025-08-26,Dirk Van de Put,Mondelez,10,27,3,40,
2025-08-26,Brian Niccol,Starbucks,12,27,1,40,
2025-08-26,Ryan McInerney,Visa,16,19,5,40,
2025-08-26,Robert Sulentic,CBRE,1,7,1,9,
2025-08-26,Jonathan Jaffe,Lennar,0,9,1,10,
2025-08-26,Scott Strazik,GE Vernova,14,23,3,40,
2025-08-26,William Demchak,PNC,14,22,4,40,
2025-08-26,Jennifer Rumsey,Cummins,8,26,6,40,
2025-08-26,Preston Feight,Paccar,5,23,0,28,
2025-08-26,Robert Bradway,Amgen,9,28,3,40,
2025-08-26,Matthew Lucey,PBF Energy,7,2,0,9,
2025-08-26,Pat Geraghty,GuideWell Mutual,2,6,0,8,
2025-08-26,Alex Chriss,PayPal,13,24,3,40,
2025-08-26,Sandy Douglas,United Natural Foods,34,5,1,40,
2025-08-26,Michael Creedon,Dollar Tree,4,33,3,40,
2025-08-26,Leon Topalian,Nucor,16,22,2,40,
2025-08-26,Roger Penske,Penske Automotive,17,23,0,40,
2025-08-26,Bom Kim,Coupang,11,28,1,40,
2025-08-26,Antonio Neri,Hewlett Packard,8,24,8,40,
2025-08-26,Harry Sideris,Duke Energy,36,4,0,40,
2025-08-26,Joseph Bae,KKR,18,19,3,40,
2025-08-26,Brian Robbins,Paramount Global,6,29,1,36,
2025-08-26,Michael Dastoor,Jabil,2,7,0,9,
2025-08-26,Daniel O'Day,Gilead Sciences,17,19,4,40,
2025-08-26,Tim Go,HF Sinclair,6,3,0,9,
2025-08-26,William Nash,CarMax,4,3,2,9,
2025-08-26,Michael Miebach,Mastercard,11,25,4,40,
2025-08-26,Lawrence Coben,NRG Energy,6,2,0,8,
2025-08-26,Sean Kerins,Arrow Electronics,1,15,0,16,
2025-08-26,Lorenzo Simonelli,Baker Hughes,17,19,4,40,
2025-08-26,Bob Jordan,Southwest Airlines,9,24,7,40,
2025-08-26,Peter Zaffino,American International,9,28,3,40,
2025-08-26,Gary Dickerson,Applied Materials,7,22,11,40,
2025-08-26,Vicki Hollub,Occidental Petroleum,20,16,3,39,
2025-08-26,Michael Manley,AutoNation,3,6,1,10,
2025-08-26,Christopher Womack,Southern Company,2,8,0,10,
2025-08-26,Christopher Swift,Hartford Insurance,4,5,1,10,
2025-08-26,Marc Rowan,Apollo Global Management,18,18,4,40,
2025-08-26,Rick Wurster,Charles Schwab,14,22,3,39,
2025-08-26,Chris Kempczinski,McDonald's,13,18,9,40,
2025-08-26,Carlos Abrams-Rivera,Kraft Heinz,14,19,7,40,
2025-08-26,Lisa Su,Advanced Micro Devices,17,17,6,40,
2025-08-26,William H Rogers Jr,Truist Financial,2,6,1,9,
2025-08-26,Kathleen Quirk,Freeport-McMoRan,14,17,2,33,
2025-08-26,Sanjay Mehrotra,Micron Technology,14,23,3,40,
2025-08-26,Anthony Capuano,Marriott International,12,25,3,40,
2025-08-26,David Gitlin,Carrier Global,15,23,2,40,
2025-08-26,John Ketchum,NextEra Energy,23,17,0,40,
2025-08-26,William M Brown,3M,2,8,0,10,
2025-08-26,John Doyle,Marsh & McLennan,11,7,0,18,
2025-08-26,Patricia Poppe,PG&E,8,16,2,26,
2025-08-26,Jim Vena,Union Pacific,19,21,0,40,
2025-08-26,Brian Doubles,Synchrony Financial,5,6,2,13,
2025-08-26,Rainer Blair,Danaher,6,15,2,23,
2025-08-26,Philip Gallagher,Avnet,1,5,0,6,
2025-08-26,Glenn Fogel,Booking s,0,4,1,5,
2025-08-26,Ezra Yacob,EOG Resources,23,12,1,36,
2025-08-26,Earl Austin,Quanta Services,2,4,2,8,
2025-08-26,Michael Shepherd,Discover Financial,9,15,2,26,
2025-08-26,Joseph Dominguez,Constellation Energy,14,10,1,25,
2025-08-26,William Stengel II,Genuine Parts,0,4,0,4,
2025-08-26,Christian Ulbrich,Jones Lang LaSalle,10,22,0,32,
2025-08-26,Raymond E Scott,Lear Corporation,6,3,0,9,
2025-08-26,Michael Rapino,Live Nation Entertainment,12,24,4,40,
2025-08-26,Heidi Petz,Sherwin-Williams,7,28,3,38,
2025-08-26,Calvin G Butler Jr,Exelon,6,4,0,10,
2025-08-26,Tony Spring,Macy's,12,25,3,40,
2025-08-26,Jeff Miller,Halliburton,12,23,5,40,
2025-08-26,Kevin Lobo,Stryker,10,26,4,40,
2025-08-26,Tony Cheng,Reinsurance of America,0,0,0,0,
2025-08-26,Ronald P O'Hanley,State Street,7,14,0,21,
2025-08-26,John Engel,WESCO International,5,11,1,17,
2025-08-26,Pierce Norton II,Oneok,4,5,0,9,
2025-08-26,Shantanu Narayen,Adobe,20,19,1,40,
2025-08-26,Bill Westrate,American Family Insurance,12,15,2,29,
2025-08-26,Chris Kubasik,L3Harris Technologies,7,13,1,21,
2025-08-26,James Conroy,Ross Stores,5,10,0,15,
2025-08-26,Christine Leahy,CDW,1,9,2,12,
2025-08-26,Saumya Sutaria,Tenet Healthcare,4,4,1,9,
2025-08-26,Bob Eddy,BJ's Wholesale Club,5,30,5,40,
2025-08-26,Mike Lyons,Fiserv,3,12,0,15,
2025-08-26,William Gifford,Altria,3,4,1,8,
2025-08-26,Larry Fink,BlackRock,7,23,10,40,
2025-08-26,Thomas Polen,Becton Dickinson,7,3,0,10,
2025-08-26,Noel Wallace,Colgate-Palmolive,10,22,2,34,
2025-08-26,Michael Hsu,Kimberly-Clark,6,6,1,13,
2025-08-26,Daryl Kenningham,1 Automotive,11,21,2,34,
2025-08-26,Jennifer Parmentier,Parker-Hannifin,2,11,0,13,
2025-08-26,Jeffrey Harmening,General Mills,4,19,4,27,
2025-08-26,Ravi Kumar S,Cognizant Technology,9,26,3,38,
2025-08-26,William Fehrman,American Electric Power,4,6,0,10,
2025-08-26,Peter Arduini,GE HealthCare Technologies,6,11,0,17,
2025-08-26,Maria Black,Automatic Data Processing,5,5,0,10,
2025-08-26,Lourenco Goncalves,Cleveland-Cliffs,7,23,10,40,
2025-08-26,Dan Amos,Aflac,12,19,9,40,
2025-08-26,Mark Stewart,Goodyear Tire & Rubber,5,32,3,40,
2025-08-26,Kevin Hogan,Corebridge Financial,4,11,0,15,
2025-08-26,Thomas Palmer,Newmont,5,5,0,10,
2025-08-26,Andrew Silvernail,International Paper,6,21,0,27,
2025-08-26,Philip Daniele III,AutoZone,0,2,0,2,
2025-08-26,Ellen Cooper,Lincoln National,2,8,0,10,
2025-08-26,Ryan Marshall,PulteGroup,13,15,11,39,
2025-08-26,James Cracchiolo,Ameriprise Financial,2,22,2,26,
2025-08-26,Andrew Clyde,Murphy USA,12,27,1,40,
2025-08-26,Jonas Prising,Manpower,9,6,1,16,
2025-08-26,David Bozeman,CH Robinson Worldwide,2,7,0,9,
2025-08-26,Timothy Knavish,PPG Industries,1,3,0,4,
2025-08-26,Pedro Pizarro,Edison International,15,8,17,40,
2025-08-26,Mark Millett,Steel Dynamics,18,2,0,20,
2025-08-26,Benjamin Tisch,Loews,2,6,0,8,
2025-08-26,Karsanbhai,Emerson Electric,8,20,2,30,
2025-08-26,John Zillmer,Aramark,7,15,2,24,
2025-08-26,William Hornbuckle,MGM Resorts International,5,24,1,30,
2025-08-26,James Burke,Vistra,7,3,0,10,
2025-08-26,David Hult,Asbury Automotive,9,30,1,40,
2025-08-26,DG Macpherson,WW Grainger,2,7,1,10,
2025-08-26,Eric Slifka,Global Partners,13,20,7,40,
2025-08-26,Bob Pragada,Jacobs Solutions,5,9,0,14,
2025-08-26,Charles Magro,Corteva,4,2,1,7,
2025-08-26,Rick Lanoha,Peter Kiewit Sons',0,2,0,2,
2025-08-26,Michael Mahoney,Boston Scientific,10,28,2,40,
2025-08-26,Brad Beckham,O'Reilly Automotive,4,16,2,22,
2025-08-26,Thomas Bell,Leidos,8,18,2,28,
2025-08-26,Thomas Gayner,Markel Group,1,9,0,10,
2025-08-26,Marc Bitzer,Whirlpool,13,11,16,40,
2025-08-26,Andrew McMahon,Guardian Life,5,15,0,20,
2025-08-26,Peter Jackson,Builders FirstSource,5,11,1,17,
2025-08-26,Michael Rhodes,Ally Financial,10,24,5,39,
2025-08-26,Matthew Meloy,Targa Resources,4,6,0,10,
2025-08-26,James Breuer,Fluor,1,1,1,3,
2025-08-26,Sasan Goodarzi,Intuit,10,26,4,40,
2025-08-26,Troy Rudd,AECOM,8,24,5,37,
2025-08-26,Penny Pennington,Edward Jones,6,29,5,40,
2025-08-26,Michael Bender,Kohl's,1,26,13,40,
2025-08-26,Beth Ford,Land O'Lakes,17,21,2,40,
2025-08-26,Deanna Strable-Soethout,Principal Financial,1,5,0,6,
2025-08-26,Robert Blue,Dominion Energy,26,10,2,38,
2025-08-26,Martin Schroeter,Kyndryl s,0,3,0,3,
2025-08-26,Jon Vander Ark,Republic Services,9,21,10,40,
2025-08-26,Clay Gaspar,Devon Energy,18,3,0,21,
2025-08-26,Christopher O'Herlihy,Illinois Tool Works,4,5,1,10,
2025-08-26,Michael O'Grady,Northern Trust,24,4,1,29,
2025-08-26,Jamie Whisnant,Auto-Owners Insurance,0,2,0,2,
2025-08-26,Marc Miller,Universal Health Services,5,23,3,31,
2025-08-26,Darryl Button,Pacific Life,0,7,0,7,
2025-08-26,Hamid Akhavan,EchoStar,3,22,8,33,
2025-08-26,Christophe Beck,Ecolab,19,21,0,40,
2025-08-26,Jack Fusco,Cheniere Energy,18,19,3,40,
2025-08-26,John Wren,Omnicom,11,20,9,40,
2025-08-26,Haviv Ilan,Texas Instruments,10,28,2,40,
2025-08-26,David Burritt,United States Steel,7,19,14,40,
2025-08-26,St√©phane de La Faverie,Est√©e Lauder,12,24,4,40,
2025-08-26,Raul Nicholas Vargas Ochoa,Farmers Insurance Exchange,0,0,0,0,
2025-08-26,Thibaut Mongon,Kenvue,9,28,3,40,
2025-08-26,Ari Bousbib,IQVIA s,0,0,0,0,
2025-08-26,Donald Allan,Stanley Black & Decker,7,31,2,40,
2025-08-26,Timothy Cofer,Keurig Dr Pepper,0,4,0,4,
2025-08-26,Matthew Flannery,United Rentals,29,2,0,31,
2025-08-26,Timothy Cawley,Consolidated Edison,5,4,0,9,
2025-08-26,Adam Norwitt,Amphenol,3,16,0,19,
2025-08-26,Brent Shafer,Baxter International,1,10,0,11,
2025-08-26,Kimberly Dang,Kinder Morgan,11,1,0,12,
2025-08-26,Erik Nordstrom,Nordstrom,6,27,5,38,
2025-08-26,Frank Holding,First Citizens BancShares,9,14,2,25,
2025-08-26,Paul Shoukry,Raymond James Financial,14,26,0,40,
2025-08-26,Timothy Archer,Lam Research,2,7,1,10,
2025-08-26,Harry Lawton III,Tractor Supply,1,1,0,2,
2025-08-26,Darren Rebelez,Casey's General Stores,15,22,3,40,
2025-08-26,Scott Smith,Viatris,7,5,0,12,
2025-08-26,James Blackledge,Mutual of Omaha Insurance,0,6,0,6,
2025-08-26,Anthony Guzzi,EMCOR,4,3,0,7,
2025-08-26,Joseph Hinrichs,CSX,6,9,1,16,
2025-08-26,Justin Jude,LKQ,4,6,1,11,
2025-08-26,Judith Marks,Otis Worldwide,2,4,0,6,
2025-08-26,David Bruton Smith,Sonic Automotive,3,10,9,22,
2025-08-26,Martina Cheung,S&P Global,11,23,0,34,
2025-08-26,Leonard Schleifer,Regeneron Pharmaceuticals,6,27,7,40,
2025-08-26,Joseph Fadool,BorgWarner,4,8,0,12,
2025-08-26,Lachlan Murdoch,Fox,5,28,7,40,
2025-08-26,Karla Lewis,Reliance,3,6,1,10,
2025-08-26,John Barrett,Western & Southern Financial,8,30,2,40,
2025-08-26,Scott Donnelly,Textron,9,26,2,37,
2025-08-26,Ariane Gorin,Expedia,8,31,1,40,
2025-08-26,Michael Nolan,Fidelity National Financial,2,0,0,2,
2025-08-26,Ernest Garcia III,Carvana,25,11,4,40,
2025-08-26,Raul Fernandez,DXC Technology,4,33,2,39,
2025-08-26,Robert Berkley,WR Berkley,8,29,3,40,
2025-08-26,Ren√© Jones,M&T Bank,12,24,4,40,
2025-08-26,Lauren Hobart,Dick's Sporting Goods,10,26,4,40,
2025-08-26,Robert Frenzel,Xcel Energy,4,3,1,8,
2025-08-26,Timothy Spence,Fifth Third Bancorp,4,4,1,9,
2025-08-26,Stephen Schwarzman,Blackstone,12,22,6,40,
2025-08-26,Walker Martin,Sempra,0,2,0,2,
2025-08-26,Timothy NeCastro,Erie Insurance,3,6,1,10,
2025-08-26,Wendell Weeks,Corning,15,23,2,40,
2025-08-26,Kathleen Johnson,Lumen Technologies,4,4,1,9,
2025-08-26,Brian Tierney,FirstEnergy,5,27,3,35,
2025-08-26,Adam Schechter,Labcorp,7,20,1,28,
2025-08-26,Tiang Yew Tan,Western Digital,2,0,0,2,
2025-08-26,Richard McKenney,Unum,5,4,0,9,
2025-08-26,Javier Rodriguez,DaVita,14,15,1,30,
2025-08-26,Steven Cahillane,Kellanova,2,7,0,9,
2025-08-26,Stanley Bergman,Henry Schein,11,28,1,40,
2025-08-26,Robert Sanchez,Ryder System,11,8,1,20,
2025-08-26,Tim Hingtgen,Community Health Systems,10,28,2,40,
2025-08-26,Avigal Soreq,Delek US,3,9,5,17,
2025-08-26,Gerardo Norcia,DTE Energy,6,3,0,9,
2025-08-26,Mark Pearson,Equitable,7,8,0,15,
2025-08-26,Lori Koch,DuPont,6,18,0,24,
2025-08-26,Rich Steinmeier,LPL Financial,25,13,2,40,
2025-08-26,Bruce Van Saun,Citizens Financial,12,27,1,40,
2025-08-26,Jos√© Mas,MasTec,6,15,1,22,
2025-08-26,Andr√©s Gluski,AES,20,20,0,40,
2025-08-26,Kevin Kwilinski,Berry Global,6,18,0,24,
2025-08-26,Mark George,Norfolk Southern,18,20,2,40,
2025-08-26,Eduardo Menezes,Air Products & Chemicals,5,4,1,10,
2025-08-26,Shelley Simpson,JB Hunt Transport Services,6,31,3,40,
2025-08-26,Daniel Fisher,Ball,2,19,5,26,
2025-08-26,Sean Connolly,Conagra Brands,7,31,2,40,
2025-08-26,Stephen Steinour,Huntington Bancshares,3,7,0,10,
2025-08-26,James Snee,Hormel Foods,2,27,1,30,
2025-08-26,Joseph Nolan,Eversource Energy,6,3,1,10,
2025-08-26,William Oplinger,Alcoa,9,19,6,34,
2025-08-26,Andrew Marsh,Entergy,2,5,0,7,
2025-08-26,Keith Demmings,Assurant,4,6,0,10,
2025-08-26,Sumit Singh,Chewy,14,21,5,40,
2025-08-26,Niraj Shah,Wayfair,7,26,7,40,
2025-08-26,Joseph Ferraro,Avis Budget,4,5,1,10,
2025-08-26,Jeffrey Sprecher,Intercontinental Exchange,15,23,2,40,
2025-08-26,Benito Minicucci,Alaska Air,3,4,1,8,
2025-08-26,Malcolm Wilson,GXO Logistics,6,22,0,28,
2025-08-26,Eric Hansotia,AGCO,17,21,1,39,
2025-08-26,Kathleen Mazzarella,Graybar Electric,1,8,0,9,
2025-08-26,Gavin Hattersley,Molson Coors Beverage,5,31,4,40,
2025-08-26,Patrick Gallagher,Arthur J Gallagher,10,29,1,40,
2025-08-26,Christopher Kastner,Huntington Ingalls Industries,3,4,1,8,
2025-08-26,Erik Fyrwald,International Flavors & Fragrances,7,9,2,18,
2025-08-26,Ricardo Cardenas,Darden Restaurants,4,3,1,8,
2025-08-26,Stephen Spray,Cincinnati Financial,2,5,3,10,
2025-08-26,Scott Boatwright,Chipotle Mexican Grill,8,28,4,40,
2025-08-26,Joey Wat,Yum China,14,24,2,40,
2025-08-26,Robert Goldstein,Las Vegas Sands,3,32,5,40,
2025-08-26,Kecia Steelman,Ulta Beauty,32,7,1,40,
2025-08-26,Thomas Reeg,Caesars Entertainment,6,5,0,11,
2025-08-26,Jon Rousseau,BrightSpring Health Services,21,18,1,40,
2025-08-26,William Krueger,Andersons,0,5,0,5,
2025-08-26,Michele Buck,Hershey,8,30,2,40,
2025-08-26,Christopher Nassetta,Hilton,13,23,4,40,
2025-08-26,Bruce Bodine,Mosaic,2,7,0,9,
2025-08-26,Brian Chesky,Airbnb,1,32,7,40,
2025-08-26,Kaes Van‚Äôt Hof,Diamondback Energy,22,15,2,39,
2025-08-26,Steven Vondran,American Tower,4,7,0,11,
2025-08-26,Reshma Kewalramani,Vertex Pharmaceuticals,22,13,5,40,
2025-08-26,William McDermott,ServiceNow,3,6,0,9,
2025-08-26,Brian Chambers,Owens Corning,3,11,1,15,
2025-08-26,Teresa Rasmussen,Thrivent Financial for Lutherans,3,2,0,5,
2025-08-26,Shane O'Kelly,Advance Auto Parts,12,24,4,40,
2025-08-26,Douglas Yearley,Toll Brothers,10,25,5,40,
2025-08-26,Jeffrey Lorberbaum,Mohawk Industries,11,5,1,17,
2025-08-26,Gregory Brown,Motorola Solutions,2,8,0,10,
2025-08-26,John Pfeifer,Oshkosh,6,24,5,35,
2025-08-26,Tony Xu,DoorDash,14,18,8,40,
2025-08-26,Edward Pesicka,Owens & Minor,4,34,2,40,
2025-08-26,Eugene Bredow,NVR,0,5,0,5,
2025-08-26,Philippe Krakowsky,Interpublic,16,21,3,40,
2025-08-26,Horacio Rozanski,Booz Allen Hamilton,16,19,5,40,
2025-08-26,Michael O‚ÄôSullivan,Burlington Stores,8,29,3,40,
2025-08-26,Daniel Wall,Expeditors International of Washington,2,5,0,7,
2025-08-26,Calvin McDonald,Lululemon athletica,8,31,1,40,
2025-08-26,Stephanie Ferris,Fidelity National Information,13,21,3,37,
2025-08-26,Rich Handler,Jefferies Financial,12,10,2,24,
2025-08-26,Alan Armstrong,Williams,24,12,4,40,
2025-08-26,Bracken Darrell,VF Corporation,10,27,3,40,
2025-08-26,Mikael Bratt,Autoliv,6,8,2,16,
2025-08-26,Rafael Santana,Westinghouse Air Brake Technologies,2,6,1,9,
2025-08-26,Ralph LaRossa,Public Service Enterprise,8,16,0,24,
2025-08-26,Jamie Iannone,Ebay,18,17,5,40,
2025-08-26,Scott Richardson,Celanese,8,28,4,40,
2025-08-26,Cameron Bready,Global Payments,8,29,3,40,
2025-08-26,Robert Thomson,News Corp,5,30,5,40,
2025-08-26,Robert Martin,THOR Industries,4,5,1,10,
2025-08-26,David Rawlinson II,QVC,7,13,2,22,
2025-08-26,Andrew Teno,Icahn Enterprises,5,6,0,11,
2025-08-26,William Newlands,Constellation Brands,0,2,2,4,
2025-08-26,James Davis,Quest Diagnostics,5,5,0,10,
2025-08-26,Richard Wallace,KLA,4,3,0,7,
2025-08-26,Julian Francis,QXO Building Products,0,0,0,0,
2025-08-26,John Christmann IV,APA,6,4,0,10,
2025-08-26,Gregory Roberts,A-Mark Precious Metals,2,4,1,7,
2025-08-26,Christopher Viehbacher,Biogen,0,30,2,32,
2025-08-26,Mick Beekhuizen,Campbell's,8,22,4,34,
2025-08-26,Christopher Caldwell,Concentrix,2,5,0,7,
2025-08-26,Todd Schneider,Cintas,13,18,1,32,
2025-08-26,Tony Sarsam,SpartanNash,19,19,2,40,
2025-08-26,John Venhuizen,Ace Hardware,14,24,2,40,
2025-08-26,Vincent Roche,Analog Devices,13,23,2,38,
2025-08-26,Mark Costa,Eastman Chemical,5,19,4,28,
2025-08-26,Milan Galik,Interactive Brokers,6,17,1,24,
2025-08-26,John Turner,Regions Financial,20,18,2,40,
2025-08-26,Joanna Geraghty,JetBlue Airways,16,17,7,40,
2025-08-26,Kristin Peck,Zoetis,12,19,1,32,
2025-08-26,Christopher Gorman,KeyCorp,4,6,0,10,
2025-08-26,Mark Bertolini,Oscar Health,12,20,8,40,
2025-08-26,Brendan McCracken,Ovintiv,6,5,0,11,
2025-08-26,Robert Steer,Seaboard,1,4,0,5,
2025-08-26,Gil West,Hertz,7,25,8,40,
2025-08-26,Robert Greenberg,Skechers,6,32,2,40,
2025-08-26,Dennis Mathew,Altice,4,29,7,40,
2025-08-26,Clay Williams,NOV,11,21,4,36,
2025-08-26,Michael Doss,Graphic Packaging,6,7,2,15,
2025-08-26,Deon Stander,Avery Dennison,0,12,0,12,
2025-08-26,Adaire Fox-Martin,Equinix,14,21,4,39,
2025-08-26,Joyce Mullen,Insight Enterprises,5,11,1,17,
2025-08-26,Jennifer Witz,Sirius XM,9,11,7,27,
2025-08-26,Stefan Larsson,PVH,11,24,5,40,
2025-08-26,Jason P Wells,CenterPoint Energy,6,4,0,10,
2025-08-26,Scott Lauber,WEC Energy,14,5,0,19,
2025-08-26,Matthew Pine,Xylem,2,9,1,12,
2025-08-26,Jennifer Johnson,Franklin Resources,2,5,2,9,
2025-08-26,Vincent Sorgi,PPL,8,9,1,18,
2025-08-26,Carl Eschenbach,Workday,10,21,9,40,
2025-08-26,Richard Tobin,Dover,4,5,1,10,
2025-08-26,Mark Kowlzan,Packaging Corp of America,0,8,1,9,
2025-08-26,Scott Salmirs,ABM Industries,6,8,1,15,
2025-08-26,Gary Guthart,Intuitive Surgical,13,24,3,40,
2025-08-26,Carl Lindner lll,American Financial,0,0,0,0,
2025-08-26,Blake Moret,Rockwell Automation,13,25,2,40,
2025-08-26,Bryan Hanson,Solventum,6,11,3,20,
2025-08-26,Craig Smiddy,Old Republic International,3,6,1,10,
2025-08-26,Christopher Hilger,Securian Financial,0,7,1,8,
2025-08-26,Hamid Moghadam,Prologis,7,28,5,40,
2025-08-26,Mark Smucker,JM Smucker,10,23,7,40,
2025-08-26,Sheryl Palmer,Taylor Morrison Home,6,12,1,19,
2025-08-26,Mario Harik,XPO,7,32,1,40,
2025-08-26,Heather Lavallee,Voya Financial,6,10,2,18,
2025-08-26,Nikesh Arora,Palo Alto Networks,8,24,8,40,
2025-08-26,Giordano Albertazzi,Vertiv s,0,1,0,1,
2025-08-26,Shankh Mitra,Welltower,16,22,2,40,
2025-08-26,Mary Dillon,Foot Locker,9,25,6,40,
2025-08-26,William Monteleone,Par Pacific,1,7,2,10,
2025-08-26,Kevin Stein,TransDigm,10,10,1,21,
2025-08-26,Peter Matt,Commercial Metals,6,3,0,9,
2025-08-26,Robert Vitale,Post s,0,0,0,0,
2025-08-26,Keith Allman,Masco,5,9,1,15,
2025-08-26,Rusty Rush,Rush Enterprises,16,21,3,40,
2025-08-26,Stuart Bradie,KBR,13,15,4,32,
2025-08-26,Jack Sinclair,Sprouts Farmers Market,15,24,1,40,
2025-08-26,Laura Alber,Williams-Sonoma,12,23,5,40,
2025-08-26,Ivan Tornos,Zimmer Biomet s,1,2,0,3,
2025-08-26,John Mengucci,CACI International,21,17,2,40,
2025-08-26,Steve Sanghi,Microchip Technology,9,27,4,40,
2025-08-26,Albert Nahmad,Watsco,2,8,0,10,
2025-08-26,Christopher Peterson,Newell Brands,2,7,1,10,
2025-08-26,Arie Kotler,ARKO,6,23,1,30,
2025-08-26,Jure Sola,Sanmina,3,13,1,17,
2025-08-26,Andrew Wilson,Electronic Arts,12,18,10,40,
2025-08-26,David Gibbs,Yum Brands,2,37,1,40,
2025-08-26,Daniel Florness,Fastenal,2,7,0,9,
2025-08-26,Garrick Rochow,CMS Energy,10,3,0,13,
2025-08-26,Rodney Sacks,Monster Beverage,14,23,2,39,
2025-08-26,Mark Shapiro,Endeavor,7,31,2,40,
2025-08-26,Toni Townes-Whitley,Science Applications International,13,20,1,34,
2025-08-26,Mark Witkowski,Core & Main,0,7,0,7,
2025-08-26,John Plant,Howmet Aerospace,4,14,1,19,
2025-08-26,James Zallie,Ingredion,4,5,1,10,
2025-08-26,Thomas Hill,Vulcan Materials,4,8,2,14,
2025-08-27,Doug McMillon,Walmart,15,19,6,40,
2025-08-27,Andrew Jassy,Amazon,5,29,6,40,
2025-08-27,Stephen Hemsley,UnitedHealth,8,26,6,40,
2025-08-27,Tim Cook,Apple,18,17,5,40,
2025-08-27,David Joyner,CVS Health,9,27,4,40,
2025-08-27,Warren Buffett,Berkshire Hathaway,9,19,12,40,
2025-08-27,Sundar Pichai,Alphabet,15,17,8,40,
2025-08-27,Darren Woods,Exxon Mobil,12,22,6,40,
2025-08-27,Brian Tyler,McKesson,4,16,5,25,
2025-08-27,Robert Mauch,Cencora,3,7,0,10,
2025-08-27,Jamie Dimon,JPMorgan Chase,9,18,13,40,
2025-08-27,Ron Vachris,Costco,7,31,2,40,
2025-08-27,David Cordani,Cigna,21,15,4,40,
2025-08-27,Satya Nadella,Microsoft,15,16,9,40,
2025-08-27,Jason Hollar,Cardinal Health,14,22,4,40,
2025-08-27,Mike Wirth,Chevron,16,16,8,40,
2025-08-27,Brian Moynihan,Bank of America,7,26,7,40,
2025-08-27,Mary Barra,General Motors,13,23,4,40,
2025-08-27,Jim Farley,Ford Motor,10,23,7,40,
2025-08-27,Gail Boudreaux,Elevance Health,15,18,7,40,
2025-08-27,Jane Fraser,Citigroup,12,22,6,40,
2025-08-27,Mark Zuckerberg,Meta,13,22,5,40,
2025-08-27,Sarah London,Centene,13,18,9,40,
2025-08-27,Ted Decker,Home Depot,10,24,6,40,
2025-08-27,Priscilla Almodovar,Fannie Mae,11,19,10,40,
2025-08-27,Tim Wentworth,Walgreens,8,22,9,39,
2025-08-27,Ron Sargent,Kroger,5,20,15,40,
2025-08-27,Mark Lashier,Phillips 66,10,21,7,38,
2025-08-27,Maryann Mannen,Marathon Petroleum,6,12,1,19,
2025-08-27,Hans Vestberg,Verizon,15,21,4,40,
2025-08-27,Jensen Huang,Nvidia,6,31,3,40,
2025-08-27,David Solomon,Goldman Sachs,7,22,11,40,
2025-08-27,Charles Scharf,Wells Fargo,28,6,6,40,
2025-08-27,Lane Riggs,Valero Energy,14,8,0,22,
2025-08-27,Brian Roberts,Comcast,10,27,3,40,
2025-08-27,Jon Farney,State Farm,9,27,4,40,
2025-08-27,John Stankey,AT&T,9,27,3,39,
2025-08-27,Michael Hutchins,Freddie Mac,3,12,3,18,
2025-08-27,Jim Rechtin,Humana,18,18,4,40,
2025-08-27,Ted Pick,Morgan Stanley,16,22,2,40,
2025-08-27,Michael Fiddelke,Target,9,22,9,40,
2025-08-27,Philip Smith,StoneX,0,10,1,11,
2025-08-27,Elon Musk,Tesla,9,19,12,40,
2025-08-27,Michael Dell,Dell Technologies,10,25,5,40,
2025-08-27,Ramon Laguarta,PepsiCo,6,28,6,40,
2025-08-27,Bob Iger,Walt Disney,7,30,3,40,
2025-08-27,Carol Tom√©,UPS,8,21,11,40,
2025-08-27,Joaquin Duato,Johnson & Johnson,10,25,5,40,
2025-08-27,Rajesh Subramaniam,FedEx,10,26,0,36,
2025-08-27,Juan Luciano,Archer Daniels Midland,3,21,14,38,
2025-08-27,Jon Moeller,Procter & Gamble,5,29,6,40,
2025-08-27,Marvin Ellison,Lowe's,16,19,5,40,
2025-08-27,Thomas Long,Energy Transfer,8,0,2,10,
2025-08-27,Christopher Calio,RTX,7,12,0,19,
2025-08-27,Susan Morris,Albertsons,12,25,3,40,
2025-08-27,Kevin Hourican,Sysco,9,28,3,40,
2025-08-27,Tricia Griffith,Progressive,12,22,4,38,
2025-08-27,Stephen Squeri,American Express,14,24,2,40,
2025-08-27,James Taiclet,Lockheed Martin,12,17,11,40,
2025-08-27,Michel Khalaf,MetLife,12,18,0,30,
2025-08-27,Samuel Hazen,HCA Healthcare,9,5,0,14,
2025-08-27,Andrew Sullivan,Prudential Financial,13,22,0,35,
2025-08-27,Kelly Ortberg,Boeing,10,25,5,40,
2025-08-27,Joe Creed,Caterpillar,11,26,3,40,
2025-08-27,Robert M Davis,Merck,4,20,0,24,
2025-08-27,Thomas J Wilson,Allstate,0,9,1,10,
2025-08-27,Albert Bourla,Pfizer,18,13,9,40,
2025-08-27,Arvind Krishna,IBM,13,22,5,40,
2025-08-27,Craig DeSanto,New York Life Insurance,3,17,0,20,
2025-08-27,Ed Bastian,Delta Airlines,16,14,9,39,
2025-08-27,Kevin Murphy,Ferguson Enterprises,2,14,2,18,
2025-08-27,Kirt Walker,Nationwide,14,17,2,33,
2025-08-27,Patrick Zammit,TD Synnex,11,16,0,27,
2025-08-27,Scott Kirby,United Airlines,33,4,3,40,
2025-08-27,Ryan Lance,ConocoPhillips,18,19,3,40,
2025-08-27,Ernie Herrman,TJX,15,23,2,40,
2025-08-27,Bob Michael,AbbVie,0,0,0,0,
2025-08-27,AJ Jim Teague,Enterprise Products Partners,4,7,0,11,
2025-08-27,Christopher Winfrey,Charter Communications,5,15,5,25,
2025-08-27,George Holm,Performance Food,11,21,2,34,
2025-08-27,Robert Isom,American Airlines,8,25,7,40,
2025-08-27,Richard Fairbank,Capital One,15,21,4,40,
2025-08-27,Chuck Robbins,Cisco Systems,13,24,3,40,
2025-08-27,Enrique Lores,HP,13,22,5,40,
2025-08-27,Donnie King,Tyson Foods,11,25,4,40,
2025-08-27,Lip-Bu Tan,Intel,12,15,13,40,
2025-08-27,Safra Catz,Oracle,10,23,7,40,
2025-08-27,Hock Tan,Broadcom,11,24,5,40,
2025-08-27,John May,Deere,9,26,5,40,
2025-08-27,Elliott Hill,Nike,9,29,2,40,
2025-08-27,Timothy M Sweeney,Liberty Mutual Insurance,14,0,0,14,
2025-08-27,Wilfred Chiang,Plains GP,1,1,0,2,
2025-08-27,Juan Andrade,USAA,5,16,0,21,
2025-08-27,Chris Boerner,Bristol-Myers Squibb,10,23,7,40,
2025-08-27,Paul Bay,Ingram Micro,12,24,4,40,
2025-08-27,Phebe Novakovic,General Dynamics,28,9,3,40,
2025-08-27,James Quincey,Coca-Cola,12,25,3,40,
2025-08-27,Thasunda Brown Duckett,TIAA,21,19,0,40,
2025-08-27,Alan Schnitzer,Travelers,16,17,7,40,
2025-08-27,David Ricks,Eli Lilly,11,20,9,40,
2025-08-27,Dara Khosrowshahi,Uber,12,23,5,40,
2025-08-27,Roger Crandall,Mass Mutual,2,7,0,9,
2025-08-27,Marc Casper,Thermo Fisher Scientific,16,22,2,40,
2025-08-27,Gunjan Kedia,US Bancorp,13,25,2,40,
2025-08-27,Michael Kasbar,World Kinect,1,10,0,11,
2025-08-27,Robert Ford,Abbott Laboratories,12,23,5,40,
2025-08-27,Corie Barry,Best Buy,39,1,0,40,
2025-08-27,Tim Gerend,Northwestern Mutual,13,26,1,40,
2025-08-27,Kathy Warden,Northrop Grumman,16,20,4,40,
2025-08-27,Joe Zubretsky,Molina Healthcare,9,7,4,20,
2025-08-27,Todd Vasos,Dollar General,6,25,9,40,
2025-08-27,Robin Vince,Bank of New York,19,18,3,40,
2025-08-27,David Zaslav,Warner Bros Discovery,6,23,10,39,
2025-08-27,Jay Debertin,CHS,3,9,4,16,
2025-08-27,Ted Sarandos,Netflix,14,24,2,40,
2025-08-27,Cristiano Amon,Qualcomm,12,27,1,40,
2025-08-27,Larry Culp,General Electric,12,25,3,40,
2025-08-27,Vimal Kapur,Honeywell,11,29,0,40,
2025-08-27,Marc Benioff,Salesforce,10,23,7,40,
2025-08-27,Jacek Olczak,Philip Morris,14,22,4,40,
2025-08-27,David Flitman,US Foods,2,7,0,9,
2025-08-27,Paul Romanowski,DR Horton,5,16,4,25,
2025-08-27,Bryan DeBoer,Lithia Motors,11,27,1,39,
2025-08-27,Dirk Van de Put,Mondelez,10,27,3,40,
2025-08-27,Brian Niccol,Starbucks,9,31,0,40,
2025-08-27,Ryan McInerney,Visa,16,19,5,40,
2025-08-27,Robert Sulentic,CBRE,1,7,1,9,
2025-08-27,Jonathan Jaffe,Lennar,0,9,1,10,
2025-08-27,Scott Strazik,GE Vernova,15,22,3,40,
2025-08-27,William Demchak,PNC,15,21,4,40,
2025-08-27,Jennifer Rumsey,Cummins,9,25,6,40,
2025-08-27,Preston Feight,Paccar,7,26,1,34,
2025-08-27,Robert Bradway,Amgen,9,29,2,40,
2025-08-27,Matthew Lucey,PBF Energy,6,2,0,8,
2025-08-27,Pat Geraghty,GuideWell Mutual,2,6,0,8,
2025-08-27,Alex Chriss,PayPal,12,25,3,40,
2025-08-27,Sandy Douglas,United Natural Foods,33,5,2,40,
2025-08-27,Michael Creedon,Dollar Tree,3,35,2,40,
2025-08-27,Leon Topalian,Nucor,17,21,2,40,
2025-08-27,Roger Penske,Penske Automotive,15,24,1,40,
2025-08-27,Bom Kim,Coupang,12,27,1,40,
2025-08-27,Antonio Neri,Hewlett Packard,9,23,8,40,
2025-08-27,Harry Sideris,Duke Energy,35,5,0,40,
2025-08-27,Joseph Bae,KKR,19,19,2,40,
2025-08-27,Brian Robbins,Paramount Global,7,28,1,36,
2025-08-27,Michael Dastoor,Jabil,2,8,0,10,
2025-08-27,Daniel O'Day,Gilead Sciences,19,17,4,40,
2025-08-27,Tim Go,HF Sinclair,6,3,0,9,
2025-08-27,William Nash,CarMax,3,4,2,9,
2025-08-27,Michael Miebach,Mastercard,11,25,4,40,
2025-08-27,Lawrence Coben,NRG Energy,5,2,0,7,
2025-08-27,Sean Kerins,Arrow Electronics,1,15,0,16,
2025-08-27,Lorenzo Simonelli,Baker Hughes,15,21,4,40,
2025-08-27,Bob Jordan,Southwest Airlines,10,24,6,40,
2025-08-27,Peter Zaffino,American International,11,26,3,40,
2025-08-27,Gary Dickerson,Applied Materials,8,21,11,40,
2025-08-27,Vicki Hollub,Occidental Petroleum,20,15,4,39,
2025-08-27,Michael Manley,AutoNation,3,6,1,10,
2025-08-27,Christopher Womack,Southern Company,1,8,0,9,
2025-08-27,Christopher Swift,Hartford Insurance,5,4,1,10,
2025-08-27,Marc Rowan,Apollo Global Management,19,17,4,40,
2025-08-27,Rick Wurster,Charles Schwab,14,21,4,39,
2025-08-27,Chris Kempczinski,McDonald's,12,19,9,40,
2025-08-27,Carlos Abrams-Rivera,Kraft Heinz,15,18,7,40,
2025-08-27,Lisa Su,Advanced Micro Devices,18,18,4,40,
2025-08-27,William H Rogers Jr,Truist Financial,2,6,1,9,
2025-08-27,Kathleen Quirk,Freeport-McMoRan,14,17,2,33,
2025-08-27,Sanjay Mehrotra,Micron Technology,17,21,2,40,
2025-08-27,Anthony Capuano,Marriott International,12,25,3,40,
2025-08-27,David Gitlin,Carrier Global,13,25,2,40,
2025-08-27,John Ketchum,NextEra Energy,23,17,0,40,
2025-08-27,William M Brown,3M,2,8,0,10,
2025-08-27,John Doyle,Marsh & McLennan,10,7,0,17,
2025-08-27,Patricia Poppe,PG&E,8,16,2,26,
2025-08-27,Jim Vena,Union Pacific,20,20,0,40,
2025-08-27,Brian Doubles,Synchrony Financial,4,7,2,13,
2025-08-27,Rainer Blair,Danaher,6,15,2,23,
2025-08-27,Philip Gallagher,Avnet,1,4,0,5,
2025-08-27,Glenn Fogel,Booking s,0,4,1,5,
2025-08-27,Ezra Yacob,EOG Resources,22,12,2,36,
2025-08-27,Earl Austin,Quanta Services,2,6,2,10,
2025-08-27,Michael Shepherd,Discover Financial,8,15,2,25,
2025-08-27,Joseph Dominguez,Constellation Energy,12,11,1,24,
2025-08-27,William Stengel II,Genuine Parts,0,4,0,4,
2025-08-27,Christian Ulbrich,Jones Lang LaSalle,9,22,0,31,
2025-08-27,Raymond E Scott,Lear Corporation,6,3,0,9,
2025-08-27,Michael Rapino,Live Nation Entertainment,15,22,3,40,
2025-08-27,Heidi Petz,Sherwin-Williams,7,28,3,38,
2025-08-27,Calvin G Butler Jr,Exelon,6,4,0,10,
2025-08-27,Tony Spring,Macy's,12,25,3,40,
2025-08-27,Jeff Miller,Halliburton,11,24,5,40,
2025-08-27,Kevin Lobo,Stryker,11,25,4,40,
2025-08-27,Tony Cheng,Reinsurance of America,0,0,0,0,
2025-08-27,Ronald P O'Hanley,State Street,7,14,0,21,
2025-08-27,John Engel,WESCO International,6,11,1,18,
2025-08-27,Pierce Norton II,Oneok,4,4,0,8,
2025-08-27,Shantanu Narayen,Adobe,19,20,1,40,
2025-08-27,Bill Westrate,American Family Insurance,12,16,2,30,
2025-08-27,Chris Kubasik,L3Harris Technologies,8,13,1,22,
2025-08-27,James Conroy,Ross Stores,5,10,0,15,
2025-08-27,Christine Leahy,CDW,1,11,2,14,
2025-08-27,Saumya Sutaria,Tenet Healthcare,4,4,1,9,
2025-08-27,Bob Eddy,BJ's Wholesale Club,5,31,4,40,
2025-08-27,Mike Lyons,Fiserv,4,11,1,16,
2025-08-27,William Gifford,Altria,3,4,1,8,
2025-08-27,Larry Fink,BlackRock,7,25,8,40,
2025-08-27,Thomas Polen,Becton Dickinson,7,3,0,10,
2025-08-27,Noel Wallace,Colgate-Palmolive,10,22,2,34,
2025-08-27,Michael Hsu,Kimberly-Clark,6,7,1,14,
2025-08-27,Daryl Kenningham,1 Automotive,11,22,2,35,
2025-08-27,Jennifer Parmentier,Parker-Hannifin,2,11,0,13,
2025-08-27,Jeffrey Harmening,General Mills,5,17,5,27,
2025-08-27,Ravi Kumar S,Cognizant Technology,10,27,3,40,
2025-08-27,William Fehrman,American Electric Power,3,7,0,10,
2025-08-27,Peter Arduini,GE HealthCare Technologies,6,11,0,17,
2025-08-27,Maria Black,Automatic Data Processing,5,5,0,10,
2025-08-27,Lourenco Goncalves,Cleveland-Cliffs,7,23,10,40,
2025-08-27,Dan Amos,Aflac,13,20,7,40,
2025-08-27,Mark Stewart,Goodyear Tire & Rubber,3,34,3,40,
2025-08-27,Kevin Hogan,Corebridge Financial,4,10,0,14,
2025-08-27,Thomas Palmer,Newmont,5,5,0,10,
2025-08-27,Andrew Silvernail,International Paper,6,20,0,26,
2025-08-27,Philip Daniele III,AutoZone,0,2,0,2,
2025-08-27,Ellen Cooper,Lincoln National,3,7,0,10,
2025-08-27,Ryan Marshall,PulteGroup,14,14,11,39,
2025-08-27,James Cracchiolo,Ameriprise Financial,2,23,2,27,
2025-08-27,Andrew Clyde,Murphy USA,13,26,1,40,
2025-08-27,Jonas Prising,Manpower,8,7,1,16,
2025-08-27,David Bozeman,CH Robinson Worldwide,2,7,0,9,
2025-08-27,Timothy Knavish,PPG Industries,1,3,0,4,
2025-08-27,Pedro Pizarro,Edison International,14,9,17,40,
2025-08-27,Mark Millett,Steel Dynamics,18,2,0,20,
2025-08-27,Benjamin Tisch,Loews,2,7,0,9,
2025-08-27,Karsanbhai,Emerson Electric,8,20,2,30,
2025-08-27,John Zillmer,Aramark,6,15,2,23,
2025-08-27,William Hornbuckle,MGM Resorts International,5,24,1,30,
2025-08-27,James Burke,Vistra,6,4,0,10,
2025-08-27,David Hult,Asbury Automotive,9,30,1,40,
2025-08-27,DG Macpherson,WW Grainger,2,8,1,11,
2025-08-27,Eric Slifka,Global Partners,13,21,6,40,
2025-08-27,Bob Pragada,Jacobs Solutions,6,7,0,13,
2025-08-27,Charles Magro,Corteva,3,2,1,6,
2025-08-27,Rick Lanoha,Peter Kiewit Sons',0,2,0,2,
2025-08-27,Michael Mahoney,Boston Scientific,10,28,2,40,
2025-08-27,Brad Beckham,O'Reilly Automotive,4,15,1,20,
2025-08-27,Thomas Bell,Leidos,8,17,2,27,
2025-08-27,Thomas Gayner,Markel Group,2,8,0,10,
2025-08-27,Marc Bitzer,Whirlpool,13,12,15,40,
2025-08-27,Andrew McMahon,Guardian Life,4,15,0,19,
2025-08-27,Peter Jackson,Builders FirstSource,5,12,1,18,
2025-08-27,Michael Rhodes,Ally Financial,11,24,5,40,
2025-08-27,Matthew Meloy,Targa Resources,4,6,0,10,
2025-08-27,James Breuer,Fluor,1,1,1,3,
2025-08-27,Sasan Goodarzi,Intuit,8,28,4,40,
2025-08-27,Troy Rudd,AECOM,8,24,5,37,
2025-08-27,Penny Pennington,Edward Jones,6,29,5,40,
2025-08-27,Michael Bender,Kohl's,2,26,12,40,
2025-08-27,Beth Ford,Land O'Lakes,16,22,2,40,
2025-08-27,Deanna Strable-Soethout,Principal Financial,1,5,0,6,
2025-08-27,Robert Blue,Dominion Energy,26,10,2,38,
2025-08-27,Martin Schroeter,Kyndryl s,0,4,0,4,
2025-08-27,Jon Vander Ark,Republic Services,10,18,12,40,
2025-08-27,Clay Gaspar,Devon Energy,20,3,0,23,
2025-08-27,Christopher O'Herlihy,Illinois Tool Works,4,5,1,10,
2025-08-27,Michael O'Grady,Northern Trust,23,4,1,28,
2025-08-27,Jamie Whisnant,Auto-Owners Insurance,0,2,0,2,
2025-08-27,Marc Miller,Universal Health Services,5,22,3,30,
2025-08-27,Darryl Button,Pacific Life,1,6,0,7,
2025-08-27,Hamid Akhavan,EchoStar,3,25,12,40,
2025-08-27,Christophe Beck,Ecolab,19,21,0,40,
2025-08-27,Jack Fusco,Cheniere Energy,18,19,3,40,
2025-08-27,John Wren,Omnicom,9,21,10,40,
2025-08-27,Haviv Ilan,Texas Instruments,11,27,2,40,
2025-08-27,David Burritt,United States Steel,8,18,14,40,
2025-08-27,St√©phane de La Faverie,Est√©e Lauder,13,21,6,40,
2025-08-27,Raul Nicholas Vargas Ochoa,Farmers Insurance Exchange,0,0,0,0,
2025-08-27,Thibaut Mongon,Kenvue,8,30,2,40,
2025-08-27,Ari Bousbib,IQVIA s,0,0,0,0,
2025-08-27,Donald Allan,Stanley Black & Decker,6,32,2,40,
2025-08-27,Timothy Cofer,Keurig Dr Pepper,2,7,1,10,
2025-08-27,Matthew Flannery,United Rentals,29,2,0,31,
2025-08-27,Timothy Cawley,Consolidated Edison,5,4,0,9,
2025-08-27,Adam Norwitt,Amphenol,3,17,0,20,
2025-08-27,Brent Shafer,Baxter International,1,9,0,10,
2025-08-27,Kimberly Dang,Kinder Morgan,11,1,0,12,
2025-08-27,Erik Nordstrom,Nordstrom,6,28,5,39,
2025-08-27,Frank Holding,First Citizens BancShares,9,14,2,25,
2025-08-27,Paul Shoukry,Raymond James Financial,14,26,0,40,
2025-08-27,Timothy Archer,Lam Research,3,7,0,10,
2025-08-27,Harry Lawton III,Tractor Supply,1,2,0,3,
2025-08-27,Darren Rebelez,Casey's General Stores,15,22,3,40,
2025-08-27,Scott Smith,Viatris,6,4,0,10,
2025-08-27,James Blackledge,Mutual of Omaha Insurance,0,6,0,6,
2025-08-27,Anthony Guzzi,EMCOR,3,3,0,6,
2025-08-27,Joseph Hinrichs,CSX,7,10,1,18,
2025-08-27,Justin Jude,LKQ,4,6,1,11,
2025-08-27,Judith Marks,Otis Worldwide,2,3,0,5,
2025-08-27,David Bruton Smith,Sonic Automotive,3,9,9,21,
2025-08-27,Martina Cheung,S&P Global,11,26,0,37,
2025-08-27,Leonard Schleifer,Regeneron Pharmaceuticals,6,27,7,40,
2025-08-27,Joseph Fadool,BorgWarner,4,9,0,13,
2025-08-27,Lachlan Murdoch,Fox,5,28,7,40,
2025-08-27,Karla Lewis,Reliance,4,5,0,9,
2025-08-27,John Barrett,Western & Southern Financial,10,28,2,40,
2025-08-27,Scott Donnelly,Textron,9,28,3,40,
2025-08-27,Ariane Gorin,Expedia,8,31,1,40,
2025-08-27,Michael Nolan,Fidelity National Financial,2,0,0,2,
2025-08-27,Ernest Garcia III,Carvana,24,12,4,40,
2025-08-27,Raul Fernandez,DXC Technology,2,34,2,38,
2025-08-27,Robert Berkley,WR Berkley,8,29,3,40,
2025-08-27,Ren√© Jones,M&T Bank,13,23,4,40,
2025-08-27,Lauren Hobart,Dick's Sporting Goods,12,24,4,40,
2025-08-27,Robert Frenzel,Xcel Energy,5,2,1,8,
2025-08-27,Timothy Spence,Fifth Third Bancorp,0,0,0,0,
2025-08-27,Stephen Schwarzman,Blackstone,17,18,5,40,
2025-08-27,Walker Martin,Sempra,0,3,0,3,
2025-08-27,Timothy NeCastro,Erie Insurance,2,7,1,10,
2025-08-27,Wendell Weeks,Corning,15,23,2,40,
2025-08-27,Kathleen Johnson,Lumen Technologies,3,5,1,9,
2025-08-27,Brian Tierney,FirstEnergy,5,25,3,33,
2025-08-27,Adam Schechter,Labcorp,8,20,1,29,
2025-08-27,Tiang Yew Tan,Western Digital,1,2,0,3,
2025-08-27,Richard McKenney,Unum,5,4,0,9,
2025-08-27,Javier Rodriguez,DaVita,14,15,1,30,
2025-08-27,Steven Cahillane,Kellanova,2,7,0,9,
2025-08-27,Stanley Bergman,Henry Schein,11,28,1,40,
2025-08-27,Robert Sanchez,Ryder System,10,8,1,19,
2025-08-27,Tim Hingtgen,Community Health Systems,10,28,2,40,
2025-08-27,Avigal Soreq,Delek US,3,9,5,17,
2025-08-27,Gerardo Norcia,DTE Energy,6,3,0,9,
2025-08-27,Mark Pearson,Equitable,9,8,0,17,
2025-08-27,Lori Koch,DuPont,6,18,0,24,
2025-08-27,Rich Steinmeier,LPL Financial,24,14,2,40,
2025-08-27,Bruce Van Saun,Citizens Financial,12,26,2,40,
2025-08-27,Jos√© Mas,MasTec,6,15,1,22,
2025-08-27,Andr√©s Gluski,AES,19,21,0,40,
2025-08-27,Kevin Kwilinski,Berry Global,6,18,0,24,
2025-08-27,Mark George,Norfolk Southern,18,20,2,40,
2025-08-27,Eduardo Menezes,Air Products & Chemicals,5,4,1,10,
2025-08-27,Shelley Simpson,JB Hunt Transport Services,7,30,3,40,
2025-08-27,Daniel Fisher,Ball,1,21,5,27,
2025-08-27,Sean Connolly,Conagra Brands,7,31,2,40,
2025-08-27,Stephen Steinour,Huntington Bancshares,2,8,0,10,
2025-08-27,James Snee,Hormel Foods,3,26,1,30,
2025-08-27,Joseph Nolan,Eversource Energy,6,3,1,10,
2025-08-27,William Oplinger,Alcoa,9,17,6,32,
2025-08-27,Andrew Marsh,Entergy,3,5,0,8,
2025-08-27,Keith Demmings,Assurant,4,7,0,11,
2025-08-27,Sumit Singh,Chewy,12,22,6,40,
2025-08-27,Niraj Shah,Wayfair,8,25,7,40,
2025-08-27,Joseph Ferraro,Avis Budget,2,7,1,10,
2025-08-27,Jeffrey Sprecher,Intercontinental Exchange,15,23,2,40,
2025-08-27,Benito Minicucci,Alaska Air,3,3,1,7,
2025-08-27,Malcolm Wilson,GXO Logistics,7,22,0,29,
2025-08-27,Eric Hansotia,AGCO,15,22,1,38,
2025-08-27,Kathleen Mazzarella,Graybar Electric,1,9,0,10,
2025-08-27,Gavin Hattersley,Molson Coors Beverage,5,31,4,40,
2025-08-27,Patrick Gallagher,Arthur J Gallagher,9,29,2,40,
2025-08-27,Christopher Kastner,Huntington Ingalls Industries,3,4,1,8,
2025-08-27,Erik Fyrwald,International Flavors & Fragrances,8,8,2,18,
2025-08-27,Ricardo Cardenas,Darden Restaurants,4,3,1,8,
2025-08-27,Stephen Spray,Cincinnati Financial,1,6,3,10,
2025-08-27,Scott Boatwright,Chipotle Mexican Grill,8,28,4,40,
2025-08-27,Joey Wat,Yum China,14,24,2,40,
2025-08-27,Robert Goldstein,Las Vegas Sands,3,32,5,40,
2025-08-27,Kecia Steelman,Ulta Beauty,33,6,1,40,
2025-08-27,Thomas Reeg,Caesars Entertainment,6,5,0,11,
2025-08-27,Jon Rousseau,BrightSpring Health Services,20,19,1,40,
2025-08-27,William Krueger,Andersons,0,5,0,5,
2025-08-27,Michele Buck,Hershey,7,31,2,40,
2025-08-27,Christopher Nassetta,Hilton,13,23,4,40,
2025-08-27,Bruce Bodine,Mosaic,2,7,0,9,
2025-08-27,Brian Chesky,Airbnb,3,30,7,40,
2025-08-27,Kaes Van‚Äôt Hof,Diamondback Energy,22,15,2,39,
2025-08-27,Steven Vondran,American Tower,4,6,0,10,
2025-08-27,Reshma Kewalramani,Vertex Pharmaceuticals,21,14,5,40,
2025-08-27,William McDermott,ServiceNow,4,5,0,9,
2025-08-27,Brian Chambers,Owens Corning,3,11,1,15,
2025-08-27,Teresa Rasmussen,Thrivent Financial for Lutherans,3,2,0,5,
2025-08-27,Shane O'Kelly,Advance Auto Parts,14,21,5,40,
2025-08-27,Douglas Yearley,Toll Brothers,10,25,5,40,
2025-08-27,Jeffrey Lorberbaum,Mohawk Industries,11,6,1,18,
2025-08-27,Gregory Brown,Motorola Solutions,2,8,0,10,
2025-08-27,John Pfeifer,Oshkosh,6,24,5,35,
2025-08-27,Tony Xu,DoorDash,14,18,8,40,
2025-08-27,Edward Pesicka,Owens & Minor,4,34,2,40,
2025-08-27,Eugene Bredow,NVR,0,4,0,4,
2025-08-27,Philippe Krakowsky,Interpublic,16,21,3,40,
2025-08-27,Horacio Rozanski,Booz Allen Hamilton,15,20,5,40,
2025-08-27,Michael O‚ÄôSullivan,Burlington Stores,7,30,3,40,
2025-08-27,Daniel Wall,Expeditors International of Washington,2,5,0,7,
2025-08-27,Calvin McDonald,Lululemon athletica,8,31,1,40,
2025-08-27,Stephanie Ferris,Fidelity National Information,13,21,4,38,
2025-08-27,Rich Handler,Jefferies Financial,12,9,2,23,
2025-08-27,Alan Armstrong,Williams,24,12,4,40,
2025-08-27,Bracken Darrell,VF Corporation,8,28,4,40,
2025-08-27,Mikael Bratt,Autoliv,6,8,2,16,
2025-08-27,Rafael Santana,Westinghouse Air Brake Technologies,3,6,1,10,
2025-08-27,Ralph LaRossa,Public Service Enterprise,8,16,0,24,
2025-08-27,Jamie Iannone,Ebay,20,16,4,40,
2025-08-27,Scott Richardson,Celanese,9,26,5,40,
2025-08-27,Cameron Bready,Global Payments,8,29,3,40,
2025-08-27,Robert Thomson,News Corp,7,28,5,40,
2025-08-27,Robert Martin,THOR Industries,4,5,1,10,
2025-08-27,David Rawlinson II,QVC,7,15,2,24,
2025-08-27,Andrew Teno,Icahn Enterprises,5,6,0,11,
2025-08-27,William Newlands,Constellation Brands,0,2,2,4,
2025-08-27,James Davis,Quest Diagnostics,4,5,1,10,
2025-08-27,Richard Wallace,KLA,3,3,0,6,
2025-08-27,Julian Francis,QXO Building Products,0,0,0,0,
2025-08-27,John Christmann IV,APA,6,4,0,10,
2025-08-27,Gregory Roberts,A-Mark Precious Metals,2,4,1,7,
2025-08-27,Christopher Viehbacher,Biogen,0,29,2,31,
2025-08-27,Mick Beekhuizen,Campbell's,8,22,4,34,
2025-08-27,Christopher Caldwell,Concentrix,2,6,0,8,
2025-08-27,Todd Schneider,Cintas,12,18,1,31,
2025-08-27,Tony Sarsam,SpartanNash,20,18,2,40,
2025-08-27,John Venhuizen,Ace Hardware,14,24,2,40,
2025-08-27,Vincent Roche,Analog Devices,12,26,2,40,
2025-08-27,Mark Costa,Eastman Chemical,5,18,4,27,
2025-08-27,Milan Galik,Interactive Brokers,6,17,1,24,
2025-08-27,John Turner,Regions Financial,20,18,2,40,
2025-08-27,Joanna Geraghty,JetBlue Airways,16,17,7,40,
2025-08-27,Kristin Peck,Zoetis,12,19,1,32,
2025-08-27,Christopher Gorman,KeyCorp,5,5,0,10,
2025-08-27,Mark Bertolini,Oscar Health,11,20,9,40,
2025-08-27,Brendan McCracken,Ovintiv,5,5,0,10,
2025-08-27,Robert Steer,Seaboard,0,4,0,4,
2025-08-27,Gil West,Hertz,7,25,8,40,
2025-08-27,Robert Greenberg,Skechers,6,32,2,40,
2025-08-27,Dennis Mathew,Altice,5,28,7,40,
2025-08-27,Clay Williams,NOV,11,21,4,36,
2025-08-27,Michael Doss,Graphic Packaging,6,8,1,15,
2025-08-27,Deon Stander,Avery Dennison,0,12,0,12,
2025-08-27,Adaire Fox-Martin,Equinix,14,22,4,40,
2025-08-27,Joyce Mullen,Insight Enterprises,5,11,1,17,
2025-08-27,Jennifer Witz,Sirius XM,9,12,5,26,
2025-08-27,Stefan Larsson,PVH,11,24,5,40,
2025-08-27,Jason P Wells,CenterPoint Energy,8,4,1,13,
2025-08-27,Scott Lauber,WEC Energy,15,5,0,20,
2025-08-27,Matthew Pine,Xylem,2,10,1,13,
2025-08-27,Jennifer Johnson,Franklin Resources,2,4,2,8,
2025-08-27,Vincent Sorgi,PPL,8,9,1,18,
2025-08-27,Carl Eschenbach,Workday,11,20,9,40,
2025-08-27,Richard Tobin,Dover,4,5,1,10,
2025-08-27,Mark Kowlzan,Packaging Corp of America,0,9,1,10,
2025-08-27,Scott Salmirs,ABM Industries,6,8,1,15,
2025-08-27,Gary Guthart,Intuitive Surgical,12,25,3,40,
2025-08-27,Carl Lindner lll,American Financial,0,0,0,0,
2025-08-27,Blake Moret,Rockwell Automation,13,25,2,40,
2025-08-27,Bryan Hanson,Solventum,6,12,2,20,
2025-08-27,Craig Smiddy,Old Republic International,2,6,1,9,
2025-08-27,Christopher Hilger,Securian Financial,0,8,1,9,
2025-08-27,Hamid Moghadam,Prologis,7,27,6,40,
2025-08-27,Mark Smucker,JM Smucker,9,24,7,40,
2025-08-27,Sheryl Palmer,Taylor Morrison Home,6,12,1,19,
2025-08-27,Mario Harik,XPO,7,32,1,40,
2025-08-27,Heather Lavallee,Voya Financial,7,9,2,18,
2025-08-27,Nikesh Arora,Palo Alto Networks,6,26,8,40,
2025-08-27,Giordano Albertazzi,Vertiv s,0,1,0,1,
2025-08-27,Shankh Mitra,Welltower,16,22,2,40,
2025-08-27,Mary Dillon,Foot Locker,9,25,6,40,
2025-08-27,William Monteleone,Par Pacific,1,7,2,10,
2025-08-27,Kevin Stein,TransDigm,10,10,2,22,
2025-08-27,Peter Matt,Commercial Metals,6,3,0,9,
2025-08-27,Robert Vitale,Post s,0,0,0,0,
2025-08-27,Keith Allman,Masco,5,9,1,15,
2025-08-27,Rusty Rush,Rush Enterprises,15,22,3,40,
2025-08-27,Stuart Bradie,KBR,13,16,4,33,
2025-08-27,Jack Sinclair,Sprouts Farmers Market,16,23,1,40,
2025-08-27,Laura Alber,Williams-Sonoma,14,21,5,40,
2025-08-27,Ivan Tornos,Zimmer Biomet s,1,2,0,3,
2025-08-27,John Mengucci,CACI International,21,17,2,40,
2025-08-27,Steve Sanghi,Microchip Technology,9,27,4,40,
2025-08-27,Albert Nahmad,Watsco,2,8,0,10,
2025-08-27,Christopher Peterson,Newell Brands,1,7,2,10,
2025-08-27,Arie Kotler,ARKO,6,23,0,29,
2025-08-27,Jure Sola,Sanmina,3,11,1,15,
2025-08-27,Andrew Wilson,Electronic Arts,12,19,9,40,
2025-08-27,David Gibbs,Yum Brands,2,37,1,40,
2025-08-27,Daniel Florness,Fastenal,2,7,0,9,
2025-08-27,Garrick Rochow,CMS Energy,10,3,0,13,
2025-08-27,Rodney Sacks,Monster Beverage,14,23,2,39,
2025-08-27,Mark Shapiro,Endeavor,6,32,2,40,
2025-08-27,Toni Townes-Whitley,Science Applications International,13,19,1,33,
2025-08-27,Mark Witkowski,Core & Main,0,7,0,7,
2025-08-27,John Plant,Howmet Aerospace,4,13,1,18,
2025-08-27,James Zallie,Ingredion,4,4,1,9,
2025-08-27,Thomas Hill,Vulcan Materials,4,8,2,14,
2025-08-28,Doug McMillon,Walmart,17,17,6,40,
2025-08-28,Andrew Jassy,Amazon,4,30,6,40,
2025-08-28,Tim Cook,Apple,16,18,6,40,
2025-08-28,Stephen Hemsley,UnitedHealth,8,25,7,40,
2025-08-28,Warren Buffett,Berkshire Hathaway,9,20,11,40,
2025-08-28,David Joyner,CVS Health,9,27,4,40,
2025-08-28,Darren Woods,Exxon Mobil,12,22,6,40,
2025-08-28,Sundar Pichai,Alphabet,16,17,7,40,
2025-08-28,Brian Tyler,McKesson,4,16,5,25,
2025-08-28,Robert Mauch,Cencora,2,8,0,10,
2025-08-28,Ron Vachris,Costco,6,32,2,40,
2025-08-28,Jamie Dimon,JPMorgan Chase,11,15,14,40,
2025-08-28,Satya Nadella,Microsoft,14,16,10,40,
2025-08-28,Jason Hollar,Cardinal Health,14,22,4,40,
2025-08-28,Mike Wirth,Chevron,17,16,7,40,
2025-08-28,David Cordani,Cigna,21,15,4,40,
2025-08-28,Jim Farley,Ford Motor,12,23,5,40,
2025-08-28,Brian Moynihan,Bank of America,8,25,7,40,
2025-08-28,Mary Barra,General Motors,13,23,4,40,
2025-08-28,Gail Boudreaux,Elevance Health,15,18,7,40,
2025-08-28,Jane Fraser,Citigroup,12,22,6,40,
2025-08-28,Sarah London,Centene,13,19,8,40,
2025-08-28,Ted Decker,Home Depot,9,25,6,40,
2025-08-28,Maryann Mannen,Marathon Petroleum,5,12,1,18,
2025-08-28,Ron Sargent,Kroger,5,21,14,40,
2025-08-28,Mark Lashier,Phillips 66,10,21,7,38,
2025-08-28,Priscilla Almodovar,Fannie Mae,11,18,11,40,
2025-08-28,Tim Wentworth,Walgreens,8,22,9,39,
2025-08-28,Lane Riggs,Valero Energy,14,8,0,22,
2025-08-28,Mark Zuckerberg,Meta,14,18,8,40,
2025-08-28,Hans Vestberg,Verizon,16,20,4,40,
2025-08-28,John Stankey,AT&T,10,27,3,40,
2025-08-28,Brian Roberts,Comcast,10,27,3,40,
2025-08-28,Charles Scharf,Wells Fargo,28,6,6,40,
2025-08-28,David Solomon,Goldman Sachs,6,23,11,40,
2025-08-28,Michael Hutchins,Freddie Mac,3,11,3,17,
2025-08-28,Michael Fiddelke,Target,11,22,7,40,
2025-08-28,Jim Rechtin,Humana,17,18,5,40,
2025-08-28,Jon Farney,State Farm Insurance,1,13,3,17,
2025-08-28,Elon Musk,Tesla,6,19,15,40,
2025-08-28,Ted Pick,Morgan Stanley,16,22,2,40,
2025-08-28,Joaquin Duato,Johnson & Johnson,10,25,5,40,
2025-08-28,Juan Luciano,Archer Daniels Midland,3,20,14,37,
2025-08-28,Ramon Laguarta,PepsiCo,6,28,6,40,
2025-08-28,Carol Tom√©,UPS,9,20,11,40,
2025-08-28,Rajesh Subramaniam,FedEx,10,26,0,36,
2025-08-28,Bob Iger,Walt Disney,9,28,3,40,
2025-08-28,Michael Dell,Dell Technologies,11,24,5,40,
2025-08-28,Marvin Ellison,Lowes,12,26,2,40,
2025-08-28,Jon Moeller,Procter & Gamble,4,30,6,40,
2025-08-28,Thomas Long,Energy Transfer,8,0,2,10,
2025-08-28,Kelly Ortberg,Boeing,11,26,3,40,
2025-08-28,Susan Morris,Albertsons,13,24,3,40,
2025-08-28,Kevin Hourican,Sysco,10,27,3,40,
2025-08-28,Christopher Calio,RTX,7,11,0,18,
2025-08-28,Larry Culp,General Electric,12,25,3,40,
2025-08-28,James Taiclet,Lockheed Martin,12,17,11,40,
2025-08-28,Stephen Squeri,American Express,16,22,2,40,
2025-08-28,Joe Creed,Caterpillar,11,26,3,40,
2025-08-28,Michel Khalaf,MetLife,11,18,0,29,
2025-08-28,Samuel Hazen,HCA Healthcare,9,5,0,14,
2025-08-28,Tricia Griffith,Progressive Insurance,9,26,4,39,
2025-08-28,Arvind Krishna,IBM,13,21,6,40,
2025-08-28,John May,Deere,9,26,5,40,
2025-08-28,Jensen Huang,Nvidia,9,25,6,40,
2025-08-28,Philip Smith,StoneX,0,10,1,11,
2025-08-28,Robert M Davis,Merck,3,20,0,23,
2025-08-28,Ryan Lance,ConocoPhillips,18,19,3,40,
2025-08-28,Albert Bourla,Pfizer,19,12,9,40,
2025-08-28,Ed Bastian,Delta Air Lines,11,19,10,40,
2025-08-28,Patrick Zammit,TD Synnex,11,15,0,26,
2025-08-28,Kevin Murphy,Publix Super Markets,9,24,1,34,
2025-08-28,Thomas J Wilson,Allstate,1,8,1,10,
2025-08-28,Chuck Robbins,Cisco Systems,15,23,2,40,
2025-08-28,Kirt Walker,Nationwide,14,17,2,33,
2025-08-28,Christopher Winfrey,Charter Communications,5,16,5,26,
2025-08-28,Bob Michael,AbbVie,0,0,0,0,
2025-08-28,Craig DeSanto,New York Life Insurance,3,17,0,20,
2025-08-28,Lip-Bu Tan,Intel,10,16,14,40,
2025-08-28,Ernie Herrman,TJX,16,22,2,40,
2025-08-28,Andrew Sullivan,Prudential Financial,13,21,0,34,
2025-08-28,Enrique Lores,Hewlett Packard,11,17,6,34,
2025-08-28,Scott Kirby,United Airlines,33,3,4,40,
2025-08-28,George Holm,Performance Food,11,21,2,34,
2025-08-28,Donnie King,Tyson Foods,10,26,4,40,
2025-08-28,Robert Isom,American Airlines,8,25,7,40,
2025-08-28,Timothy M Sweeney,Liberty Mutual Insurance,14,0,0,14,
2025-08-28,Elliott Hill,Nike,8,30,2,40,
2025-08-28,Safra Catz,Oracle,10,23,7,40,
2025-08-28,AJ Jim Teague,Enterprise Products Partners,3,8,0,11,
2025-08-28,Richard Fairbank,Capital One,14,22,4,40,
2025-08-28,Wilfred Chiang,Plains GP,1,1,0,2,
2025-08-28,Michael Kasbar,World Kinect,1,9,0,10,
2025-08-28,Peter Zaffino,American International Group,9,28,3,40,
2025-08-28,James Quincey,The Coca-Cola Company,9,29,2,40,
2025-08-28,Thasunda Brown Duckett,TIAA,21,19,0,40,
2025-08-28,Jay Debertin,CHS,3,9,4,16,
2025-08-28,Chris Boerner,Bristol-Myers Squibb,10,23,7,40,
2025-08-28,Corie Barry,Best Buy,38,1,1,40,
2025-08-28,Marc Casper,Thermo Fisher Scientific,15,22,3,40,
2025-08-28,Roger Crandall,Mass Mutual,2,7,0,9,
2025-08-28,Juan Andrade,USAA,5,16,0,21,
2025-08-28,Phebe Novakovic,General Dynamics,28,9,3,40,
2025-08-28,Alan Schnitzer,Travelers Insurance,3,5,2,10,
2025-08-28,David Zaslav,Warner Bros Discovery,6,22,11,39,
2025-08-28,Gunjan Kedia,US Bancorp,14,24,2,40,
2025-08-28,Robert Ford,Abbott Laboratories,13,22,5,40,
2025-08-28,Kathy Warden,Northrop Grumman,14,22,4,40,
2025-08-28,Tim Gerend,Northwestern Mutual,13,26,1,40,
2025-08-28,Todd Vasos,Dollar General,4,27,9,40,
2025-08-28,Matthew Lucey,PBF Energy,5,3,0,8,
2025-08-28,Dara Khosrowshahi,Uber,11,24,5,40,
2025-08-28,Vimal Kapur,Honeywell,11,29,0,40,
2025-08-28,Dirk Van de Put,Mondelez,10,26,4,40,
2025-08-28,Brian Niccol,Starbucks,12,28,0,40,
2025-08-28,Cristiano Amon,Qualcomm,11,28,1,40,
2025-08-28,Hock Tan,Broadcom,12,24,4,40,
2025-08-28,David Flitman,US Foods,1,8,0,9,
2025-08-28,Paul Romanowski,DR Horton,5,16,5,26,
2025-08-28,Jacek Olczak,Philip Morris,14,22,4,40,
2025-08-28,Preston Feight,Paccar,6,26,0,32,
2025-08-28,Marc Benioff,Salesforce,10,23,7,40,
2025-08-28,Leon Topalian,Nucor,16,22,2,40,
2025-08-28,Michael Dastoor,Jabil,1,8,0,9,
2025-08-28,Jonathan Jaffe,Lennar,1,8,1,10,
2025-08-28,David Ricks,Eli Lilly,11,20,9,40,
2025-08-28,Joe Zubretsky,Molina Healthcare,8,7,4,19,
2025-08-28,Jennifer Rumsey,Cummins,8,26,6,40,
2025-08-28,Robin Vince,Bank of New York Mellon,20,18,2,40,
2025-08-28,Ted Sarandos,Netflix,15,23,2,40,
2025-08-28,William H Rogers Jr,Truist Financial,2,6,1,9,
2025-08-28,Sean Kerins,Arrow Electronics,1,15,0,16,
2025-08-28,William M Brown,3M,2,8,0,10,
2025-08-28,Ryan McInerney,Visa,16,20,4,40,
2025-08-28,Marc Rowan,Apollo Global Management,20,16,4,40,
2025-08-28,Tim Go,HF Sinclair,5,3,0,8,
2025-08-28,Robert Sulentic,CBRE Group,1,7,1,9,
2025-08-28,William Demchak,PNC Financial Services,14,20,6,40,
2025-08-28,Bryan DeBoer,Lithia Motors,11,27,1,39,
2025-08-28,William Nash,CarMax,3,5,2,10,
2025-08-28,Brian Robbins,Paramount Global,6,29,0,35,
2025-08-28,Michael Creedon,Dollar Tree,3,35,2,40,
2025-08-28,Sandy Douglas,United Natural Foods,33,5,2,40,
2025-08-28,Alex Chriss,PayPal,12,25,3,40,
2025-08-28,Roger Penske,Penske Automotive,16,23,1,40,
2025-08-28,Antonio Neri,Hewlett Packard Enterprise,9,23,8,40,
2025-08-28,Harry Sideris,Duke Energy,35,5,0,40,
2025-08-28,Vicki Hollub,Occidental Petroleum,20,15,4,39,
2025-08-28,Lawrence Coben,NRG Energy,5,2,0,7,
2025-08-28,Robert Bradway,Amgen,9,28,3,40,
2025-08-28,John Ketchum,NextEra Energy,23,17,0,40,
2025-08-28,Rainer Blair,Danaher,6,15,2,23,
2025-08-28,Daniel O'Day,Gilead Sciences,17,19,4,40,
2025-08-28,Michael Manley,AutoNation,3,6,1,10,
2025-08-28,Carlos Abrams-Rivera,Kraft Heinz,15,18,7,40,
2025-08-28,Philip Gallagher,Avnet,1,4,1,6,
2025-08-28,Gary Dickerson,Applied Materials,7,22,11,40,
2025-08-28,Bob Jordan,Southwest Airlines,12,21,7,40,
2025-08-28,Rick Wurster,Charles Schwab,14,21,4,39,
2025-08-28,Lorenzo Simonelli,Baker Hughes,16,20,4,40,
2025-08-28,Chris Kempczinski,McDonalds,11,22,7,40,
2025-08-28,Christopher Womack,Southern Company,3,7,0,10,
2025-08-28,Michael Miebach,Mastercard,11,26,3,40,
2025-08-28,Joseph Dominguez,Constellation Energy,12,11,1,24,
2025-08-28,Christopher Swift,The Hartford,15,22,3,40,
2025-08-28,Patricia Poppe,PG&E,8,16,2,26,
2025-08-28,Bom Kim,Coupang,12,27,1,40,
2025-08-28,Ezra Yacob,EOG Resources,22,12,2,36,
2025-08-28,Jim Vena,Union Pacific,18,22,0,40,
2025-08-28,Matt Schroeder,Rite Aid,4,33,3,40,
2025-08-28,Tony Spring,Macys,10,27,3,40,
2025-08-28,Anthony Capuano,Marriott International,12,25,3,40,
2025-08-28,Raymond E Scott,Lear Corporation,5,4,0,9,
2025-08-28,William Stengel II,Genuine Parts,0,4,0,4,
2025-08-28,Heidi Petz,Sherwin-Williams,8,28,3,39,
2025-08-28,Jeff Miller,Halliburton,11,24,5,40,
2025-08-28,Kathleen Quirk,Freeport-McMoRan,14,17,2,33,
2025-08-28,Michael Rapino,Live Nation Entertainment,14,23,3,40,
2025-08-28,John Doyle,Marsh & McLennan,10,7,0,17,
2025-08-28,Lisa Su,Advanced Micro Devices,20,16,4,40,
2025-08-28,Frank Holding,First Citizens BancShares,8,14,2,24,
2025-08-28,John Engel,WESCO International,6,11,1,18,
2025-08-28,David Gitlin,Carrier Global,13,25,2,40,
2025-08-28,Lourenco Goncalves,Cleveland-Cliffs,7,22,11,40,
2025-08-28,Calvin G Butler Jr,Exelon,5,4,0,9,
2025-08-28,Joseph Bae,KKR,19,19,2,40,
2025-08-28,Christine Leahy,CDW,1,11,2,14,
2025-08-28,Glenn Fogel,Booking Holdings,11,24,5,40,
2025-08-28,Brian Doubles,Synchrony Financial,4,7,2,13,
2025-08-28,Earl Austin,Quanta Services,2,6,2,10,
2025-08-28,Christian Ulbrich,Jones Lang LaSalle,9,22,0,31,
2025-08-28,Saumya Sutaria,Tenet Healthcare,4,4,1,9,
2025-08-28,William Gifford,Altria,3,4,2,9,
2025-08-28,Kevin Lobo,Stryker,11,25,4,40,
2025-08-28,Michael Hsu,Kimberly-Clark,6,6,1,13,
2025-08-28,Jack Fusco,Cheniere Energy,18,19,3,40,
2025-08-28,James Conroy,Ross Stores,5,10,0,15,
2025-08-28,Anthony Smurfit,Smurfit Westrock,3,6,0,9,
2025-08-28,Jeffrey Harmening,General Mills,5,17,4,26,
2025-08-28,Mark Stewart,Goodyear Tire & Rubber,3,34,3,40,
2025-08-28,Bob Eddy,BJs Wholesale Club,6,22,2,30,
2025-08-28,Peter Arduini,GE HealthCare Technologies,6,11,0,17,
2025-08-28,Noel Wallace,Colgate-Palmolive,8,21,2,31,
2025-08-28,Marc Bitzer,Whirlpool,12,13,15,40,
2025-08-28,Chris Kubasik,L3Harris Technologies,7,12,1,20,
2025-08-28,Shantanu Narayen,Adobe,19,20,1,40,
2025-08-28,Thomas Polen,Becton Dickinson,7,3,0,10,
2025-08-28,Richard P Dealy,Pioneer Natural Resources,6,3,0,9,
2025-08-28,Ravi Kumar S,Cognizant Technology Solutions,9,24,3,36,
2025-08-28,Andrew Clyde,Murphy USA,13,26,1,40,
2025-08-28,Mike Lyons,Fiserv,4,11,1,16,
2025-08-28,Jennifer Parmentier,Parker-Hannifin,2,11,0,13,
2025-08-28,William Fehrman,American Electric Power,4,6,0,10,
2025-08-28,Andrew Silvernail,International Paper,6,20,0,26,
2025-08-28,Jonas Prising,ManpowerGroup,0,0,0,0,
2025-08-28,John Zillmer,Aramark,6,15,2,23,
2025-08-28,Mark Millett,Steel Dynamics,19,2,0,21,
2025-08-28,Dan Amos,Aflac,12,20,8,40,
2025-08-28,Tony Cheng,Reinsurance Group of America,3,10,2,15,
2025-08-28,Karsanbhai,Emerson Electric,8,20,2,30,
2025-08-28,Ronald P O'Hanley,State Street,7,14,0,21,
2025-08-28,Timothy Knavish,PPG Industries,1,3,0,4,
2025-08-28,David Burritt,United States Steel,7,19,14,40,
2025-08-28,Maria Black,Automatic Data Processing,5,4,0,9,
2025-08-28,Daryl Kenningham,Group 1 Automotive,8,30,2,40,
2025-08-28,Robert Blue,Dominion Energy,25,10,2,37,
2025-08-28,Larry Fink,BlackRock,6,26,8,40,
2025-08-28,Pierce Norton II,Oneok,4,4,0,8,
2025-08-28,David Bozeman,CH Robinson Worldwide,2,7,0,9,
2025-08-28,Haviv Ilan,Texas Instruments,11,27,2,40,
2025-08-28,Michael Bender,Kohls,2,26,11,39,
2025-08-28,Philip Daniele III,AutoZone,0,2,0,2,
2025-08-28,Timothy Archer,Lam Research,3,6,0,9,
2025-08-28,Charles Magro,Corteva,3,2,1,6,
2025-08-28,Rick Lanoha,Peter Kiewit Sons',0,2,0,2,
2025-08-28,Peter Jackson,Builders FirstSource,5,12,1,18,
2025-08-28,Martin Schroeter,Kyndryl,11,28,0,39,
2025-08-28,Hamid Akhavan,EchoStar,3,23,9,35,
2025-08-28,Bill Westrate,American Family Insurance,10,16,2,28,
2025-08-28,Avigal Soreq,Delek US,4,9,5,18,
2025-08-28,Beth Ford,Land O'Lakes,17,21,2,40,
2025-08-28,Walker Martin,Sempra,0,3,0,3,
2025-08-28,Eric Slifka,Global Partners,12,22,6,40,
2025-08-28,DG Macpherson,WW Grainger,2,8,1,11,
2025-08-28,Bob Pragada,Jacobs Solutions,6,7,0,13,
2025-08-28,Pedro Pizarro,Edison International,14,10,16,40,
2025-08-28,William Hornbuckle,MGM Resorts International,6,23,1,30,
2025-08-28,Andrew McMahon,Guardian Life insurance,5,13,0,18,
2025-08-28,Christopher O'Herlihy,Illinois Tool Works,4,4,1,9,
2025-08-28,James Cracchiolo,Ameriprise Financial,2,22,2,26,
2025-08-28,Ryan Marshall,PulteGroup,14,14,11,39,
2025-08-28,Matthew Meloy,Targa Resources,6,4,0,10,
2025-08-28,Michael Rhodes,Ally Financial,11,23,5,39,
2025-08-28,Joseph Fadool,BorgWarner,4,9,0,13,
2025-08-28,St√©phane de La Faverie,Est√©e Lauder,9,26,5,40,
2025-08-28,Benjamin Tisch,Loews,2,7,0,9,
2025-08-28,Brad Beckham,O'Reilly Automotive,4,16,1,21,
2025-08-28,Thomas Gayner,Markel Group,1,9,0,10,
2025-08-28,Donald Allan,Stanley Black & Decker,5,33,2,40,
2025-08-28,Sanjay Mehrotra,Micron Technology,17,21,2,40,
2025-08-28,James Breuer,Fluor,1,1,1,3,
2025-08-28,Thomas Bell,Leidos,8,18,2,28,
2025-08-28,Scott Smith,Viatris,5,4,0,9,
2025-08-28,Kimberly Dang,Kinder Morgan,11,1,0,12,
2025-08-28,Christophe Beck,Ecolab,18,22,0,40,
2025-08-28,Brent Shafer,Baxter International,1,9,0,10,
2025-08-28,Clay Gaspar,Devon Energy,20,3,0,23,
2025-08-28,Steven Cahillane,Kellanova,2,7,0,9,
2025-08-28,Raul Nicholas Vargas Ochoa,Farmers Insurance Exchange,0,0,0,0,
2025-08-28,Darren Rebelez,Caseys General Stores,3,6,0,9,
2025-08-28,Ari Bousbib,IQVIA,7,16,1,24,
2025-08-28,Jon Vander Ark,Republic Services,9,18,13,40,
2025-08-28,Timothy Cofer,Keurig Dr Pepper,0,5,0,5,
2025-08-28,Karla Lewis,Reliance Inc,2,6,0,8,
2025-08-28,David Hult,Asbury Automotive Group,7,32,1,40,
2025-08-28,Darryl Button,Pacific Life,1,6,0,7,
2025-08-28,James Burke,Vistra,7,3,0,10,
2025-08-28,John Barrett,Western & Southern Financial,10,28,2,40,
2025-08-28,William Krueger,The Andersons Inc,0,3,0,3,
2025-08-28,Erik Nordstrom,Nordstrom,6,28,5,39,
2025-08-28,John Wren,Omnicom Group,15,19,6,40,
2025-08-28,Stephanie Ferris,Fidelity National Information Services,14,24,2,40,
2025-08-28,Timothy Cawley,Consolidated Edison,5,4,0,9,
2025-08-28,Joseph Hinrichs,CSX,8,10,1,19,
2025-08-28,Troy Rudd,AECOM,8,25,5,38,
2025-08-28,Kathleen Johnson,Lumen Technologies,3,4,0,7,
2025-08-28,Harry Lawton III,Tractor Supply,1,2,0,3,
2025-08-28,Raul Fernandez,DXC Technology,2,35,2,39,
2025-08-28,Eric Hansotia,AGCO,13,15,1,29,
2025-08-28,David Bruton Smith,Sonic Automotive,3,10,9,22,
2025-08-28,Sasan Goodarzi,Intuit,11,25,4,40,
2025-08-28,Matthew Flannery,United Rentals,29,2,0,31,
2025-08-28,Marc Miller,Universal Health Services,5,22,3,30,
2025-08-28,Michael Mahoney,Boston Scientific,9,29,2,40,
2025-08-28,Judith Marks,Otis Worldwide,2,3,0,5,
2025-08-28,Robert Frenzel,Xcel Energy,5,2,1,8,
2025-08-28,Penny Pennington,Edward Jones,6,29,5,40,
2025-08-28,Daniel Fisher,Ball,2,20,5,27,
2025-08-28,Justin Jude,LKQ,4,6,1,11,
2025-08-28,James Blackledge,Mutual of Omaha,2,29,2,33,
2025-08-28,Bruce Bodine,Mosaic,2,7,0,9,
2025-08-28,Scott Donnelly,Textron,10,27,3,40,
2025-08-28,Adam Schechter,Labcorp Holdings,3,6,0,9,
2025-08-28,Deanna Strable-Soethout,Principal Financial,1,5,0,6,
2025-08-28,Leonard Schleifer,Regeneron Pharmaceuticals,6,27,7,40,
2025-08-28,Paul Shoukry,Raymond James Financial,14,26,0,40,
2025-08-28,Lauren Hobart,Dicks Sporting Goods,14,23,3,40,
2025-08-28,Jamie Whisnant,Auto-Owners Insurance,0,2,0,2,
2025-08-28,Ariane Gorin,Expedia,8,31,1,40,
2025-08-28,Shelley Simpson,JB Hunt Transport Services,7,31,2,40,
2025-08-28,Ren√© Jones,M&T Bank,13,24,3,40,
2025-08-28,Gerardo Norcia,DTE Energy,6,3,0,9,
2025-08-28,Andr√©s Gluski,AES,18,22,0,40,
2025-08-28,Timothy Spence,Fifth Third Bancorp,3,5,1,9,
2025-08-28,Eduardo Menezes,Air Products & Chemicals,4,5,1,10,
2025-08-28,Wendell Weeks,Corning,14,24,2,40,
2025-08-28,Anthony Guzzi,EMCOR Group,3,3,1,7,
2025-08-28,Adam Norwitt,Amphenol,3,15,0,18,
2025-08-28,Jean-Marc Gilson,Westlake Corporation,2,4,0,6,
2025-08-28,Lori Koch,DuPont,6,18,0,24,
2025-08-28,Derek Chang,Liberty Media,36,4,0,40,
2025-08-28,Martina Cheung,S&P Global,12,26,0,38,
2025-08-28,Tim Hingtgen,Community Health Systems,10,28,2,40,
2025-08-28,Brian Tierney,FirstEnergy,5,25,3,33,
2025-08-28,Rick McKenney,Unum Group,6,4,0,10,
2025-08-28,Stanley Bergman,Henry Schein,11,28,1,40,
2025-08-28,Tiang Yew Tan,Western Digital,0,2,0,2,
2025-08-28,Vincent Roche,Analog Devices,13,22,2,37,
2025-08-28,Sean Connolly,Conagra Brands,7,31,2,40,
2025-08-28,Bruce Van Saun,Citizens Financial Group,14,26,0,40,
2025-08-28,Mark George,Norfolk Southern,18,20,2,40,
2025-08-28,Andrew Marsh,Entergy,3,5,0,8,
2025-08-28,Robert Berkley,WR Berkley,8,29,3,40,
2025-08-28,Javier Rodriguez,DaVita,14,14,1,29,
2025-08-28,Michael O'Grady,Northern Trust,23,4,1,28,
2025-08-28,James Snee,Hormel Foods,3,26,1,30,
2025-08-28,Timothy J Donahue,Crown Holdings,1,8,0,9,
2025-08-28,Joseph Ferraro,Avis Budget,2,7,1,10,
2025-08-28,Niraj Shah,Wayfair,8,25,7,40,
2025-08-28,Jos√© Mas,MasTec,6,15,1,22,
2025-08-28,Joseph Nolan,Eversource Energy,6,3,1,10,
2025-08-28,Thomas Palmer,Newmont,7,3,0,10,
2025-08-28,Robert Sanchez,Ryder System,10,9,1,20,
2025-08-28,Michael Nolan,Fidelity National Financial,2,0,0,2,
2025-08-28,Gavin Hattersley,Molson Coors Beverage,5,31,4,40,
2025-08-28,Thomas Reeg,Caesars Entertainment,5,6,0,11,
2025-08-28,Ellen Cooper,Lincoln National,3,6,0,9,
2025-08-28,Bracken Darrell,VF Corporation,8,28,4,40,
2025-08-28,Erik Fyrwald,International Flavors & Fragrances,8,6,3,17,
2025-08-28,Christopher Kastner,Huntington Ingalls Industries,3,4,1,8,
2025-08-28,Shane O'Kelly,Advance Auto Parts,14,21,5,40,
2025-08-28,Ralph LaRossa,Public Service Enterprise Group,12,18,0,30,
2025-08-28,Kecia Steelman,Ulta Beauty,33,6,1,40,
2025-08-28,Michele Buck,Hershey,9,29,2,40,
2025-08-28,Sumit Singh,Chewy,13,22,5,40,
2025-08-28,Steven Vondran,American Tower,4,6,0,10,
2025-08-28,Jeffrey Lorberbaum,Mohawk Industries,11,6,1,18,
2025-08-28,Keith Demmings,Assurant,4,6,0,10,
2025-08-28,Robert Martin,Thor Industries,4,5,1,10,
2025-08-28,Kathleen Mazzarella,Graybar Electric,1,9,0,10,
2025-08-28,Joey Wat,Yum China,12,26,2,40,
2025-08-28,Scott Richardson,Celanese,7,28,5,40,
2025-08-28,David Rawlinson II,QVC,7,15,2,24,
2025-08-28,Alan Armstrong,Williams,24,12,4,40,
2025-08-28,Philippe Krakowsky,Interpublic Group,12,25,3,40,
2025-08-28,Brendan McCracken,Ovintiv,5,5,0,10,
2025-08-28,Andrew Teno,Icahn Enterprises,5,6,0,11,
2025-08-28,Stephen Steinour,Huntington Bancshares,2,8,0,10,
2025-08-28,Timothy NeCastro,Erie Insurance,2,7,1,10,
2025-08-28,Ernest Garcia III,Carvana,24,12,4,40,
2025-08-28,R Bruce McDonald,Dana Incorporated,4,7,1,12,
2025-08-28,William Oplinger,Alcoa Corporation,1,7,2,10,
2025-08-28,Mark Pearson,Equitable,9,8,0,17,
2025-08-28,Richard Wallace,KLA,4,3,0,7,
2025-08-28,Ricardo Cardenas,Darden Restaurants,4,3,1,8,
2025-08-28,Mikael Bratt,Autoliv,6,8,2,16,
2025-08-28,Benito Minicucci,Alaska Air,4,3,1,8,
2025-08-28,Christopher Gorman,KeyCorp,5,5,0,10,
2025-08-28,Robert Goldstein,Las Vegas Sands,3,32,5,40,
2025-08-28,Edward Pesicka,Owens & Minor,4,33,2,39,
2025-08-28,Christopher Nassetta,Hilton Worldwide,6,16,2,24,
2025-08-28,Jamie Iannone,Ebay,20,16,4,40,
2025-08-28,Patrick Gallagher,Arthur J Gallagher,10,28,2,40,
2025-08-28,Rich Steinmeier,LPL Financial,24,14,2,40,
2025-08-28,Stephen Spray,Cincinnati Financial,1,6,3,10,
2025-08-28,Douglas Yearley,Toll Brothers,10,24,6,40,
2025-08-28,Gregory Brown,Motorola Solutions,2,8,0,10,
2025-08-28,Brian Chesky,Airbnb,2,31,7,40,
2025-08-28,Jeffrey Sprecher,Intercontinental Exchange,16,22,2,40,
2025-08-28,Robert Thomson,News Corp,7,28,5,40,
2025-08-28,Scott Boatwright,Chipotle Mexican Grill,8,28,4,40,
2025-08-28,Reshma Kewalramani,Vertex Pharmaceuticals,21,14,5,40,
2025-08-28,Christopher Viehbacher,Biogen,0,29,2,31,
2025-08-28,Malcolm Wilson,GXO Logistics,8,22,0,30,
2025-08-28,Tony Sarsam,SpartanNash,20,18,2,40,
2025-08-28,Michael O‚ÄôSullivan,Burlington Stores,4,33,3,40,
2025-08-28,Teresa Rasmussen,Thrivent Financial for Lutherans,3,2,0,5,
2025-08-28,Eugene Bredow,NVR,0,4,0,4,
2025-08-28,Brian Chambers,Owens Corning,3,12,1,16,
2025-08-28,Rafael Santana,Westinghouse Air Brake Technologies,3,6,1,10,
2025-08-28,John Pfeifer,Oshkosh,6,24,5,35,
2025-08-28,Cameron Bready,Global Payments,8,29,3,40,
2025-08-28,Calvin McDonald,Lululemon athletica,8,31,1,40,
2025-08-28,J Kent Masters,Albemarle Corporation,3,6,0,9,
2025-08-28,Joanna Geraghty,JetBlue Airways,14,20,6,40,
2025-08-28,Robert Steer,Seaboard,0,4,0,4,
2025-08-28,William Newlands,Constellation Brands,0,2,2,4,
2025-08-28,Michael Doss,Graphic Packaging,6,8,1,15,
2025-08-28,Gil West,Hertz,6,25,9,40,
2025-08-28,Malcolm C Roberts,FM Global,1,11,2,14,
2025-08-28,Mick Beekhuizen,Campbell Soup,8,24,1,33,
2025-08-28,Daniel Wall,Expeditors International of Washington,2,5,0,7,
2025-08-28,Gregory Roberts,A-Mark Precious Metals,2,4,1,7,
2025-08-28,Horacio Rozanski,Booz Allen Hamilton,15,20,5,40,
2025-08-28,James Davis,Quest Diagnostics,4,5,1,10,
2025-08-28,Dennis Mathew,Altice,5,29,6,40,
2025-08-28,Stefan Larsson,PVH,11,24,5,40,
2025-08-28,Mark Costa,Eastman Chemical,5,18,4,27,
2025-08-28,Joyce Mullen,Insight Enterprises,5,10,1,16,
2025-08-28,John Turner,Regions Financial,20,18,2,40,
2025-08-28,Julian G Francis,Beacon Roofing Supply,0,1,0,1,
2025-08-28,Blake Moret,Rockwell Automation,12,26,2,40,
2025-08-28,Mike Speetzen,Polaris Inc,3,17,2,22,
2025-08-28,William McDermott,ServiceNow,4,5,0,9,
2025-08-28,Jure Sola,Sanmina,3,11,1,15,
2025-08-28,Bob Flexon,UGI Utilities Inc,1,1,0,2,
2025-08-28,Scott Lauber,WEC Energy,15,5,0,20,
2025-08-28,Jon Rousseau,BrightSpring Health Services,20,19,1,40,
2025-08-28,Todd Schneider,Cintas,12,18,1,31,
2025-08-28,Peter Matt,Commercial Metals,5,4,0,9,
2025-08-28,Robert D Lawler,Continental Resources,1,0,0,1,
2025-08-28,Domenic Dell‚ÄôOsso Jr,Expand Energy,3,0,0,3,
2025-08-28,Jason P Wells,CenterPoint Energy,8,4,1,13,
2025-08-28,H Michael Krimbill,NGL Energy Partners,6,2,0,8,
2025-08-28,Tony Xu,DoorDash,14,18,8,40,
2025-08-28,Clay Williams,NOV,10,22,4,36,
2025-08-28,Kristin Peck,Zoetis,12,19,1,32,
2025-08-28,Mark Smucker,JM Smucker,9,24,7,40,
2025-08-28,Steve Sanghi,Microchip Technology,8,27,5,40,
2025-08-28,Richard Tobin,Dover Corporation,5,3,0,8,
2025-08-28,Kaes Van‚Äôt Hof,Diamondback Energy,22,15,2,39,
2025-08-28,Deon Stander,Avery Dennison,0,12,0,12,
2025-08-28,Vincent Sorgi,PPL,8,9,1,18,
2025-08-28,Hassane El-Khoury,ON Semiconductor,1,17,4,22,
2025-08-28,Arie Kotler,ARKO,5,22,1,28,
2025-08-28,William Monteleone,Par Pacific,1,7,2,10,
2025-08-28,John Christmann IV,APA,6,4,0,10,
2025-08-28,Adaire Fox-Martin,Equinix,15,21,4,40,
2025-08-28,Joseph M Otting,Flagstar Financial,2,7,0,9,
2025-08-28,Mary Dillon,Foot Locker,10,24,6,40,
2025-08-28,James Zallie,Ingredion,4,4,1,9,
2025-08-28,Christopher Peterson,Newell Brands,1,7,2,10,
2025-08-28,Scott Salmirs,ABM Industries,6,8,1,15,
2025-08-28,Christopher Hilger,Securian Financial,0,8,1,9,
2025-08-28,Hamid Moghadam,Prologis,0,0,0,0,
2025-08-28,Stephen Schwarzman,Blackstone,15,19,6,40,
2025-08-28,Robert Greenberg,Skechers USA,6,24,3,33,
2025-08-28,Keith Allman,Masco,4,9,1,14,
2025-08-28,Rusty Rush,Rush Enterprises,15,22,3,40,
2025-08-28,Jennifer Johnson,Franklin Resources,1,6,2,9,
2025-08-28,Gerry P Smith,ODP Business Solutions,1,0,0,1,
2025-08-28,Carl Lindner lll,American Financial,0,0,0,0,
2025-08-28,Mark Kowlzan,Packaging Corp of America,0,9,1,10,
2025-08-28,Thomas Hill,Vulcan Materials,4,8,2,14,
2025-08-28,Milan Galik,Interactive Brokers,6,17,1,24,
2025-08-28,Laura Alber,Williams-Sonoma,14,21,5,40,
2025-08-28,Mario Harik,XPO,8,31,1,40,
2025-08-28,Devin Stockfish,Weyerhaeuser,5,5,0,10,
2025-08-28,Thomas J McInerney,Genworth Financial,0,7,0,7,
2025-08-28,Garrick Rochow,CMS Energy,11,3,0,14,
2025-08-28,Toni Townes-Whitley,Science Applications International,13,19,1,33,
2025-08-28,Rich Handler,Jefferies Financial,12,9,2,23,
2025-08-28,Daniel Heaf,Bath & Body Works,12,26,2,40,
2025-08-28,Andrew Wilson,Electronic Arts,12,18,10,40,
2025-08-28,Sheryl Palmer,Taylor Morrison Home,7,12,1,20,
2025-08-28,Ivan Tornos,Zimmer Biomet,10,29,1,40,
2025-08-28,Linda Rendle,Clorox,2,36,1,39,
2025-08-28,Matthew Pine,Xylem,2,11,1,14,
2025-08-28,Heather Lavallee,Voya Financial,7,9,2,18,
2025-08-28,Daniel Florness,Fastenal,2,7,0,9,
2025-08-28,Albert Nahmad,Watsco,2,7,0,9,
2025-08-28,Carl Eschenbach,Workday,11,20,9,40,
2025-08-28,Craig Smiddy,Old Republic International,2,6,1,9,
2025-08-28,Frank C Sullivan,RPM International,3,11,1,15,
2025-08-28,Matthew Missad,UFP Industries,7,2,0,9,
2025-08-28,Martin J Lyons,Ameren,3,3,0,6,
2025-08-28,Adam W Miller,Knight Swift Transportation,3,2,1,6,
2025-08-28,Rodney Sacks,Monster Beverage,13,24,2,39,
2025-08-28,Gary Guthart,Intuitive Surgical,13,24,3,40,
2025-08-28,Charles Liang,Super Micro Computer,36,4,0,40,
2025-08-28,Christopher Caldwell,Concentrix,2,6,0,8,
2025-08-28,Gordon J Hardie,O-I Glass,1,5,0,6,
2025-08-28,David Gibbs,Yum Brands,2,37,1,40,
2025-08-28,Steve Henry,Domtar,4,6,0,10,
2025-08-28,Chuck Treadway,CommScope,8,19,3,30,
2025-08-28,Rob Vitale,Post Holdings,1,12,5,18,
2025-08-28,Steven J Moskowitz,Crown Castle,2,5,3,10,
2025-08-28,Emmanuel Ligner,Avantor,5,11,3,19,
2025-08-28,Stuart Bradie,KBR,13,14,4,31,
2025-08-28,Carrie Wheeler,Opendoor Technologies,11,27,2,40,
2025-08-28,Russell Becker,APi Group,3,5,0,8,
2025-08-28,Toby Rice,EQT,25,13,2,40,
2025-08-28,Jesse Arenivas,EnLink Midstream,7,9,0,16,
2025-08-28,Nikesh Arora,Palo Alto Networks,5,27,8,40,
2025-08-28,Steven Bandrowczak,Xerox,1,8,1,10,
2025-08-28,Vicente Reynal,Ingersoll Rand,9,29,0,38,
2025-08-28,William T Dillard II,Dillards,3,5,2,10,
2025-08-28,C Howard Nye,Martin Marietta Materials,3,5,2,10,
2025-08-28,Giordano Albertazzi,Vertiv,17,20,3,40,
2025-08-28,Stephane Bancel,Moderna,10,20,10,40,
2025-08-28,Nate R Jorgensen,Boise Cascade,0,0,0,0,
2025-08-28,Jack Sinclair,Sprouts Farmers Market,17,22,1,40,
2025-08-28,Padraig McDonnell,Agilent Technologies,10,15,0,25,
2025-08-28,Kenneth T Lane,Olin,1,0,0,1,
2025-08-28,Randall C Stuewe,Darling Ingredients,25,1,0,26,
2025-08-28,R Howard Coker,Sonoco Products,3,6,1,10,
2025-08-28,John Mengucci,CACI International,22,17,1,40,
2025-08-28,Mark Witkowski,Core & Main,0,7,0,7,
2025-08-28,Lee M Tillman,Marathon Oil,5,4,0,9,
2025-08-28,Mark Hoplamazian,Hyatt Hotels,14,22,4,40,
2025-08-28,David S Chernow,Select Medical,0,7,2,9,
2025-08-28,Brendan M Foley,McCormick & Company,0,8,0,8,
2025-08-28,Joanne Crevoiserat,Tapestry,13,24,3,40,
2025-08-28,John Plant,Howmet Aerospace,0,0,0,0,
2025-08-28,Shankh Mitra,Welltower,16,22,2,40,
2025-08-28,W Anthony Will,CF Industries,4,5,0,9,
2025-08-28,David A Zapico,Ametek,3,17,0,20,
2025-08-28,Kevin Stein,TransDigm,10,9,2,21,
2025-08-28,Craig Billings,Wynn Resorts,12,26,2,40,
2025-08-28,William J Way,Southwestern Energy,1,1,0,2,
2025-08-28,Giel Rutten,Amkor Technology,2,8,1,11,
2025-08-28,Paul Sarvadi,Insperity,3,4,1,8,
2025-08-28,Donald Zurbay,Patterson Companies Inc,0,2,0,2,
2025-08-28,Rob Sharps,T Rowe Price,11,21,7,39,
2025-08-28,Patrice Louvet,Ralph Lauren,14,17,9,40,
2025-08-28,Jeffrey Mezger,KB Home,2,28,10,40,
2025-08-28,David M Foulkes,Brunswick,0,8,0,8,
2025-08-28,M Keith Waddell,Robert Half,2,10,0,12,
2025-08-28,Jay Snowden,PENN Entertainment,18,19,3,40,
2025-08-28,George Kurian,NetApp,13,23,4,40,
2025-08-28,Kevin Ali,Organon,9,19,0,28,
2025-08-28,Joel D Anderson,Petco Health and Wellness,2,10,0,12,
2025-08-28,Louis V Pinkham,Regal Rexnord,0,1,0,1,
2025-08-28,Jay Geldmacher,Resideo Technologies,11,5,1,17,
2025-08-28,Marcus Lemonis,Camping World,6,23,11,40,
2025-08-28,Peter R Huntsman,Huntsman,6,12,4,22,
2025-08-28,Hillary Super,Victorias Secret,12,4,7,23,
2025-08-28,Michelle Gass,Levi Strauss,11,25,3,39,
2025-08-28,Neil Hunn,Roper Technologies,3,22,0,25,
2025-08-28,Steven P Lawrence,Academy Sports and Outdoors,1,1,0,2,
2025-08-28,Phillippe Lord,Meritage Homes,9,17,0,26,
2025-08-28,David C Dauch,American Axle & Manufacturing,5,10,2,17,
2025-08-28,Olumide Soroye,Fortive,1,10,0,11,
2025-08-28,Adena Friedman,Nasdaq,15,21,4,40,
2025-08-28,Tim Gokey,Broadridge Financial Solutions,3,14,1,18,
2025-08-28,Patrick M Shanahan,Spirit AeroSystems,2,8,0,10,
2025-08-28,Robert Kyncl,Warner Music Group,9,28,3,40,
2025-08-28,Denise Dignam,Chemours,3,19,4,26,
2025-08-28,Jim DeVries,ADT,9,7,1,17,
2025-08-28,Bernard Zovighian,Edwards Lifesciences,7,6,2,15,
2025-08-28,Mark E Seaton,First American Financial,1,9,0,10,
2025-08-28,John C Roche,Hanover Insurance Group,4,14,1,19,
2025-08-28,Adam J Greenlee,Silgan,0,5,0,5,
2025-08-28,Jayne Hrdlicka,Endeavor Group,0,1,0,1,
2025-08-28,Robert Fauber,Moodys,0,5,1,6,
2025-08-28,Thomas E Jorden,Coterra Energy,10,0,0,10,
2025-08-28,Eugene A Hall,Gartner,1,9,0,10,
2025-08-28,Kevin Plank,Under Armour,8,30,2,40,
2025-08-28,James W Lanning,Ingles Markets,3,5,0,8,
2025-08-28,Matthew T Farrell,Church & Dwight,8,7,0,15,
2025-08-28,Kevin M Freeman,Old Dominion Freight Line,1,0,0,1,
2025-08-28,Joe Shoen,U-Haul,15,20,4,39,
2025-08-28,Mark Bertolini,Oscar Health,13,18,9,40,
2025-08-28,Jayshree Ullal,Arista Networks,20,20,0,40,
2025-08-28,Sassine Ghazi,Synopsys,13,24,3,40,
2025-08-28,Jochen Zeitz,Harley-Davidson,7,26,7,40,
2025-08-28,Nick Jeffery,Frontier Communications,10,27,2,39,
2025-08-28,Thomas Edward McCormick,Primoris Services,0,5,0,5,
2025-08-28,D Christian Koch,Carlisle Companies,1,4,1,6,
2025-08-28,David E Simon,Simon Property Group,2,5,2,9,
2025-08-28,Stephen Bratspies,Hanesbrands,3,11,0,14,
2025-08-28,Ryan M. Schneider,Anywhere Real Estate Inc,0,2,0,2,
2025-08-28,George Bobb III,Teledyne Technologies,1,4,1,6,
2025-08-28,Terrence A Duffy,CME Group,6,9,1,16,
2025-08-28,Rami Rahim,Juniper Networks,11,27,2,40,
2025-08-28,Sue Nabi,Coty,17,17,6,40,
2025-08-28,Peter D Arvan,Pool Corporation,2,7,0,9,
2025-08-28,David Campbell,Evergy,14,7,0,21,
2025-08-28,Matthew J Murphy,Marvell Technology,2,7,1,10,
2025-08-28,Lloyd Yates,NiSource,4,5,0,9,
2025-08-28,William C Stone,SS&C Technologies,2,4,1,7,
2025-08-28,Mark Rourke,Schneider National,8,18,1,27,
2025-08-28,Andrew Anagnost,Autodesk,8,24,8,40,
2025-08-28,Dustin Semach,Sealed Air Corporation,1,7,0,8,
2025-08-28,William L Meaney,Iron Mountain,5,16,2,23,
2025-08-28,Andy P Power,Digital Realty Trust,0,0,0,0,
2025-08-28,Satish Dhanasekaran,Keysight Technologies,5,14,1,20,
2025-08-28,Frank M Svoboda,Globe Life,3,4,3,10,
2025-08-28,Carey A Smith,Parsons,1,3,0,4,
2025-08-28,Ynon Kreiz,Mattel,9,24,7,40,
2025-08-28,Karen S Haller,Southwest Gas,3,6,0,9,
2025-08-28,Terrance Williams,TruStage,4,7,1,12,
2025-08-28,Eric W Gerstenberg,Clean Harbors,4,2,1,7,
2025-08-28,Gunner Smith,Cornerstone Building Brands,1,7,0,8,
2025-08-28,Gerben W Bakker,Hubbell,1,5,0,6,
2025-08-28,Dave Davis,Spirit Airlines,4,32,4,40,
2025-08-28,Michael J Smith,Lamb Weston,0,6,3,9,
2025-08-28,Strauss Zelnick,Take-Two Interactive Software,13,20,7,40,
2025-08-28,John C Turner Jr,GMS,3,7,0,10,
2025-08-28,David M O'Malley,Penn Mutual Life Insurance,1,2,0,3,
2025-08-28,Frank A Lonegro,Landstar System,2,5,0,7,
2025-08-28,James F Risoleo,Host Hotels & Resorts,5,18,1,24,
2025-08-28,Ken Xie,Fortinet,13,19,8,40,
2025-08-28,Doug Shulman,OneMain,3,7,0,10,
2025-08-28,Ryan Cohen,GameStop,10,21,9,40,
2025-08-28,Mark W Begor,Equifax,3,12,0,15,
2025-08-28,Jay L Schottenstein,American Eagle Outfitters,9,16,0,25,
2025-08-28,Curtis C Farmer,Comerica,3,9,0,12,
2025-08-28,Ole Rosgaard,Greif,3,14,1,18,
2025-08-28,Brian E Lane,Comfort Systems USA,9,1,0,10,
2025-08-28,Robert M Buck,TopBuild,1,5,1,7,
2025-08-28,Ralph Andretta,Bread Financial,3,7,0,10,
2025-08-28,Jim Anderson,Coherent,6,33,1,40,
2025-08-28,Walter C. D. Carlson,Telephone & Data Systems,0,3,0,3,
2025-08-28,Ronald Kruszewski,Stifel Financial,7,5,0,12,
2025-08-28,Richard Hayne,Urban Outfitters,10,21,7,38,
2025-08-28,Simon Meester,Terex,4,7,0,11,
2025-08-28,Edward J Lehner,Ryerson Holding,0,3,0,3,
2025-08-28,Nicholas T Pinchuk,Snap-on,2,7,0,9,
2025-08-28,Ryals McMullian,Flowers Foods,6,26,2,34,
2025-08-28,D Bryan Jordan,First Horizon,4,8,1,13,
2025-08-28,John B Gibson,Paychex,2,6,0,8,
2025-08-28,Chris Cocks,Hasbro,13,19,8,40,
2025-08-28,Pete McPartland,Sentry Insurance Group,0,2,0,2,
2025-08-28,Michael Arougheti,Ares Management,17,21,2,40,
2025-08-28,Alok Maskara,Lennox International,6,3,1,10,
2025-08-28,James C Grech,Peabody Energy,3,0,0,3,
2025-08-28,Joseph P Lacher Jr,Kemper,3,18,4,25,
2025-08-28,Perry A Sook,Nexstar Media Group,7,30,1,38,
2025-08-28,Wade Davis,TelevisaUnivision,12,26,2,40,
2025-08-28,Scott L Thompson,Tempur Sealy International,0,7,0,7,
2025-08-28,Mike Simonds,TriNet Group,0,8,0,8,
2025-08-28,B Andrew Rose,Worthington Enterprises,1,1,0,2,
2025-08-28,Bruce L Caswell,Maximus,6,4,0,10,
2025-08-28,Robert L Reffkin,Compass,1,7,0,8,
2025-08-28,Mark Eubanks,Brinks Company,1,2,1,4,
2025-08-28,Peter Quigley,Kelly Services inc,1,8,0,9,
2025-08-28,David L Yowan,Navient,4,3,0,7,
2025-08-28,Mary E Kipp,Puget Sound Energy,4,0,1,5,
2025-08-28,Adam Aron,AMC Entertainment,21,12,7,40,
2025-08-28,Mark J Tarr,Encompass Health,2,5,1,8,
2025-08-28,Liam K Griffin,Skyworks Solutions,1,7,0,8,
2025-08-28,Richard G Kyle,Timken,6,13,1,20,
2025-08-28,Ron Gusek,Liberty Energy,23,1,0,24,
2025-08-28,John E Geller Jr,Marriott Vacations Worldwide,6,6,1,13,
2025-08-28,Karl G. Glassman,Leggett & Platt,0,4,0,4,
2025-08-28,Bruce K Thorn,Big Lots,3,5,2,10,
2025-08-28,Jonathan H Weis,Weis Markets,11,28,0,39,
2025-08-28,Jeffrey B Guldner,Pinnacle West Capital,1,4,0,5,
2025-08-28,Arkadiy Dobkin,EPAM Systems,10,16,2,28,
2025-08-28,Paul M Rady,Antero Resources,3,8,0,11,
2025-08-28,Michael Spanos,Bloomin Brands,1,8,1,10,
2025-08-28,Nicole A Kivisto,MDU Resources Group,3,7,0,10,
2025-08-28,Gerald L Morgan,Texas Roadhouse,2,3,3,8,
2025-08-28,Gabriel Tirador,Mercury General,3,5,2,10,
2025-08-28,Nicholas I Fink,Fortune Brands Innovations,3,3,0,6,
2025-08-28,Paul E Burdiss,Zions Bancorp,1,1,0,2,
2025-08-28,William J Christensen,JELD-WEN Holding,3,7,0,10,
2025-08-28,Evan Spiegel,Snap Inc,19,17,4,40,
2025-08-28,Bill Burns,Zebra Technologies,7,25,1,33,
2025-08-28,Steven Sell,Agilon Health,1,5,2,8,
2025-08-28,Richard M Olson,Toro Company,1,11,0,12,
2025-08-28,Eric S Yuan,Zoom Video Communications,5,8,0,13,
2025-08-28,Dan L Batrack,Tetra Tech,2,6,1,9,
2025-08-28,Joseph D Russell Jr,Public Storage,0,9,0,9,
2025-08-28,Jacob Thaysen,Illumina inc,6,6,0,12,
2025-08-28,Debra A Cafaro,Ventas inc,7,5,0,12,
2025-08-28,Pierre R Brondeau,FMC Corporation,1,4,0,5,
2025-08-28,Judy R McReynolds,ArcBest,6,12,1,19,
2025-08-28,Russell J Weiner,Dominos Pizza inc,0,0,0,0,
2025-08-28,Theodore S Hanson,ASGN,0,3,0,3,
2025-08-28,RJ Scaringe,Rivian Automotive,8,28,4,40,
2025-08-28,Jeffrey N Simmons,Elanco Animal Health,3,4,1,8,
2025-08-28,Tim O Shaughnessy,Graham Holdings Company,2,7,0,9,
2025-08-28,Thomas V Taylor,Floor & Decor,1,1,2,4,
2025-08-28,Neil A Schrimsher,Applied Industrial Technologies,7,23,1,31,
2025-08-28,Robert E Price,PriceSmart,4,6,0,10,
2025-08-28,John David Risher,Lyft,4,6,0,10,
2025-08-28,Gary B Smith,Ciena,3,9,0,12,
2025-08-28,Joey Levin,IAC,7,29,1,37,
2025-08-28,Jim Jacobs,Country Financial,7,3,1,11,
2025-08-28,Devin B McGranahan,Western Union,1,5,0,6,
2025-08-28,R Scott Rowe,Flowserve,3,6,1,10,
2025-08-28,Kenneth A Vecchione,Western Alliance Bancorp,0,0,1,1,
2025-08-28,John C Rademacher,Option Care Health,6,3,0,9,
2025-08-28,Doug Black,SiteOne Landscape Supply,3,23,1,27,
2025-08-28,Oliver G Brewer III,Topgolf Callaway Brands,2,0,0,2,
2025-08-28,Glenn Sanford,eXp World,14,22,4,40,
2025-08-28,Fran Horowitz,Abercrombie & Fitch,13,22,5,40,
2025-08-28,Kevin Akers,Atmos Energy,7,2,1,10,
2025-08-28,Alessandro Maselli,Catalent,4,11,2,17,
2025-08-28,J Powell Brown,Brown & Brown,11,23,6,40,
2025-08-28,Aman Bhutani,GoDaddy,16,22,2,40,
2025-08-28,John C. Griffith,American Water Works,1,3,0,4,
2025-08-28,John J Marchioni,Selective Insurance Group,4,15,2,21,
2025-08-28,Lawson E Whiting,Brown-Forman,1,7,1,9,
2025-08-28,Dave Peacock,Advantage Solutions,21,6,0,27,
2025-08-28,Mick Farrell,ResMed,16,21,3,40,
2025-08-28,Kamal Hathi,Splunk,1,4,0,5,
2025-08-28,Todd Kelsey,Plexus,2,8,0,10,
2025-08-28,Phillip D Yeager,Hub Group,3,6,0,9,
2025-08-28,Steven B Hedlund,Lincoln Electric,5,9,0,14,
2025-08-28,Timothy C Oliver,NCR Atleos,0,1,0,1,
2025-08-28,Bruce Fleming,Calumet,2,8,0,10,
2025-08-28,Daniel S. Peyovich,Dycom Industries,1,5,1,7,
2025-08-28,Avner M Applbaum,Valmont Industries,0,8,2,10,
2025-08-28,Kimberly A Fields,ATI inc,5,11,0,16,
2025-08-28,Khozema Z Shipchandler,Twilio,0,2,1,3,
2025-08-28,Gary C Bhojwani,CNO Financial Group,1,7,1,9,
2025-08-28,William Andrew Hendricks Jr,Patterson-UTI Energy,0,0,0,0,
2025-08-28,Kevin D Hochman,Brinker International,1,4,1,6,
2025-08-28,James C Foster,Charles River Laboratories International,2,9,0,11,
2025-08-28,Rajiv K Prasad,Hyster-Yale,3,5,0,8,
2025-08-28,Eric T Steigerwalt,Brighthouse Financial,1,4,0,5,
2025-08-28,Thomas L Ryan,Service Corp International,5,5,0,10,
2025-08-28,Charles M Nifong Jr,CrossAmerica Partners,0,0,0,0,
2025-08-28,Anirudh Devgan,Cadence,8,27,3,38,
2025-08-28,Andi Owen,MillerKnoll,15,15,10,40,
2025-08-28,Sumit Roy,Realty Income,13,20,2,35,
2025-08-28,Timothy John Fitzgerald,Middleby,0,0,0,0,
2025-08-28,Robert H Schottenstein,M/I Homes,2,10,0,12,
2025-08-28,Stephen P MacMillan,Hologic,2,6,0,8,
2025-08-28,Lisa M Barton,Alliant Energy,6,0,0,6,
2025-08-28,Aaron P Jagdfeld,Generac,1,5,1,7,
2025-08-28,Erik Gershwind,MSC Industrial Direct,2,6,2,10,
2025-08-28,Varun Krishna,Rocket Companies,7,32,1,40,
2025-08-28,Fahmi Karam,Upbound Group,4,5,0,9,
2025-08-28,NADominic Ng,East West Bancorp,0,0,0,0,
2025-08-28,Mark Wang,Hilton Grand Vacations,38,2,0,40,
2025-08-28,Robert J Sheedy Jr,Grocery Outlet Holding,0,0,0,0,
2025-08-28,Simon D Campion,Dentsply Sirona,0,3,0,3,
2025-08-28,Jeremy Wensinger,V2X,7,9,0,16,
2025-08-28,Andrew Rees,Crocs,17,16,7,40,
2025-08-28,David M Maura,Spectrum Brands,6,2,1,9,
2025-08-28,Sachin S Lawande,Visteon,0,1,0,1,
2025-08-28,Neil M Ashe,Acuity Brands,1,7,0,8,
2025-08-28,Lorie L Tekorius,Greenbrier,1,8,1,10,
2025-08-28,John R Ciulla,Webster Financial,4,5,0,9,
2025-08-28,Sean D Keohane,Cabot Corporation,3,5,0,8,
2025-08-28,Drew M Wilkerson,RXO inc,1,0,0,1,
2025-08-28,Daniel E Brown,Chord Energy,1,1,0,2,
2025-08-28,Javier D Ferrer Fernandez,Popular inc,0,1,0,1,
2025-08-28,Olivier Rabiller,Garrett Motion inc,4,9,0,13,
2025-08-28,Ronald N Tutor,Tutor Perini Corporation,1,7,1,9,
2025-08-28,Jeff Liaw,Copart,4,4,1,9,
2025-08-28,Aman Narang,Toast inc,4,6,1,11,
2025-08-28,Joseph M Hogan,Align Technology,2,3,1,6,
2025-08-28,Kevin J Wheeler,A O Smith,0,14,1,15,
2025-08-28,Christopher A Cartwright,TransUnion,2,0,1,3,
2025-08-28,James Kelly,NCR Voyix,2,11,0,13,
2025-08-28,Tom Leighton,Akamai Technologies,13,18,5,36,
2025-08-28,Robert G Painter,Trimble,5,2,0,7,
2025-08-28,Tony Helton,Medical Mutual of Ohio,1,3,1,5,
2025-08-28,Caroline S Grace,AMN Healthcare Services,0,0,0,0,
2025-08-28,Patrick Kaltenbach,Mettler-Toledo International,3,7,0,10,
2025-08-28,Michael L Baur,ScanSource,0,5,0,5,
2025-08-28,Jason Lippert,LCI Industries,5,11,0,16,
2025-08-28,Fredric J Tomczyk,Cboe Global Markets,2,4,1,7,
2025-08-28,Octavio Marquez,Diebold Nixdorf,6,14,1,21,
2025-08-28,Sivasankaran Somasundaram,ChampionX,6,1,0,7,
2025-08-28,Ronald F Clarke,Corpay,2,1,0,3,
2025-08-28,Robert W Pittman,iHeartMedia,5,2,0,7,
2025-08-28,Patrick Zalupski,Dream Finders Homes,25,13,2,40,
2025-08-28,Keith E Smith,Boyd Gaming,1,7,1,9,
2025-08-28,Mehran Assadi,NLV Financial,1,1,0,2,
2025-08-28,Barry R Port,Ensign Group,2,5,1,8,
2025-08-28,Denise A Paulonis,Sally Beauty,1,3,0,4,
2025-08-28,Clifford A Skelton,Conduent,0,0,0,0,
2025-08-28,Jean-Michel Ribieras,Sylvamo,3,7,0,10,
2025-08-28,Douglas F Bauer,Tri Pointe Homes,0,4,0,4,
2025-08-28,Shawn O'Connell,EnerSys,3,5,0,8,
2025-08-28,Bill Meury,Incyte,10,16,0,26,
2025-08-28,Dale Francescon,Century Communities,1,10,1,12,
2025-08-28,Michael Nierenberg,Rithm Capital,6,25,1,32,
2025-08-28,Michael J Brown,Euronet Worldwide,2,8,0,10,
2025-08-28,Scott Seu,Hawaiian Electric Industries,6,16,3,25,
2025-08-28,Jason D Robins,DraftKings,5,3,0,8,
2025-08-28,Jonathan J Mazelsky,IDEXX Laboratories,1,3,2,6,
2025-08-28,Richard S Swartz,MYR Group,1,2,0,3,
2025-08-28,Stefano Caroti,Deckers Outdoor,0,8,1,9,
2025-08-28,Kevin R Sayer,DexCom,2,5,0,7,
2025-08-28,John T C Lee,MKS Instruments,5,8,0,13,
2025-08-28,Edward B Pitoniak,VICI Properties,1,7,0,8,
2025-08-28,Albert White III,Cooper Cos,0,0,0,0,
2025-08-28,Barry L Biffle,Frontier Airlines,1,7,6,14,
2025-08-28,Robert A Bruggeworth,Qorvo,4,4,0,8,
2025-08-28,Winnie Park,Five Below,10,27,3,40,
2025-08-28,Steven Oakland,TreeHouse Foods,3,12,0,15,
2025-08-28,James S Hagedorn,Scotts Miracle-Gro,1,1,0,2,
2025-08-28,Michael Cannon-Brookes,Atlassian,22,15,2,39,
2025-08-28,Bertrand Loy,Entegris,3,11,1,15,
2025-08-28,William E Waltz,Atkore,2,8,0,10,
2025-08-28,Celeste B Mastin,H B Fuller,1,4,0,5,
2025-08-28,Kyle T Larkin,Granite Construction,1,7,0,8,
2025-08-28,Michael J Happe,Winnebago Industries,1,4,0,5,
2025-08-28,Steven H Gunby,FTI Consulting,6,12,0,18,
2025-08-28,Stephan B Tanda,AptarGroup,1,4,3,8,
2025-08-28,Timothy P Boyle,Columbia Sportswear,3,3,2,8,
2025-08-28,Anthony J Wood,Roku,5,3,1,9,
2025-08-28,M Christopher Doyle,Civitas Resources,1,2,0,3,
2025-08-28,Jeffrey J Jones II,H&R Block,3,3,7,13,
2025-08-28,Andy Eidson,Alpha Metallurgical Resources,1,7,1,9,
2025-08-28,Andy L Nemeth,Patrick Industries,4,2,0,6,
2025-08-28,Roger W Jenkins,Murphy Oil,3,15,0,18,
2025-08-28,Kevin S Blair,Synovus Financial,7,2,0,9,
2025-08-28,Julie Felss Masino,Cracker Barrel Old Country Store,7,20,13,40,
2025-08-28,David M Overton,Cheesecake Factory,1,9,0,10,
2025-08-28,Nick DeIuliis,CNX Resources,11,3,2,16,
2025-08-28,Christopher Pappas,Chefs Warehouse,3,8,1,12,
2025-08-28,Tod Carpenter,Donaldson Company,2,7,0,9,
2025-08-28,Gregory L Christopher,Mueller Industries,2,6,0,8,
2025-08-28,Rob Saltiel,MRC Global,5,13,2,20,
2025-08-28,Jillian C Evanko,Chart Industries,3,6,0,9,
2025-08-28,Dave Guilmette,Alight Solutions,2,8,0,10,
2025-08-28,Joel Smejkal,Vishay Intertechnology,5,4,1,10,
2025-08-28,Dennis Degner,Range Resources,4,6,0,10,
2025-08-28,Ira D Robbins,Valley National Bancorp,0,3,0,3,
2025-08-28,Bernard Kim,Match Group,15,18,7,40,
2025-08-28,Vincent Pilette,Gen Digital,2,12,1,15,
2025-08-28,Timothy S Crane,Wintrust Financial,2,7,0,9,
2025-08-28,Pat Roche,Moog inc,5,11,1,17,
2025-08-28,Mark R Widmar,First Solar,4,6,2,12,
2025-08-28,Niko Lahanas,Central Garden & Pet,1,13,0,14,
2025-08-28,Chris Osowski,Green Plains inc,6,14,1,21,
2025-08-28,Derek J Leathers,Werner Enterprises,1,7,2,10,
2025-08-28,Adam Foroughi,AppLovin,10,26,4,40,
2025-08-28,Luca Savi,ITT,3,5,0,8,
2025-08-28,Lawrence H Silber,Herc Rentals,0,0,0,0,
2025-08-28,Hilton H Howell Jr,Gray Television,7,19,1,27,
2025-08-28,Eric D Ashleman,IDEX,0,7,1,8,
2025-08-28,Owen D Thomas,Boston Properties,2,8,0,10,
2025-08-28,Kurt Wolf,Pitney Bowes,5,18,2,25,
2025-08-28,Sara E Armbruster,Steelcase,1,0,0,1,
2025-08-28,Charles D. Young,Sun Communities,2,6,0,8,
2025-08-28,Suzanne Foster,AdaptHealth,4,11,1,16,
2025-08-28,Grant E Sims,Genesis Energy,5,3,0,8,
2025-08-28,Laura Prieskorn,Jackson Financial,3,5,2,10,
2025-08-28,Rick L Wessel,FirstCash,3,5,1,9,
2025-08-28,Sherman Miller,Cal-Maine Foods,11,28,1,40,
2025-08-28,Paul A Lang,Arch Resources,4,3,1,8,
2025-08-28,Ashish K Khandpur,Avient,2,5,0,7,
2025-08-28,Shyam K Reddy,BlueLinx,1,7,0,8,
2025-08-28,Christopher S Ripley,Sinclair,1,8,0,9,
2025-08-28,Stacy Kymes,BOK Financial,8,5,0,13,
2025-08-28,James H Walter,Permian Resources,1,1,0,2,
2025-08-28,Jason Murray,PACS Group,5,12,3,20,
2025-08-28,Brian Armstrong,Coinbase Global,14,21,5,40,
2025-08-28,Oscar K Brown,Western Midstream Partners,1,3,0,4,
2025-08-28,Nicholas R Lower,Federated Mutual Insurance,0,1,0,1,
2025-08-28,Morris Goldfarb,G-III Apparel Group,12,23,5,40,
2025-08-28,Mark D Morelli,Vontier,0,6,0,6,
2025-08-28,Matthew J Cox,Matson inc,0,5,0,5,
2025-08-28,David W Grzebinski,Kirby Corporation,0,3,0,3,
2025-08-28,Keith A Harvey,Kaiser Aluminum,4,4,1,9,
2025-08-28,Eric Nyman,Vista Outdoor,4,11,1,16,
2025-08-28,Doug Howe,Designer Brands,4,19,0,23,
2025-08-28,Jerry E Gahlhoff Jr,Rollins inc,0,2,0,2,
2025-08-28,D Scott Barbour,Advanced Drainage Systems,4,3,0,7,
2025-08-28,Sean Gamble,Cinemark,19,20,1,40,
2025-08-28,George Kurtz,CrowdStrike,17,21,2,40,
2025-08-28,Bill Ready,Pinterest,25,15,0,40,
2025-08-28,Fidji Simo,Instacart,10,29,1,40,
2025-08-28,Kimberly K Ryan,Hillenbrand,2,6,0,8,
2025-08-28,David S Graziosi,Allison Transmission,3,14,2,19,
2025-08-28,Gary G Friedman,Restoration Hardware,2,5,0,7,
2025-08-28,Lucinda M Baier,Brookdale Senior Living,4,2,1,7,
2025-08-28,Brian J Blaser,QuidelOrtho,1,9,0,10,
2025-08-28,E Jean Savage,Trinity Industries,0,8,1,9,
2025-08-28,Liam J Kelly,Teleflex,1,5,1,7,
2025-08-28,Laurans A Mendelson,HEICO,9,19,2,30,
2025-08-28,Frank H Laukien,Bruker,1,10,0,11,
2025-08-28,Harvey M Schwartz,Carlyle Group,8,13,0,21,
2025-08-28,Mark S LaVigne,Energizer,3,0,0,3,
2025-08-28,Joel Quadracci,Quad/Graphics,9,26,5,40,
2025-08-28,Amar Maletira,Rackspace Technology,4,9,3,16,
2025-08-28,Udit Batra,Waters Corporation,12,24,1,37,
2025-08-28,Eric M Green,West Pharmaceutical Services,0,9,0,9,
2025-08-28,Doug Palladini,Carters inc,2,2,2,6,
2025-08-28,G Mike Mikan,NeueHealth,3,2,0,5,
2025-08-28,Russell ChipChilds,SkyWest,0,0,0,0,
2025-08-28,Christopher H Hunter,Acadia Healthcare,0,2,0,2,
2025-08-28,Prahlad Singh,Revvity,2,7,0,9,
2025-08-28,Maria M Pope,Portland General Electric,1,3,0,4,
2025-08-28,Charles Chip Blankenship,Woodward inc,0,2,0,2,
2025-08-28,Mike Steib,TEGNA,15,19,2,36,
2025-08-28,Kurt J Ekert,Sabre Corporation,0,1,0,1,
2025-08-28,Matt Wilson,Light & Wonder,16,20,4,40,
2025-08-28,Rob Katz,Vail Resorts,2,14,24,40,
2025-08-28,Schnitzer Steel Industries,Radius Recycling,8,25,5,38,
2025-08-28,David A Spector,PennyMac Financial Services,3,0,0,3,
2025-08-28,Frederick J Holzgrefe III,Saia inc,1,2,0,3,
2025-08-28,Mark J Parrell,Equity Residential,3,7,1,11,
2025-08-28,John W Lindsay,Helmerich & Payne,1,4,0,5,
2025-08-28,Gary D Burnison,Korn Ferry,4,13,0,17,
2025-08-28,Timothy J McGrath,PC Connection,2,4,0,6,
2025-08-28,Lynn M Bamford,Curtiss-Wright,11,6,0,17,
2025-08-28,Jonathan W Witter,Sallie Mae,0,0,0,0,
2025-08-28,Jeff Benck,Benchmark Electronics,1,8,0,9,
2025-08-28,Charles H Giancarlo,Pure Storage,1,3,0,4,
2025-08-28,Brian R Gray,Knife River Corporation,0,2,0,2,
2025-08-28,Jay Schmidt,Caleres inc,3,4,2,9,
2025-08-28,Dale Asplund,BrightView Holdings,0,5,0,5,
2025-08-28,Jeffrey S Edwards,Cooper-Standard,0,6,0,6,
2025-08-28,Glenn J Williams,Primerica,6,2,2,10,
2025-08-28,Francois Locoh-Donou,F5,4,20,3,27,
2025-08-28,Joseph Wm Foran,Matador Resources,7,9,0,16,
2025-08-28,Sridhar Ramaswamy,Snowflake inc,14,22,2,38,
2025-08-28,Mark D Dankberg,Viasat,2,4,2,8,
2025-08-28,Francisco J Leon,California Resources,1,2,1,4,
2025-08-28,Peter Stern,Peloton,17,19,4,40,
2025-08-28,David Baszucki,Roblox,12,18,10,40,
2025-08-28,Jeffrey W Edwards,Installed Building Products,2,3,0,5,
2025-08-28,Clark Lauritzen,First National of Nebraska,1,7,0,8,
2025-08-28,Carlos Alberini,Guess inc,12,27,1,40,
2025-08-28,Shyam P Kambeyanda,ESAB,3,4,0,7,
2025-08-28,Edmund Shallcross III,Amica Mutual Insurance,1,4,0,5,
2025-08-28,Benjamin W Schall,AvalonBay Communities,1,7,1,9,
2025-08-28,Allan C Thygesen,DocuSign,2,6,0,8,
2025-08-28,Bryan J Knutson,Titan Machinery,1,0,0,1,
2025-08-28,Heath Sampson,ModivCare,7,2,1,10,
2025-08-28,Ara K Hovnanian,Hovnanian Enterprises,1,17,2,20,
2025-08-28,Joshua G Silverman,Etsy,2,3,0,5,
2025-08-28,Kevin Roycraft,Adams Resources & Energy,7,2,1,10,
2025-08-28,J Eric Evans,Surgery Partners,0,3,0,3,
2025-08-28,Clint E Stein,Columbia Banking System,1,6,0,7,
2025-08-28,Lee M Shavel,Verisk,3,6,0,9,
2025-08-28,Dave Banyard Jr,MasterBrand,0,0,0,0,
2025-08-28,Peter R Ingram,Hawaiian Airlines inc,1,1,0,2,
2025-08-28,Kristin A Dolan,AMC Networks,3,2,0,5,
2025-08-28,Brendan T Cavanagh,SBA Communications,1,2,0,3,
2025-08-28,George F Chappelle Jr,Americold Realty Trust,1,3,0,4,
2025-08-28,Thomas E Gottwald,NewMarket Corporation,2,8,0,10,
2025-08-28,Thomas J Baltimore Jr,Park Hotels & Resorts,4,25,0,29,
2025-08-28,Peter M Moglia,Alexandria Real Estate Equities,4,6,0,10,
2025-08-28,Ronald J Kramer,Griffon Corporation,2,5,0,7,
2025-08-28,John L Plueger,Air Lease,3,11,0,14,
2025-08-28,Jennifer F Scanlon,UL Solutions,3,5,0,8,
2025-08-28,Greg Smith,Teradyne,2,9,1,12,
2025-08-28,Sean Trauschke,OGE Energy,16,5,0,21,
2025-08-28,Norman D Schwartz,Bio-Rad Laboratories,1,1,1,3,
2025-08-28,Scott Doyle,Spire inc,4,5,1,10,
2025-08-28,Michael E Reed,Gannett,0,5,1,6,
2025-08-28,Cindy J Miller,Stericycle,2,5,1,8,
2025-08-28,Phillip D Green,Cullen Frost Bankers,1,4,2,7,
2025-08-28,Joseph D Margolis,Extra Space Storage,0,10,0,10,
2025-08-28,Mark A Skonieczny,REV Group,6,2,0,8,
2025-08-28,Ladd Wilks,ProFrac Holding,4,3,1,8,
2025-08-28,Sundaram Nagarajan,Nordson,2,11,1,14,
2025-08-28,Anne P Noonan,Summit Materials,0,1,0,1,
2025-08-28,Lori Flees,Valvoline inc,4,6,2,12,
2025-08-28,Scott H Baxter,Kontoor Brands,2,4,0,6,
2025-08-28,Tim Larson,Skyline Champion,8,0,0,8,
2025-08-28,Chuck Divita,Teladoc Health,10,16,4,30,
2025-08-28,W Bradley Southern,Louisiana-Pacific Corporation,0,1,0,1,
2025-08-28,George C Freeman III,Universal Corporation,4,6,0,10,
2025-08-28,James A Brock,Consol Energy,1,0,0,1,
2025-08-28,Robert Antokol,Playtika Holding,1,7,1,9,
2025-08-28,Joe Craft,Alliance Resource Partners,6,11,1,18,
2025-08-28,Paul Keel,Envista,2,8,1,11,
2025-08-28,Jared Isaacman,Shift4 Payments,10,26,4,40,
2025-08-28,Mark Mac McFarland,Talen Energy,5,1,1,7,
2025-08-28,Tony R Thene,Carpenter Technology,3,10,0,13,
2025-08-28,Melissa D Smith,WEX,3,6,0,9,
2025-08-28,James Jim C Ryan III,Old National Bancorp,1,0,0,1,
2025-08-28,Peter J Federico,AGNC Investment,2,0,0,2,
2025-08-28,Brent L Yeagy,Wabash National,0,1,0,1,
2025-08-28,Henry A Fernandez,MSCI,4,14,0,18,
2025-08-28,Mark Penn,Stagwell,12,25,2,39,
2025-08-28,Julie Schertell,Mativ,3,8,0,11,
2025-08-28,Ashish Chand,Belden,2,5,2,9,
2025-08-28,Greg Anderson,Allegiant Travel Company,4,6,0,10,
2025-08-28,Drew Houston,Dropbox,14,18,8,40,
2025-08-28,Kevin T Conroy,Exact Sciences,2,5,1,8,
2025-08-28,Rex D Geveden,BWX Technologies,3,8,0,11,
2025-08-28,Scott R Wells,Clear Channel Outdoor Hldgs,0,0,0,0,
2025-08-28,Paul Bay,Ingram Micro,12,24,4,40,
2025-08-29,Doug McMillon,Walmart,16,19,5,40,
2025-08-29,Andrew Jassy,Amazon,3,30,7,40,
2025-08-29,Tim Cook,Apple,16,19,5,40,
2025-08-29,Stephen Hemsley,UnitedHealth,8,27,5,40,
2025-08-29,Warren Buffett,Berkshire Hathaway,10,22,8,40,
2025-08-29,David Joyner,CVS Health,8,27,5,40,
2025-08-29,Darren Woods,Exxon Mobil,9,24,7,40,
2025-08-29,Sundar Pichai,Alphabet,18,16,6,40,
2025-08-29,Brian Tyler,McKesson,4,16,5,25,
2025-08-29,Robert Mauch,Cencora,2,8,0,10,
2025-08-29,Ron Vachris,Costco,5,33,2,40,
2025-08-29,Jamie Dimon,JPMorgan Chase,10,16,14,40,
2025-08-29,Satya Nadella,Microsoft,13,18,9,40,
2025-08-29,Jason Hollar,Cardinal Health,14,22,4,40,
2025-08-29,Mike Wirth,Chevron,18,16,6,40,
2025-08-29,David Cordani,Cigna,22,15,3,40,
2025-08-29,Jim Farley,Ford Motor,11,24,5,40,
2025-08-29,Brian Moynihan,Bank of America,5,28,7,40,
2025-08-29,Mary Barra,General Motors,14,22,4,40,
2025-08-29,Gail Boudreaux,Elevance Health,16,17,7,40,
2025-08-29,Jane Fraser,Citigroup,12,23,5,40,
2025-08-29,Sarah London,Centene,13,18,9,40,
2025-08-29,Ted Decker,Home Depot,9,25,6,40,
2025-08-29,Maryann Mannen,Marathon Petroleum,5,13,1,19,
2025-08-29,Ron Sargent,Kroger,5,21,14,40,
2025-08-29,Mark Lashier,Phillips 66,10,22,6,38,
2025-08-29,Priscilla Almodovar,Fannie Mae,11,18,11,40,
2025-08-29,Tim Wentworth,Walgreens,7,23,9,39,
2025-08-29,Lane Riggs,Valero Energy,14,8,0,22,
2025-08-29,Mark Zuckerberg,Meta,7,22,11,40,
2025-08-29,Hans Vestberg,Verizon,15,20,5,40,
2025-08-29,John Stankey,AT&T,11,26,3,40,
2025-08-29,Brian Roberts,Comcast,11,26,3,40,
2025-08-29,Charles Scharf,Wells Fargo,29,6,5,40,
2025-08-29,David Solomon,Goldman Sachs,7,22,11,40,
2025-08-29,Michael Hutchins,Freddie Mac,2,11,3,16,
2025-08-29,Michael Fiddelke,Target,11,22,7,40,
2025-08-29,Jim Rechtin,Humana,18,17,5,40,
2025-08-29,Jon Farney,State Farm Insurance,1,12,3,16,
2025-08-29,Elon Musk,Tesla,8,17,15,40,
2025-08-29,Ted Pick,Morgan Stanley,16,22,2,40,
2025-08-29,Joaquin Duato,Johnson & Johnson,11,24,5,40,
2025-08-29,Juan Luciano,Archer Daniels Midland,4,20,13,37,
2025-08-29,Ramon Laguarta,PepsiCo,6,28,6,40,
2025-08-29,Carol Tom√©,UPS,9,21,10,40,
2025-08-29,Rajesh Subramaniam,FedEx,9,28,0,37,
2025-08-29,Bob Iger,Walt Disney,7,30,3,40,
2025-08-29,Michael Dell,Dell Technologies,13,21,6,40,
2025-08-29,Marvin Ellison,Lowes,13,24,2,39,
2025-08-29,Jon Moeller,Procter & Gamble,5,28,7,40,
2025-08-29,Thomas Long,Energy Transfer,8,0,2,10,
2025-08-29,Kelly Ortberg,Boeing,10,26,4,40,
2025-08-29,Susan Morris,Albertsons,12,25,3,40,
2025-08-29,Kevin Hourican,Sysco,10,27,3,40,
2025-08-29,Christopher Calio,RTX,7,11,0,18,
2025-08-29,Larry Culp,General Electric,12,25,3,40,
2025-08-29,James Taiclet,Lockheed Martin,11,20,9,40,
2025-08-29,Stephen Squeri,American Express,15,23,2,40,
2025-08-29,Joe Creed,Caterpillar,11,27,2,40,
2025-08-29,Michel Khalaf,MetLife,11,17,0,28,
2025-08-29,Samuel Hazen,HCA Healthcare,8,5,0,13,
2025-08-29,Tricia Griffith,Progressive Insurance,10,26,4,40,
2025-08-29,Arvind Krishna,IBM,13,21,6,40,
2025-08-29,John May,Deere,10,25,5,40,
2025-08-29,Jensen Huang,Nvidia,12,26,2,40,
2025-08-29,Philip Smith,StoneX,0,9,1,10,
2025-08-29,Robert M Davis,Merck,4,19,0,23,
2025-08-29,Ryan Lance,ConocoPhillips,18,19,3,40,
2025-08-29,Albert Bourla,Pfizer,18,12,10,40,
2025-08-29,Ed Bastian,Delta Air Lines,11,19,10,40,
2025-08-29,Patrick Zammit,TD Synnex,11,15,0,26,
2025-08-29,Kevin Murphy,Publix Super Markets,9,23,1,33,
2025-08-29,Thomas J Wilson,Allstate,0,9,1,10,
2025-08-29,Chuck Robbins,Cisco Systems,14,24,2,40,
2025-08-29,Kirt Walker,Nationwide,14,16,2,32,
2025-08-29,Christopher Winfrey,Charter Communications,5,16,5,26,
2025-08-29,Bob Michael,AbbVie,0,0,0,0,
2025-08-29,Craig DeSanto,New York Life Insurance,3,17,0,20,
2025-08-29,Lip-Bu Tan,Intel,9,14,17,40,
2025-08-29,Ernie Herrman,TJX,14,24,2,40,
2025-08-29,Andrew Sullivan,Prudential Financial,12,21,0,33,
2025-08-29,Enrique Lores,Hewlett Packard,11,17,7,35,
2025-08-29,Scott Kirby,United Airlines,34,3,3,40,
2025-08-29,George Holm,Performance Food,11,21,2,34,
2025-08-29,Donnie King,Tyson Foods,10,25,5,40,
2025-08-29,Robert Isom,American Airlines,7,26,7,40,
2025-08-29,Timothy M Sweeney,Liberty Mutual Insurance,14,0,0,14,
2025-08-29,Elliott Hill,Nike,10,26,4,40,
2025-08-29,Safra Catz,Oracle,12,21,7,40,
2025-08-29,AJ Jim Teague,Enterprise Products Partners,3,7,0,10,
2025-08-29,Richard Fairbank,Capital One,15,22,3,40,
2025-08-29,Wilfred Chiang,Plains GP,0,1,0,1,
2025-08-29,Michael Kasbar,World Kinect,1,9,0,10,
2025-08-29,Peter Zaffino,American International Group,8,28,4,40,
2025-08-29,James Quincey,The Coca-Cola Company,9,28,3,40,
2025-08-29,Thasunda Brown Duckett,TIAA,20,20,0,40,
2025-08-29,Jay Debertin,CHS,3,8,4,15,
2025-08-29,Chris Boerner,Bristol-Myers Squibb,10,23,7,40,
2025-08-29,Corie Barry,Best Buy,38,1,0,39,
2025-08-29,Marc Casper,Thermo Fisher Scientific,14,23,3,40,
2025-08-29,Roger Crandall,Mass Mutual,3,7,0,10,
2025-08-29,Juan Andrade,USAA,5,16,0,21,
2025-08-29,Phebe Novakovic,General Dynamics,28,9,3,40,
2025-08-29,Alan Schnitzer,Travelers Insurance,3,4,2,9,
2025-08-29,David Zaslav,Warner Bros Discovery,6,21,12,39,
2025-08-29,Gunjan Kedia,US Bancorp,14,24,2,40,
2025-08-29,Robert Ford,Abbott Laboratories,11,24,5,40,
2025-08-29,Kathy Warden,Northrop Grumman,15,21,4,40,
2025-08-29,Tim Gerend,Northwestern Mutual,14,25,1,40,
2025-08-29,Todd Vasos,Dollar General,5,28,7,40,
2025-08-29,Matthew Lucey,PBF Energy,7,3,0,10,
2025-08-29,Dara Khosrowshahi,Uber,12,20,7,39,
2025-08-29,Vimal Kapur,Honeywell,11,29,0,40,
2025-08-29,Dirk Van de Put,Mondelez,10,27,3,40,
2025-08-29,Brian Niccol,Starbucks,11,29,0,40,
2025-08-29,Cristiano Amon,Qualcomm,12,27,1,40,
2025-08-29,Hock Tan,Broadcom,10,26,4,40,
2025-08-29,David Flitman,US Foods,2,7,0,9,
2025-08-29,Paul Romanowski,DR Horton,5,16,4,25,
2025-08-29,Jacek Olczak,Philip Morris,14,22,4,40,
2025-08-29,Preston Feight,Paccar,10,29,1,40,
2025-08-29,Marc Benioff,Salesforce,9,22,9,40,
2025-08-29,Leon Topalian,Nucor,16,22,2,40,
2025-08-29,Michael Dastoor,Jabil,1,7,0,8,
2025-08-29,Jonathan Jaffe,Lennar,1,8,1,10,
2025-08-29,David Ricks,Eli Lilly,10,21,9,40,
2025-08-29,Joe Zubretsky,Molina Healthcare,8,6,4,18,
2025-08-29,Jennifer Rumsey,Cummins,8,26,6,40,
2025-08-29,Robin Vince,Bank of New York Mellon,19,18,3,40,
2025-08-29,Ted Sarandos,Netflix,13,24,3,40,
2025-08-29,William H Rogers Jr,Truist Financial,2,7,1,10,
2025-08-29,Sean Kerins,Arrow Electronics,2,14,0,16,
2025-08-29,William M Brown,3M,2,8,0,10,
2025-08-29,Ryan McInerney,Visa,16,20,4,40,
2025-08-29,Marc Rowan,Apollo Global Management,19,17,4,40,
2025-08-29,Tim Go,HF Sinclair,5,3,0,8,
2025-08-29,Robert Sulentic,CBRE Group,1,7,1,9,
2025-08-29,William Demchak,PNC Financial Services,12,22,6,40,
2025-08-29,Bryan DeBoer,Lithia Motors,10,28,1,39,
2025-08-29,William Nash,CarMax,4,4,2,10,
2025-08-29,Brian Robbins,Paramount Global,6,30,0,36,
2025-08-29,Michael Creedon,Dollar Tree,3,34,3,40,
2025-08-29,Sandy Douglas,United Natural Foods,33,5,2,40,
2025-08-29,Alex Chriss,PayPal,11,26,3,40,
2025-08-29,Roger Penske,Penske Automotive,18,22,0,40,
2025-08-29,Antonio Neri,Hewlett Packard Enterprise,9,23,8,40,
2025-08-29,Harry Sideris,Duke Energy,36,4,0,40,
2025-08-29,Vicki Hollub,Occidental Petroleum,20,15,4,39,
2025-08-29,Lawrence Coben,NRG Energy,6,2,0,8,
2025-08-29,Robert Bradway,Amgen,10,28,2,40,
2025-08-29,John Ketchum,NextEra Energy,21,19,0,40,
2025-08-29,Rainer Blair,Danaher,6,15,2,23,
2025-08-29,Daniel O'Day,Gilead Sciences,18,18,4,40,
2025-08-29,Michael Manley,AutoNation,3,5,2,10,
2025-08-29,Carlos Abrams-Rivera,Kraft Heinz,15,18,7,40,
2025-08-29,Philip Gallagher,Avnet,1,6,1,8,
2025-08-29,Gary Dickerson,Applied Materials,7,21,12,40,
2025-08-29,Bob Jordan,Southwest Airlines,10,23,7,40,
2025-08-29,Rick Wurster,Charles Schwab,13,22,4,39,
2025-08-29,Lorenzo Simonelli,Baker Hughes,15,21,4,40,
2025-08-29,Chris Kempczinski,McDonalds,10,24,6,40,
2025-08-29,Christopher Womack,Southern Company,3,6,0,9,
2025-08-29,Michael Miebach,Mastercard,12,25,3,40,
2025-08-29,Joseph Dominguez,Constellation Energy,12,11,1,24,
2025-08-29,Christopher Swift,The Hartford,15,22,3,40,
2025-08-29,Patricia Poppe,PG&E,8,16,2,26,
2025-08-29,Bom Kim,Coupang,12,27,1,40,
2025-08-29,Ezra Yacob,EOG Resources,20,13,2,35,
2025-08-29,Jim Vena,Union Pacific,19,21,0,40,
2025-08-29,Matt Schroeder,Rite Aid,4,33,3,40,
2025-08-29,Tony Spring,Macys,10,27,3,40,
2025-08-29,Anthony Capuano,Marriott International,14,23,3,40,
2025-08-29,Raymond E Scott,Lear Corporation,4,5,1,10,
2025-08-29,William Stengel II,Genuine Parts,0,4,0,4,
2025-08-29,Heidi Petz,Sherwin-Williams,8,27,3,38,
2025-08-29,Jeff Miller,Halliburton,11,23,6,40,
2025-08-29,Kathleen Quirk,Freeport-McMoRan,14,17,2,33,
2025-08-29,Michael Rapino,Live Nation Entertainment,14,23,3,40,
2025-08-29,John Doyle,Marsh & McLennan,9,9,0,18,
2025-08-29,Lisa Su,Advanced Micro Devices,17,19,4,40,
2025-08-29,Frank Holding,First Citizens BancShares,8,15,2,25,
2025-08-29,John Engel,WESCO International,5,11,1,17,
2025-08-29,David Gitlin,Carrier Global,13,25,2,40,
2025-08-29,Lourenco Goncalves,Cleveland-Cliffs,8,22,10,40,
2025-08-29,Calvin G Butler Jr,Exelon,5,4,0,9,
2025-08-29,Joseph Bae,KKR,19,19,2,40,
2025-08-29,Christine Leahy,CDW,1,12,2,15,
2025-08-29,Glenn Fogel,Booking Holdings,11,24,5,40,
2025-08-29,Brian Doubles,Synchrony Financial,5,7,2,14,
2025-08-29,Earl Austin,Quanta Services,2,6,2,10,
2025-08-29,Christian Ulbrich,Jones Lang LaSalle,10,21,0,31,
2025-08-29,Saumya Sutaria,Tenet Healthcare,4,4,1,9,
2025-08-29,William Gifford,Altria,2,4,2,8,
2025-08-29,Kevin Lobo,Stryker,12,24,4,40,
2025-08-29,Michael Hsu,Kimberly-Clark,6,6,1,13,
2025-08-29,Jack Fusco,Cheniere Energy,18,19,3,40,
2025-08-29,James Conroy,Ross Stores,4,11,0,15,
2025-08-29,Anthony Smurfit,Smurfit Westrock,3,6,0,9,
2025-08-29,Jeffrey Harmening,General Mills,4,17,4,25,
2025-08-29,Mark Stewart,Goodyear Tire & Rubber,5,33,2,40,
2025-08-29,Bob Eddy,BJs Wholesale Club,5,22,3,30,
2025-08-29,Peter Arduini,GE HealthCare Technologies,6,12,0,18,
2025-08-29,Noel Wallace,Colgate-Palmolive,9,22,2,33,
2025-08-29,Marc Bitzer,Whirlpool,12,13,15,40,
2025-08-29,Chris Kubasik,L3Harris Technologies,7,12,1,20,
2025-08-29,Shantanu Narayen,Adobe,20,19,1,40,
2025-08-29,Thomas Polen,Becton Dickinson,7,3,0,10,
2025-08-29,Richard P Dealy,Pioneer Natural Resources,4,2,0,6,
2025-08-29,Ravi Kumar S,Cognizant Technology Solutions,10,25,3,38,
2025-08-29,Andrew Clyde,Murphy USA,14,25,1,40,
2025-08-29,Mike Lyons,Fiserv,3,12,1,16,
2025-08-29,Jennifer Parmentier,Parker-Hannifin,2,11,0,13,
2025-08-29,William Fehrman,American Electric Power,3,7,0,10,
2025-08-29,Andrew Silvernail,International Paper,6,20,1,27,
2025-08-29,Jonas Prising,ManpowerGroup,7,21,2,30,
2025-08-29,John Zillmer,Aramark,6,15,2,23,
2025-08-29,Mark Millett,Steel Dynamics,19,2,0,21,
2025-08-29,Dan Amos,Aflac,12,20,8,40,
2025-08-29,Tony Cheng,Reinsurance Group of America,3,11,2,16,
2025-08-29,Karsanbhai,Emerson Electric,9,17,2,28,
2025-08-29,Ronald P O'Hanley,State Street,5,12,0,17,
2025-08-29,Timothy Knavish,PPG Industries,1,4,1,6,
2025-08-29,David Burritt,United States Steel,8,19,13,40,
2025-08-29,Maria Black,Automatic Data Processing,4,5,0,9,
2025-08-29,Daryl Kenningham,Group 1 Automotive,8,30,2,40,
2025-08-29,Robert Blue,Dominion Energy,29,10,1,40,
2025-08-29,Larry Fink,BlackRock,7,24,9,40,
2025-08-29,Pierce Norton II,Oneok,4,5,0,9,
2025-08-29,David Bozeman,CH Robinson Worldwide,2,7,0,9,
2025-08-29,Haviv Ilan,Texas Instruments,11,26,3,40,
2025-08-29,Michael Bender,Kohls,2,25,13,40,
2025-08-29,Philip Daniele III,AutoZone,0,2,0,2,
2025-08-29,Timothy Archer,Lam Research,2,7,0,9,
2025-08-29,Charles Magro,Corteva,4,2,1,7,
2025-08-29,Rick Lanoha,Peter Kiewit Sons',0,2,0,2,
2025-08-29,Peter Jackson,Builders FirstSource,5,12,1,18,
2025-08-29,Martin Schroeter,Kyndryl,11,27,0,38,
2025-08-29,Hamid Akhavan,EchoStar,3,26,11,40,
2025-08-29,Bill Westrate,American Family Insurance,9,16,2,27,
2025-08-29,Avigal Soreq,Delek US,4,9,5,18,
2025-08-29,Beth Ford,Land O'Lakes,17,21,2,40,
2025-08-29,Walker Martin,Sempra,0,3,0,3,
2025-08-29,Eric Slifka,Global Partners,11,23,6,40,
2025-08-29,DG Macpherson,WW Grainger,2,7,1,10,
2025-08-29,Bob Pragada,Jacobs Solutions,6,6,0,12,
2025-08-29,Pedro Pizarro,Edison International,15,9,16,40,
2025-08-29,William Hornbuckle,MGM Resorts International,8,24,1,33,
2025-08-29,Andrew McMahon,Guardian Life insurance,6,13,0,19,
2025-08-29,Christopher O'Herlihy,Illinois Tool Works,4,5,1,10,
2025-08-29,James Cracchiolo,Ameriprise Financial,2,21,2,25,
2025-08-29,Ryan Marshall,PulteGroup,14,13,10,37,
2025-08-29,Matthew Meloy,Targa Resources,6,4,0,10,
2025-08-29,Michael Rhodes,Ally Financial,11,24,5,40,
2025-08-29,Joseph Fadool,BorgWarner,4,10,0,14,
2025-08-29,St√©phane de La Faverie,Est√©e Lauder,12,23,5,40,
2025-08-29,Benjamin Tisch,Loews,2,7,0,9,
2025-08-29,Brad Beckham,O'Reilly Automotive,4,14,1,19,
2025-08-29,Thomas Gayner,Markel Group,2,8,0,10,
2025-08-29,Donald Allan,Stanley Black & Decker,7,32,1,40,
2025-08-29,Sanjay Mehrotra,Micron Technology,16,22,2,40,
2025-08-29,James Breuer,Fluor,0,2,1,3,
2025-08-29,Thomas Bell,Leidos,8,18,2,28,
2025-08-29,Scott Smith,Viatris,5,4,0,9,
2025-08-29,Kimberly Dang,Kinder Morgan,11,1,0,12,
2025-08-29,Christophe Beck,Ecolab,21,19,0,40,
2025-08-29,Brent Shafer,Baxter International,1,8,0,9,
2025-08-29,Clay Gaspar,Devon Energy,19,3,0,22,
2025-08-29,Steven Cahillane,Kellanova,2,7,0,9,
2025-08-29,Raul Nicholas Vargas Ochoa,Farmers Insurance Exchange,0,0,0,0,
2025-08-29,Darren Rebelez,Caseys General Stores,3,6,0,9,
2025-08-29,Ari Bousbib,IQVIA,8,16,1,25,
2025-08-29,Jon Vander Ark,Republic Services,10,17,13,40,
2025-08-29,Timothy Cofer,Keurig Dr Pepper,2,6,1,9,
2025-08-29,Karla Lewis,Reliance Inc,2,7,0,9,
2025-08-29,David Hult,Asbury Automotive Group,7,32,1,40,
2025-08-29,Darryl Button,Pacific Life,0,8,0,8,
2025-08-29,James Burke,Vistra,6,3,1,10,
2025-08-29,John Barrett,Western & Southern Financial,10,28,2,40,
2025-08-29,William Krueger,The Andersons Inc,0,3,0,3,
2025-08-29,Erik Nordstrom,Nordstrom,6,28,5,39,
2025-08-29,John Wren,Omnicom Group,14,20,6,40,
2025-08-29,Stephanie Ferris,Fidelity National Information Services,16,22,2,40,
2025-08-29,Timothy Cawley,Consolidated Edison,5,5,0,10,
2025-08-29,Joseph Hinrichs,CSX,7,10,1,18,
2025-08-29,Troy Rudd,AECOM,8,24,5,37,
2025-08-29,Kathleen Johnson,Lumen Technologies,3,4,0,7,
2025-08-29,Harry Lawton III,Tractor Supply,1,1,0,2,
2025-08-29,Raul Fernandez,DXC Technology,2,31,2,35,
2025-08-29,Eric Hansotia,AGCO,12,14,1,27,
2025-08-29,David Bruton Smith,Sonic Automotive,5,8,9,22,
2025-08-29,Sasan Goodarzi,Intuit,10,26,4,40,
2025-08-29,Matthew Flannery,United Rentals,29,2,0,31,
2025-08-29,Marc Miller,Universal Health Services,4,22,3,29,
2025-08-29,Michael Mahoney,Boston Scientific,10,29,1,40,
2025-08-29,Judith Marks,Otis Worldwide,3,3,0,6,
2025-08-29,Robert Frenzel,Xcel Energy,3,2,2,7,
2025-08-29,Penny Pennington,Edward Jones,6,28,6,40,
2025-08-29,Daniel Fisher,Ball,2,19,4,25,
2025-08-29,Justin Jude,LKQ,5,6,1,12,
2025-08-29,James Blackledge,Mutual of Omaha,2,28,2,32,
2025-08-29,Bruce Bodine,Mosaic,3,7,0,10,
2025-08-29,Scott Donnelly,Textron,9,28,3,40,
2025-08-29,Adam Schechter,Labcorp Holdings,3,5,0,8,
2025-08-29,Deanna Strable-Soethout,Principal Financial,1,5,0,6,
2025-08-29,Leonard Schleifer,Regeneron Pharmaceuticals,5,28,7,40,
2025-08-29,Paul Shoukry,Raymond James Financial,14,26,0,40,
2025-08-29,Lauren Hobart,Dicks Sporting Goods,10,21,4,35,
2025-08-29,Jamie Whisnant,Auto-Owners Insurance,0,2,0,2,
2025-08-29,Ariane Gorin,Expedia,9,30,1,40,
2025-08-29,Shelley Simpson,JB Hunt Transport Services,8,30,2,40,
2025-08-29,Ren√© Jones,M&T Bank,14,24,2,40,
2025-08-29,Gerardo Norcia,DTE Energy,5,3,0,8,
2025-08-29,Andr√©s Gluski,AES,17,22,0,39,
2025-08-29,Timothy Spence,Fifth Third Bancorp,4,6,0,10,
2025-08-29,Eduardo Menezes,Air Products & Chemicals,4,5,1,10,
2025-08-29,Wendell Weeks,Corning,15,23,2,40,
2025-08-29,Anthony Guzzi,EMCOR Group,4,3,1,8,
2025-08-29,Adam Norwitt,Amphenol,3,16,0,19,
2025-08-29,Jean-Marc Gilson,Westlake Corporation,2,4,0,6,
2025-08-29,Lori Koch,DuPont,7,18,0,25,
2025-08-29,Derek Chang,Liberty Media,36,4,0,40,
2025-08-29,Martina Cheung,S&P Global,11,26,0,37,
2025-08-29,Tim Hingtgen,Community Health Systems,10,27,3,40,
2025-08-29,Brian Tierney,FirstEnergy,6,23,3,32,
2025-08-29,Rick McKenney,Unum Group,6,4,0,10,
2025-08-29,Stanley Bergman,Henry Schein,11,28,1,40,
2025-08-29,Tiang Yew Tan,Western Digital,0,2,0,2,
2025-08-29,Vincent Roche,Analog Devices,11,26,2,39,
2025-08-29,Sean Connolly,Conagra Brands,7,31,2,40,
2025-08-29,Bruce Van Saun,Citizens Financial Group,13,25,2,40,
2025-08-29,Mark George,Norfolk Southern,18,20,2,40,
2025-08-29,Andrew Marsh,Entergy,3,4,0,7,
2025-08-29,Robert Berkley,WR Berkley,8,30,2,40,
2025-08-29,Javier Rodriguez,DaVita,14,14,1,29,
2025-08-29,Michael O'Grady,Northern Trust,25,4,1,30,
2025-08-29,James Snee,Hormel Foods,3,26,1,30,
2025-08-29,Timothy J Donahue,Crown Holdings,1,9,0,10,
2025-08-29,Joseph Ferraro,Avis Budget,3,5,2,10,
2025-08-29,Niraj Shah,Wayfair,7,26,7,40,
2025-08-29,Jos√© Mas,MasTec,6,14,1,21,
2025-08-29,Joseph Nolan,Eversource Energy,5,3,1,9,
2025-08-29,Thomas Palmer,Newmont,7,3,0,10,
2025-08-29,Robert Sanchez,Ryder System,10,9,1,20,
2025-08-29,Michael Nolan,Fidelity National Financial,2,0,0,2,
2025-08-29,Gavin Hattersley,Molson Coors Beverage,5,31,4,40,
2025-08-29,Thomas Reeg,Caesars Entertainment,5,6,0,11,
2025-08-29,Ellen Cooper,Lincoln National,3,6,0,9,
2025-08-29,Bracken Darrell,VF Corporation,8,28,4,40,
2025-08-29,Erik Fyrwald,International Flavors & Fragrances,7,7,2,16,
2025-08-29,Christopher Kastner,Huntington Ingalls Industries,3,4,1,8,
2025-08-29,Shane O'Kelly,Advance Auto Parts,12,22,6,40,
2025-08-29,Ralph LaRossa,Public Service Enterprise Group,11,17,0,28,
2025-08-29,Kecia Steelman,Ulta Beauty,32,6,2,40,
2025-08-29,Michele Buck,Hershey,7,31,2,40,
2025-08-29,Sumit Singh,Chewy,12,22,6,40,
2025-08-29,Steven Vondran,American Tower,4,6,0,10,
2025-08-29,Jeffrey Lorberbaum,Mohawk Industries,11,7,1,19,
2025-08-29,Keith Demmings,Assurant,4,6,0,10,
2025-08-29,Robert Martin,Thor Industries,4,5,1,10,
2025-08-29,Kathleen Mazzarella,Graybar Electric,1,6,2,9,
2025-08-29,Joey Wat,Yum China,11,27,2,40,
2025-08-29,Scott Richardson,Celanese,7,28,5,40,
2025-08-29,David Rawlinson II,QVC,7,15,2,24,
2025-08-29,Alan Armstrong,Williams,23,13,4,40,
2025-08-29,Philippe Krakowsky,Interpublic Group,13,24,3,40,
2025-08-29,Brendan McCracken,Ovintiv,5,5,0,10,
2025-08-29,Andrew Teno,Icahn Enterprises,5,5,0,10,
2025-08-29,Stephen Steinour,Huntington Bancshares,1,8,0,9,
2025-08-29,Timothy NeCastro,Erie Insurance,3,6,1,10,
2025-08-29,Ernest Garcia III,Carvana,23,13,4,40,
2025-08-29,R Bruce McDonald,Dana Incorporated,4,6,1,11,
2025-08-29,William Oplinger,Alcoa Corporation,1,8,1,10,
2025-08-29,Mark Pearson,Equitable,8,8,0,16,
2025-08-29,Richard Wallace,KLA,4,5,0,9,
2025-08-29,Ricardo Cardenas,Darden Restaurants,4,2,1,7,
2025-08-29,Mikael Bratt,Autoliv,6,8,2,16,
2025-08-29,Benito Minicucci,Alaska Air,3,3,1,7,
2025-08-29,Christopher Gorman,KeyCorp,5,5,0,10,
2025-08-29,Robert Goldstein,Las Vegas Sands,4,31,5,40,
2025-08-29,Edward Pesicka,Owens & Minor,4,33,2,39,
2025-08-29,Christopher Nassetta,Hilton Worldwide,6,15,2,23,
2025-08-29,Jamie Iannone,Ebay,19,17,4,40,
2025-08-29,Patrick Gallagher,Arthur J Gallagher,10,28,2,40,
2025-08-29,Rich Steinmeier,LPL Financial,24,14,2,40,
2025-08-29,Stephen Spray,Cincinnati Financial,1,5,4,10,
2025-08-29,Douglas Yearley,Toll Brothers,10,24,6,40,
2025-08-29,Gregory Brown,Motorola Solutions,2,8,0,10,
2025-08-29,Brian Chesky,Airbnb,3,29,8,40,
2025-08-29,Jeffrey Sprecher,Intercontinental Exchange,14,24,2,40,
2025-08-29,Robert Thomson,News Corp,7,29,4,40,
2025-08-29,Scott Boatwright,Chipotle Mexican Grill,7,29,4,40,
2025-08-29,Reshma Kewalramani,Vertex Pharmaceuticals,22,13,5,40,
2025-08-29,Christopher Viehbacher,Biogen,0,28,2,30,
2025-08-29,Malcolm Wilson,GXO Logistics,8,20,0,28,
2025-08-29,Tony Sarsam,SpartanNash,19,19,2,40,
2025-08-29,Michael O‚ÄôSullivan,Burlington Stores,7,29,4,40,
2025-08-29,Teresa Rasmussen,Thrivent Financial for Lutherans,4,0,0,4,
2025-08-29,Eugene Bredow,NVR,0,4,0,4,
2025-08-29,Brian Chambers,Owens Corning,3,13,1,17,
2025-08-29,Rafael Santana,Westinghouse Air Brake Technologies,3,6,1,10,
2025-08-29,John Pfeifer,Oshkosh,6,24,4,34,
2025-08-29,Cameron Bready,Global Payments,8,29,3,40,
2025-08-29,Calvin McDonald,Lululemon athletica,8,31,1,40,
2025-08-29,J Kent Masters,Albemarle Corporation,3,7,0,10,
2025-08-29,Joanna Geraghty,JetBlue Airways,15,21,4,40,
2025-08-29,Robert Steer,Seaboard,0,4,0,4,
2025-08-29,William Newlands,Constellation Brands,0,2,2,4,
2025-08-29,Michael Doss,Graphic Packaging,6,7,1,14,
2025-08-29,Gil West,Hertz,8,23,9,40,
2025-08-29,Malcolm C Roberts,FM Global,1,11,2,14,
2025-08-29,Mick Beekhuizen,Campbell Soup,8,24,1,33,
2025-08-29,Daniel Wall,Expeditors International of Washington,2,5,0,7,
2025-08-29,Gregory Roberts,A-Mark Precious Metals,2,4,1,7,
2025-08-29,Horacio Rozanski,Booz Allen Hamilton,16,19,5,40,
2025-08-29,James Davis,Quest Diagnostics,4,5,1,10,
2025-08-29,Dennis Mathew,Altice,5,28,7,40,
2025-08-29,Stefan Larsson,PVH,11,24,5,40,
2025-08-29,Mark Costa,Eastman Chemical,6,17,4,27,
2025-08-29,Joyce Mullen,Insight Enterprises,6,9,1,16,
2025-08-29,John Turner,Regions Financial,20,18,2,40,
2025-08-29,Julian G Francis,Beacon Roofing Supply,0,1,0,1,
2025-08-29,Blake Moret,Rockwell Automation,11,27,2,40,
2025-08-29,Mike Speetzen,Polaris Inc,3,17,2,22,
2025-08-29,William McDermott,ServiceNow,3,6,0,9,
2025-08-29,Jure Sola,Sanmina,2,12,0,14,
2025-08-29,Bob Flexon,UGI Utilities Inc,1,1,0,2,
2025-08-29,Scott Lauber,WEC Energy,13,5,0,18,
2025-08-29,Jon Rousseau,BrightSpring Health Services,20,19,1,40,
2025-08-29,Todd Schneider,Cintas,12,18,2,32,
2025-08-29,Peter Matt,Commercial Metals,5,4,0,9,
2025-08-29,Robert D Lawler,Continental Resources,1,0,0,1,
2025-08-29,Domenic Dell‚ÄôOsso Jr,Expand Energy,4,0,0,4,
2025-08-29,Jason P Wells,CenterPoint Energy,8,4,1,13,
2025-08-29,H Michael Krimbill,NGL Energy Partners,6,2,0,8,
2025-08-29,Tony Xu,DoorDash,12,20,8,40,
2025-08-29,Clay Williams,NOV,10,19,4,33,
2025-08-29,Kristin Peck,Zoetis,13,17,1,31,
2025-08-29,Mark Smucker,JM Smucker,11,23,6,40,
2025-08-29,Steve Sanghi,Microchip Technology,9,25,6,40,
2025-08-29,Richard Tobin,Dover Corporation,6,3,1,10,
2025-08-29,Kaes Van‚Äôt Hof,Diamondback Energy,22,15,2,39,
2025-08-29,Deon Stander,Avery Dennison,0,13,0,13,
2025-08-29,Vincent Sorgi,PPL,8,8,1,17,
2025-08-29,Hassane El-Khoury,ON Semiconductor,2,17,4,23,
2025-08-29,Arie Kotler,ARKO,6,24,0,30,
2025-08-29,William Monteleone,Par Pacific,1,6,2,9,
2025-08-29,John Christmann IV,APA,5,5,0,10,
2025-08-29,Adaire Fox-Martin,Equinix,16,21,3,40,
2025-08-29,Joseph M Otting,Flagstar Financial,2,7,0,9,
2025-08-29,Mary Dillon,Foot Locker,10,24,6,40,
2025-08-29,James Zallie,Ingredion,5,5,0,10,
2025-08-29,Christopher Peterson,Newell Brands,0,8,2,10,
2025-08-29,Scott Salmirs,ABM Industries,6,8,1,15,
2025-08-29,Christopher Hilger,Securian Financial,0,8,1,9,
2025-08-29,Hamid Moghadam,Prologis,7,27,6,40,
2025-08-29,Stephen Schwarzman,Blackstone,14,21,5,40,
2025-08-29,Robert Greenberg,Skechers USA,6,23,3,32,
2025-08-29,Keith Allman,Masco,4,9,1,14,
2025-08-29,Rusty Rush,Rush Enterprises,15,22,3,40,
2025-08-29,Jennifer Johnson,Franklin Resources,1,6,2,9,
2025-08-29,Gerry P Smith,ODP Business Solutions,1,0,0,1,
2025-08-29,Carl Lindner lll,American Financial,0,0,0,0,
2025-08-29,Mark Kowlzan,Packaging Corp of America,0,9,1,10,
2025-08-29,Thomas Hill,Vulcan Materials,4,8,2,14,
2025-08-29,Milan Galik,Interactive Brokers,7,19,1,27,
2025-08-29,Laura Alber,Williams-Sonoma,14,22,4,40,
2025-08-29,Mario Harik,XPO,7,32,1,40,
2025-08-29,Devin Stockfish,Weyerhaeuser,5,5,0,10,
2025-08-29,Thomas J McInerney,Genworth Financial,0,6,0,6,
2025-08-29,Garrick Rochow,CMS Energy,10,3,0,13,
2025-08-29,Toni Townes-Whitley,Science Applications International,13,19,1,33,
2025-08-29,Rich Handler,Jefferies Financial,11,11,2,24,
2025-08-29,Daniel Heaf,Bath & Body Works,11,27,2,40,
2025-08-29,Andrew Wilson,Electronic Arts,14,18,8,40,
2025-08-29,Sheryl Palmer,Taylor Morrison Home,7,12,1,20,
2025-08-29,Ivan Tornos,Zimmer Biomet,10,29,1,40,
2025-08-29,Linda Rendle,Clorox,2,35,1,38,
2025-08-29,Matthew Pine,Xylem Inc,1,8,1,10,
2025-08-29,Heather Lavallee,Voya Financial,6,10,2,18,
2025-08-29,Daniel Florness,Fastenal,2,6,1,9,
2025-08-29,Albert Nahmad,Watsco,2,8,0,10,
2025-08-29,Carl Eschenbach,Workday,11,20,9,40,
2025-08-29,Craig Smiddy,Old Republic International,4,5,1,10,
2025-08-29,Frank C Sullivan,RPM International,3,10,1,14,
2025-08-29,Matthew Missad,UFP Industries,7,2,0,9,
2025-08-29,Martin J Lyons,Ameren,2,3,1,6,
2025-08-29,Adam W Miller,Knight Swift Transportation,2,2,1,5,
2025-08-29,Rodney Sacks,Monster Beverage,13,25,1,39,
2025-08-29,Gary Guthart,Intuitive Surgical,14,24,2,40,
2025-08-29,Charles Liang,Super Micro Computer,35,5,0,40,
2025-08-29,Christopher Caldwell,Concentrix,2,5,0,7,
2025-08-29,Gordon J Hardie,O-I Glass,1,5,0,6,
2025-08-29,David Gibbs,Yum Brands,3,36,1,40,
2025-08-29,Steve Henry,Domtar,4,5,0,9,
2025-08-29,Chuck Treadway,CommScope,8,20,3,31,
2025-08-29,Rob Vitale,Post Holdings,1,12,5,18,
2025-08-29,Steven J Moskowitz,Crown Castle,2,5,3,10,
2025-08-29,Emmanuel Ligner,Avantor,5,11,3,19,
2025-08-29,Stuart Bradie,KBR,15,14,4,33,
2025-08-29,Carrie Wheeler,Opendoor Technologies,11,26,3,40,
2025-08-29,Russell Becker,APi Group,3,5,0,8,
2025-08-29,Toby Rice,EQT,24,14,2,40,
2025-08-29,Jesse Arenivas,EnLink Midstream,6,9,0,15,
2025-08-29,Nikesh Arora,Palo Alto Networks,6,26,8,40,
2025-08-29,Steven Bandrowczak,Xerox,1,8,1,10,
2025-08-29,Vicente Reynal,Ingersoll Rand,9,29,0,38,
2025-08-29,William T Dillard II,Dillards,3,4,2,9,
2025-08-29,C Howard Nye,Martin Marietta Materials,4,4,2,10,
2025-08-29,Giordano Albertazzi,Vertiv,19,18,3,40,
2025-08-29,Stephane Bancel,Moderna,10,19,11,40,
2025-08-29,Nate R Jorgensen,Boise Cascade,0,1,0,1,
2025-08-29,Jack Sinclair,Sprouts Farmers Market,16,23,1,40,
2025-08-29,Padraig McDonnell,Agilent Technologies,11,14,0,25,
2025-08-29,Kenneth T Lane,Olin,1,0,0,1,
2025-08-29,Randall C Stuewe,Darling Ingredients,27,1,0,28,
2025-08-29,R Howard Coker,Sonoco Products,3,6,1,10,
2025-08-29,John Mengucci,CACI International,21,17,2,40,
2025-08-29,Mark Witkowski,Core & Main,0,7,1,8,
2025-08-29,Lee M Tillman,Marathon Oil,5,3,0,8,
2025-08-29,Mark Hoplamazian,Hyatt Hotels,14,22,4,40,
2025-08-29,David S Chernow,Select Medical,0,8,1,9,
2025-08-29,Brendan M Foley,McCormick & Company,0,8,0,8,
2025-08-29,Joanne Crevoiserat,Tapestry,13,22,5,40,
2025-08-29,John Plant,Howmet Aerospace,4,14,1,19,
2025-08-29,Shankh Mitra,Welltower,16,22,2,40,
2025-08-29,W Anthony Will,CF Industries,4,5,0,9,
2025-08-29,David A Zapico,Ametek,2,16,0,18,
2025-08-29,Kevin Stein,TransDigm,9,9,3,21,
2025-08-29,Craig Billings,Wynn Resorts,12,25,3,40,
2025-08-29,William J Way,Southwestern Energy,1,1,0,2,
2025-08-29,Giel Rutten,Amkor Technology,2,9,1,12,
2025-08-29,Paul Sarvadi,Insperity,3,6,1,10,
2025-08-29,Donald Zurbay,Patterson Companies Inc,0,1,0,1,
2025-08-29,Rob Sharps,T Rowe Price,10,21,8,39,
2025-08-29,Patrice Louvet,Ralph Lauren,15,16,9,40,
2025-08-29,Jeffrey Mezger,KB Home,2,29,9,40,
2025-08-29,David M Foulkes,Brunswick,0,8,0,8,
2025-08-29,M Keith Waddell,Robert Half,2,9,1,12,
2025-08-29,Jay Snowden,PENN Entertainment,18,19,3,40,
2025-08-29,George Kurian,NetApp,13,24,3,40,
2025-08-29,Kevin Ali,Organon,9,18,0,27,
2025-08-29,Joel D Anderson,Petco Health and Wellness,3,11,0,14,
2025-08-29,Louis V Pinkham,Regal Rexnord,0,1,0,1,
2025-08-29,Jay Geldmacher,Resideo Technologies,10,5,1,16,
2025-08-29,Marcus Lemonis,Camping World,6,24,10,40,
2025-08-29,Peter R Huntsman,Huntsman,6,13,4,23,
2025-08-29,Hillary Super,Victorias Secret,12,4,8,24,
2025-08-29,Michelle Gass,Levi Strauss,12,24,3,39,
2025-08-29,Neil Hunn,Roper Technologies,2,21,0,23,
2025-08-29,Steven P Lawrence,Academy Sports and Outdoors,1,1,0,2,
2025-08-29,Phillippe Lord,Meritage Homes,9,17,0,26,
2025-08-29,David C Dauch,American Axle & Manufacturing,5,9,2,16,
2025-08-29,Olumide Soroye,Fortive,1,10,0,11,
2025-08-29,Adena Friedman,Nasdaq,16,19,5,40,
2025-08-29,Tim Gokey,Broadridge Financial Solutions,3,13,1,17,
2025-08-29,Patrick M Shanahan,Spirit AeroSystems,1,9,0,10,
2025-08-29,Robert Kyncl,Warner Music Group,9,30,1,40,
2025-08-29,Denise Dignam,Chemours,2,18,4,24,
2025-08-29,Jim DeVries,ADT,9,7,1,17,
2025-08-29,Bernard Zovighian,Edwards Lifesciences,7,6,2,15,
2025-08-29,Mark E Seaton,First American Financial,1,9,0,10,
2025-08-29,John C Roche,Hanover Insurance Group,4,16,1,21,
2025-08-29,Adam J Greenlee,Silgan,0,4,0,4,
2025-08-29,Jayne Hrdlicka,Endeavor Group,0,1,0,1,
2025-08-29,Robert Fauber,Moodys Corporation,0,6,0,6,
2025-08-29,Thomas E Jorden,Coterra Energy,8,0,0,8,
2025-08-29,Eugene A Hall,Gartner,1,9,0,10,
2025-08-29,Kevin Plank,Under Armour,9,28,3,40,
2025-08-29,James W Lanning,Ingles Markets,3,4,0,7,
2025-08-29,Matthew T Farrell,Church & Dwight,8,8,0,16,
2025-08-29,Kevin M Freeman,Old Dominion Freight Line,1,1,0,2,
2025-08-29,Joe Shoen,U-Haul,14,21,4,39,
2025-08-29,Mark Bertolini,Oscar Health,12,19,9,40,
2025-08-29,Jayshree Ullal,Arista Networks,20,20,0,40,
2025-08-29,Sassine Ghazi,Synopsys,11,26,3,40,
2025-08-29,Jochen Zeitz,Harley-Davidson,6,25,9,40,
2025-08-29,Nick Jeffery,Frontier Communications,10,27,2,39,
2025-08-29,Thomas Edward McCormick,Primoris Services,0,5,0,5,
2025-08-29,D Christian Koch,Carlisle Companies,1,3,1,5,
2025-08-29,David E Simon,Simon Property Group,2,5,2,9,
2025-08-29,Stephen Bratspies,Hanesbrands,3,11,0,14,
2025-08-29,Ryan M. Schneider,Anywhere Real Estate Inc,0,2,0,2,
2025-08-29,George Bobb III,Teledyne Technologies,1,4,1,6,
2025-08-29,Terrence A Duffy,CME Group,6,9,1,16,
2025-08-29,Rami Rahim,Juniper Networks,11,27,2,40,
2025-08-29,Sue Nabi,Coty,17,17,6,40,
2025-08-29,Peter D Arvan,Pool Corporation,2,10,0,12,
2025-08-29,David Campbell,Evergy,14,7,0,21,
2025-08-29,Matthew J Murphy,Marvell Technology,4,5,1,10,
2025-08-29,Lloyd Yates,NiSource,6,4,0,10,
2025-08-29,William C Stone,SS&C Technologies,2,4,1,7,
2025-08-29,Mark Rourke,Schneider National,8,18,1,27,
2025-08-29,Andrew Anagnost,Autodesk,9,23,8,40,
2025-08-29,Dustin Semach,Sealed Air Corporation,0,7,0,7,
2025-08-29,William L Meaney,Iron Mountain,4,18,1,23,
2025-08-29,Andy P Power,Digital Realty Trust,0,0,0,0,
2025-08-29,Satish Dhanasekaran,Keysight Technologies,5,12,1,18,
2025-08-29,Frank M Svoboda,Globe Life,3,4,3,10,
2025-08-29,Carey A Smith,Parsons,1,4,0,5,
2025-08-29,Ynon Kreiz,Mattel,8,25,7,40,
2025-08-29,Karen S Haller,Southwest Gas,3,6,0,9,
2025-08-29,Terrance Williams,TruStage,4,7,1,12,
2025-08-29,Eric W Gerstenberg,Clean Harbors,5,2,1,8,
2025-08-29,Gunner Smith,Cornerstone Building Brands,1,7,0,8,
2025-08-29,Gerben W Bakker,Hubbell,1,5,0,6,
2025-08-29,Dave Davis,Spirit Airlines,2,34,4,40,
2025-08-29,Michael J Smith,Lamb Weston,0,6,3,9,
2025-08-29,Strauss Zelnick,Take-Two Interactive Software,15,18,7,40,
2025-08-29,John C Turner Jr,GMS,2,8,0,10,
2025-08-29,David M O'Malley,Penn Mutual Life Insurance,1,2,0,3,
2025-08-29,Frank A Lonegro,Landstar System,2,4,0,6,
2025-08-29,James F Risoleo,Host Hotels & Resorts,6,17,1,24,
2025-08-29,Ken Xie,Fortinet,13,19,8,40,
2025-08-29,Doug Shulman,OneMain,2,7,0,9,
2025-08-29,Ryan Cohen,GameStop,10,22,8,40,
2025-08-29,Mark W Begor,Equifax,3,12,0,15,
2025-08-29,Jay L Schottenstein,American Eagle Outfitters,10,18,1,29,
2025-08-29,Curtis C Farmer,Comerica,3,9,0,12,
2025-08-29,Ole Rosgaard,Greif,4,20,2,26,
2025-08-29,Brian E Lane,Comfort Systems USA,9,1,0,10,
2025-08-29,Robert M Buck,TopBuild,1,5,1,7,
2025-08-29,Ralph Andretta,Bread Financial,3,7,0,10,
2025-08-29,Jim Anderson,Coherent,6,33,1,40,
2025-08-29,Walter C. D. Carlson,Telephone & Data Systems,0,2,0,2,
2025-08-29,Ronald Kruszewski,Stifel Financial,7,5,0,12,
2025-08-29,Richard Hayne,Urban Outfitters,11,20,7,38,
2025-08-29,Simon Meester,Terex,4,8,0,12,
2025-08-29,Edward J Lehner,Ryerson Holding,0,3,0,3,
2025-08-29,Nicholas T Pinchuk,Snap-on,2,7,0,9,
2025-08-29,Ryals McMullian,Flowers Foods,5,27,2,34,
2025-08-29,D Bryan Jordan,First Horizon,4,7,1,12,
2025-08-29,John B Gibson,Paychex,2,5,0,7,
2025-08-29,Chris Cocks,Hasbro,13,18,9,40,
2025-08-29,Pete McPartland,Sentry Insurance Group,0,2,0,2,
2025-08-29,Michael Arougheti,Ares Management,16,23,1,40,
2025-08-29,Alok Maskara,Lennox International,5,4,1,10,
2025-08-29,James C Grech,Peabody Energy,3,0,0,3,
2025-08-29,Joseph P Lacher Jr,Kemper,4,18,4,26,
2025-08-29,Perry A Sook,Nexstar Media Group,7,30,1,38,
2025-08-29,Wade Davis,TelevisaUnivision,13,25,2,40,
2025-08-29,Scott L Thompson,Tempur Sealy International,0,7,0,7,
2025-08-29,Mike Simonds,TriNet Group,0,7,0,7,
2025-08-29,B Andrew Rose,Worthington Enterprises,1,2,0,3,
2025-08-29,Bruce L Caswell,Maximus,5,5,0,10,
2025-08-29,Robert L Reffkin,Compass,1,7,0,8,
2025-08-29,Mark Eubanks,Brinks Company,1,2,1,4,
2025-08-29,Peter Quigley,Kelly Services inc,1,9,0,10,
2025-08-29,David L Yowan,Navient,2,3,0,5,
2025-08-29,Mary E Kipp,Puget Sound Energy,4,0,1,5,
2025-08-29,Adam Aron,AMC Entertainment,20,13,7,40,
2025-08-29,Mark J Tarr,Encompass Health,2,5,1,8,
2025-08-29,Liam K Griffin,Skyworks Solutions,1,7,0,8,
2025-08-29,Richard G Kyle,Timken,6,14,1,21,
2025-08-29,Ron Gusek,Liberty Energy,25,1,0,26,
2025-08-29,John E Geller Jr,Marriott Vacations Worldwide,6,6,1,13,
2025-08-29,Karl G. Glassman,Leggett & Platt,0,5,0,5,
2025-08-29,Bruce K Thorn,Big Lots,3,5,2,10,
2025-08-29,Jonathan H Weis,Weis Markets,12,27,0,39,
2025-08-29,Jeffrey B Guldner,Pinnacle West Capital,1,3,0,4,
2025-08-29,Arkadiy Dobkin,EPAM Systems,9,15,2,26,
2025-08-29,Paul M Rady,Antero Resources,3,8,0,11,
2025-08-29,Michael Spanos,Bloomin Brands,1,8,1,10,
2025-08-29,Nicole A Kivisto,MDU Resources Group,2,6,0,8,
2025-08-29,Gerald L Morgan,Texas Roadhouse,2,3,3,8,
2025-08-29,Gabriel Tirador,Mercury General,3,5,2,10,
2025-08-29,Nicholas I Fink,Fortune Brands Innovations,5,1,0,6,
2025-08-29,Paul E Burdiss,Zions Bancorp,1,1,0,2,
2025-08-29,William J Christensen,JELD-WEN Holding,3,6,0,9,
2025-08-29,Evan Spiegel,Snap Inc,21,17,2,40,
2025-08-29,Bill Burns,Zebra Technologies,6,26,1,33,
2025-08-29,Steven Sell,Agilon Health,1,7,1,9,
2025-08-29,Richard M Olson,Toro Company,1,13,1,15,
2025-08-29,Eric S Yuan,Zoom Video Communications,5,8,0,13,
2025-08-29,Dan L Batrack,Tetra Tech,2,6,1,9,
2025-08-29,Joseph D Russell Jr,Public Storage,0,7,0,7,
2025-08-29,Jacob Thaysen,Illumina inc,5,6,0,11,
2025-08-29,Debra A Cafaro,Ventas inc,7,5,0,12,
2025-08-29,Pierre R Brondeau,FMC Corporation,0,4,0,4,
2025-08-29,Judy R McReynolds,ArcBest,6,12,1,19,
2025-08-29,Russell J Weiner,Dominos Pizza inc,0,0,0,0,
2025-08-29,Theodore S Hanson,ASGN,0,2,0,2,
2025-08-29,RJ Scaringe,Rivian Automotive,12,26,2,40,
2025-08-29,Jeffrey N Simmons,Elanco Animal Health,3,5,1,9,
2025-08-29,Tim O Shaughnessy,Graham Holdings Company,2,6,0,8,
2025-08-29,Thomas V Taylor,Floor & Decor,1,1,2,4,
2025-08-29,Neil A Schrimsher,Applied Industrial Technologies,6,23,1,30,
2025-08-29,Robert E Price,PriceSmart,5,5,0,10,
2025-08-29,John David Risher,Lyft,3,4,1,8,
2025-08-29,Gary B Smith,Ciena,3,9,0,12,
2025-08-29,Joey Levin,IAC,6,29,1,36,
2025-08-29,Jim Jacobs,Country Financial,7,3,1,11,
2025-08-29,Devin B McGranahan,Western Union,0,7,0,7,
2025-08-29,R Scott Rowe,Flowserve,3,7,0,10,
2025-08-29,Kenneth A Vecchione,Western Alliance Bancorp,0,0,1,1,
2025-08-29,John C Rademacher,Option Care Health,7,3,0,10,
2025-08-29,Doug Black,SiteOne Landscape Supply,3,22,1,26,
2025-08-29,Oliver G Brewer III,Topgolf Callaway Brands,2,0,0,2,
2025-08-29,Glenn Sanford,eXp World,15,23,2,40,
2025-08-29,Fran Horowitz,Abercrombie & Fitch,13,22,5,40,
2025-08-29,Kevin Akers,Atmos Energy,7,2,1,10,
2025-08-29,Alessandro Maselli,Catalent,4,11,2,17,
2025-08-29,J Powell Brown,Brown & Brown,11,21,8,40,
2025-08-29,Aman Bhutani,GoDaddy,16,22,2,40,
2025-08-29,John C. Griffith,American Water Works,1,2,0,3,
2025-08-29,John J Marchioni,Selective Insurance Group,4,15,2,21,
2025-08-29,Lawson E Whiting,Brown-Forman,1,7,1,9,
2025-08-29,Dave Peacock,Advantage Solutions,21,7,0,28,
2025-08-29,Mick Farrell,ResMed,16,22,2,40,
2025-08-29,Kamal Hathi,Splunk,2,4,0,6,
2025-08-29,Todd Kelsey,Plexus,2,7,0,9,
2025-08-29,Phillip D Yeager,Hub Group,3,6,0,9,
2025-08-29,Steven B Hedlund,Lincoln Electric,5,9,0,14,
2025-08-29,Timothy C Oliver,NCR Atleos,0,1,0,1,
2025-08-29,Bruce Fleming,Calumet,2,8,0,10,
2025-08-29,Daniel S. Peyovich,Dycom Industries,1,5,0,6,
2025-08-29,Avner M Applbaum,Valmont Industries,0,9,1,10,
2025-08-29,Kimberly A Fields,ATI inc,5,11,0,16,
2025-08-29,Khozema Z Shipchandler,Twilio,0,2,0,2,
2025-08-29,Gary C Bhojwani,CNO Financial Group,1,7,1,9,
2025-08-29,William Andrew Hendricks Jr,Patterson-UTI Energy,0,0,0,0,
2025-08-29,Kevin D Hochman,Brinker International,1,4,1,6,
2025-08-29,James C Foster,Charles River Laboratories International,2,9,0,11,
2025-08-29,Rajiv K Prasad,Hyster-Yale,2,5,0,7,
2025-08-29,Eric T Steigerwalt,Brighthouse Financial,1,4,0,5,
2025-08-29,Thomas L Ryan,Service Corp International,4,6,0,10,
2025-08-29,Charles M Nifong Jr,CrossAmerica Partners,0,0,0,0,
2025-08-29,Anirudh Devgan,Cadence,8,22,1,31,
2025-08-29,Andi Owen,MillerKnoll,14,15,11,40,
2025-08-29,Sumit Roy,Realty Income,13,20,2,35,
2025-08-29,Timothy John Fitzgerald,Middleby,0,0,0,0,
2025-08-29,Robert H Schottenstein,M/I Homes,3,11,0,14,
2025-08-29,Stephen P MacMillan,Hologic,2,6,0,8,
2025-08-29,Lisa M Barton,Alliant Energy,6,0,0,6,
2025-08-29,Aaron P Jagdfeld,Generac,1,5,1,7,
2025-08-29,Erik Gershwind,MSC Industrial Direct,2,6,2,10,
2025-08-29,Varun Krishna,Rocket Companies,7,31,2,40,
2025-08-29,Fahmi Karam,Upbound Group,4,5,0,9,
2025-08-29,NADominic Ng,East West Bancorp,0,0,0,0,
2025-08-29,Mark Wang,Hilton Grand Vacations,38,2,0,40,
2025-08-29,Robert J Sheedy Jr,Grocery Outlet Holding,0,0,0,0,
2025-08-29,Simon D Campion,Dentsply Sirona,0,3,0,3,
2025-08-29,Jeremy Wensinger,V2X,8,9,0,17,
2025-08-29,Andrew Rees,Crocs,15,16,9,40,
2025-08-29,David M Maura,Spectrum Brands,5,0,0,5,
2025-08-29,Sachin S Lawande,Visteon,0,1,0,1,
2025-08-29,Neil M Ashe,Acuity Inc,0,2,0,2,
2025-08-29,Lorie L Tekorius,Greenbrier,1,8,1,10,
2025-08-29,John R Ciulla,Webster Financial,4,6,0,10,
2025-08-29,Sean D Keohane,Cabot Corporation,2,6,0,8,
2025-08-29,Drew M Wilkerson,RXO inc,1,0,0,1,
2025-08-29,Daniel E Brown,Chord Energy,1,1,0,2,
2025-08-29,Javier D Ferrer Fernandez,Popular inc,0,0,0,0,
2025-08-29,Olivier Rabiller,Garrett Motion inc,4,9,0,13,
2025-08-29,Ronald N Tutor,Tutor Perini Corporation,1,7,1,9,
2025-08-29,Jeff Liaw,Copart,4,4,2,10,
2025-08-29,Aman Narang,Toast inc,5,5,1,11,
2025-08-29,Joseph M Hogan,Align Technology,2,4,1,7,
2025-08-29,Kevin J Wheeler,A O Smith,0,16,1,17,
2025-08-29,Christopher A Cartwright,TransUnion,2,0,0,2,
2025-08-29,James Kelly,NCR Voyix,1,12,1,14,
2025-08-29,Tom Leighton,Akamai Technologies,12,16,5,33,
2025-08-29,Robert G Painter,Trimble,6,2,0,8,
2025-08-29,Tony Helton,Medical Mutual of Ohio,1,3,1,5,
2025-08-29,Caroline S Grace,AMN Healthcare Services,0,0,0,0,
2025-08-29,Patrick Kaltenbach,Mettler-Toledo International,2,7,1,10,
2025-08-29,Michael L Baur,ScanSource,0,5,0,5,
2025-08-29,Jason Lippert,LCI Industries,4,11,0,15,
2025-08-29,Fredric J Tomczyk,Cboe Global Markets,2,5,0,7,
2025-08-29,Octavio Marquez,Diebold Nixdorf,6,13,1,20,
2025-08-29,Sivasankaran Somasundaram,ChampionX,7,1,0,8,
2025-08-29,Ronald F Clarke,Corpay,1,1,0,2,
2025-08-29,Robert W Pittman,iHeartMedia,5,2,0,7,
2025-08-29,Patrick Zalupski,Dream Finders Homes,25,13,2,40,
2025-08-29,Keith E Smith,Boyd Gaming,1,7,1,9,
2025-08-29,Mehran Assadi,NLV Financial,1,1,0,2,
2025-08-29,Barry R Port,Ensign Group,2,5,1,8,
2025-08-29,Denise A Paulonis,Sally Beauty,1,3,0,4,
2025-08-29,Clifford A Skelton,Conduent,0,0,0,0,
2025-08-29,Jean-Michel Ribieras,Sylvamo,3,7,0,10,
2025-08-29,Douglas F Bauer,Tri Pointe Homes,0,4,0,4,
2025-08-29,Shawn O'Connell,EnerSys,3,5,0,8,
2025-08-29,Bill Meury,Incyte,9,16,0,25,
2025-08-29,Dale Francescon,Century Communities,0,8,3,11,
2025-08-29,Michael Nierenberg,Rithm Capital,7,25,1,33,
2025-08-29,Michael J Brown,Euronet Worldwide,2,8,0,10,
2025-08-29,Scott Seu,Hawaiian Electric Industries,6,17,3,26,
2025-08-29,Jason D Robins,DraftKings,5,3,0,8,
2025-08-29,Jonathan J Mazelsky,IDEXX Laboratories,1,2,1,4,
2025-08-29,Richard S Swartz,MYR Group,0,2,0,2,
2025-08-29,Stefano Caroti,Deckers Outdoor,2,7,1,10,
2025-08-29,Kevin R Sayer,DexCom,3,4,0,7,
2025-08-29,John T C Lee,MKS Instruments,4,8,1,13,
2025-08-29,Edward B Pitoniak,VICI Properties,1,7,0,8,
2025-08-29,Albert White III,Cooper Cos,0,0,0,0,
2025-08-29,Barry L Biffle,Frontier Airlines,1,6,6,13,
2025-08-29,Robert A Bruggeworth,Qorvo,3,5,0,8,
2025-08-29,Winnie Park,Five Below,10,27,3,40,
2025-08-29,Steven Oakland,TreeHouse Foods,3,11,0,14,
2025-08-29,James S Hagedorn,Scotts Miracle-Gro,1,1,0,2,
2025-08-29,Michael Cannon-Brookes,Atlassian,19,19,2,40,
2025-08-29,Bertrand Loy,Entegris,3,11,1,15,
2025-08-29,William E Waltz,Atkore,2,7,0,9,
2025-08-29,Celeste B Mastin,H B Fuller,1,4,0,5,
2025-08-29,Kyle T Larkin,Granite Construction,1,7,0,8,
2025-08-29,Michael J Happe,Winnebago Industries,1,5,0,6,
2025-08-29,Steven H Gunby,FTI Consulting,4,12,0,16,
2025-08-29,Stephan B Tanda,AptarGroup,1,3,3,7,
2025-08-29,Timothy P Boyle,Columbia Sportswear,3,3,2,8,
2025-08-29,Anthony J Wood,Roku,5,2,1,8,
2025-08-29,M Christopher Doyle,Civitas Resources,1,2,0,3,
2025-08-29,Andy Eidson,Alpha Metallurgical Resources,1,7,2,10,
2025-08-29,Andy L Nemeth,Patrick Industries,3,2,0,5,
2025-08-29,Roger W Jenkins,Murphy Oil,4,14,0,18,
2025-08-29,Kevin S Blair,Synovus Financial,7,3,0,10,
2025-08-29,Julie Felss Masino,Cracker Barrel Old Country Store,6,18,16,40,
2025-08-29,David M Overton,Cheesecake Factory,1,9,0,10,
2025-08-29,Nick DeIuliis,CNX Resources,10,3,2,15,
2025-08-29,Christopher Pappas,Chefs Warehouse,3,8,1,12,
2025-08-29,Tod Carpenter,Donaldson Company,2,8,0,10,
2025-08-29,Gregory L Christopher,Mueller Industries,1,5,0,6,
2025-08-29,Rob Saltiel,MRC Global,6,12,2,20,
2025-08-29,Jillian C Evanko,Chart Industries,3,6,0,9,
2025-08-29,Dave Guilmette,Alight Solutions,3,7,0,10,
2025-08-29,Joel Smejkal,Vishay Intertechnology,5,4,1,10,
2025-08-29,Dennis Degner,Range Resources,4,6,0,10,
2025-08-29,Ira D Robbins,Valley National Bancorp,1,3,0,4,
2025-08-29,Bernard Kim,Match Group,15,18,7,40,
2025-08-29,Vincent Pilette,Gen Digital,1,14,1,16,
2025-08-29,Timothy S Crane,Wintrust Financial,2,7,0,9,
2025-08-29,Pat Roche,Moog inc,4,10,1,15,
2025-08-29,Mark R Widmar,First Solar,3,7,2,12,
2025-08-29,Niko Lahanas,Central Garden & Pet,1,12,0,13,
2025-08-29,Chris Osowski,Green Plains inc,7,14,1,22,
2025-08-29,Derek J Leathers,Werner Enterprises,1,7,2,10,
2025-08-29,Adam Foroughi,AppLovin,10,26,4,40,
2025-08-29,Luca Savi,ITT,3,5,0,8,
2025-08-29,Lawrence H Silber,Herc Rentals,0,0,0,0,
2025-08-29,Hilton H Howell Jr,Gray Television,7,20,1,28,
2025-08-29,Eric D Ashleman,IDEX,0,7,1,8,
2025-08-29,Owen D Thomas,Boston Properties,2,8,0,10,
2025-08-29,Kurt Wolf,Pitney Bowes,6,18,2,26,
2025-08-29,Sara E Armbruster,Steelcase,1,0,0,1,
2025-08-29,Charles D. Young,Sun Communities,2,5,0,7,
2025-08-29,Suzanne Foster,AdaptHealth,4,9,1,14,
2025-08-29,Grant E Sims,Genesis Energy,5,3,0,8,
2025-08-29,Laura Prieskorn,Jackson Financial,3,5,2,10,
2025-08-29,Rick L Wessel,FirstCash,2,6,1,9,
2025-08-29,Sherman Miller,Cal-Maine Foods,11,27,2,40,
2025-08-29,Paul A Lang,Arch Resources,4,3,1,8,
2025-08-29,Ashish K Khandpur,Avient,2,6,0,8,
2025-08-29,Shyam K Reddy,BlueLinx,1,7,0,8,
2025-08-29,Christopher S Ripley,Sinclair,1,7,0,8,
2025-08-29,Stacy Kymes,BOK Financial,8,5,0,13,
2025-08-29,James H Walter,Permian Resources,1,2,0,3,
2025-08-29,Jason Murray,PACS Group,5,13,3,21,
2025-08-29,Brian Armstrong,Coinbase Global,13,22,5,40,
2025-08-29,Oscar K Brown,Western Midstream Partners,1,3,0,4,
2025-08-29,Nicholas R Lower,Federated Mutual Insurance,0,1,0,1,
2025-08-29,Morris Goldfarb,G-III Apparel Group,11,24,5,40,
2025-08-29,Mark D Morelli,Vontier,0,5,0,5,
2025-08-29,Matthew J Cox,Matson inc,0,5,0,5,
2025-08-29,David W Grzebinski,Kirby Corporation,0,3,0,3,
2025-08-29,Keith A Harvey,Kaiser Aluminum,3,4,2,9,
2025-08-29,Eric Nyman,Vista Outdoor,4,10,1,15,
2025-08-29,Doug Howe,Designer Brands,4,18,0,22,
2025-08-29,Jerry E Gahlhoff Jr,Rollins inc,0,2,0,2,
2025-08-29,D Scott Barbour,Advanced Drainage Systems,2,3,0,5,
2025-08-29,Sean Gamble,Cinemark,17,22,1,40,
2025-08-29,George Kurtz,CrowdStrike,17,21,2,40,
2025-08-29,Bill Ready,Pinterest,25,15,0,40,
2025-08-29,Fidji Simo,Instacart,11,28,1,40,
2025-08-29,Kimberly K Ryan,Hillenbrand,3,6,0,9,
2025-08-29,David S Graziosi,Allison Transmission,3,14,2,19,
2025-08-29,Gary G Friedman,Restoration Hardware,2,5,0,7,
2025-08-29,Lucinda M Baier,Brookdale Senior Living,4,3,1,8,
2025-08-29,Brian J Blaser,QuidelOrtho,1,9,0,10,
2025-08-29,E Jean Savage,Trinity Industries,1,8,1,10,
2025-08-29,Liam J Kelly,Teleflex,1,4,1,6,
2025-08-29,Laurans A Mendelson,HEICO,9,20,2,31,
2025-08-29,Frank H Laukien,Bruker,1,10,0,11,
2025-08-29,Harvey M Schwartz,Carlyle Group,8,13,0,21,
2025-08-29,Mark S LaVigne,Energizer,2,0,0,2,
2025-08-29,Joel Quadracci,Quad/Graphics,9,24,5,38,
2025-08-29,Amar Maletira,Rackspace Technology,4,9,3,16,
2025-08-29,Udit Batra,Waters Corporation,12,23,1,36,
2025-08-29,Eric M Green,West Pharmaceutical Services,1,9,0,10,
2025-08-29,Doug Palladini,Carters inc,2,2,2,6,
2025-08-29,G Mike Mikan,NeueHealth,3,2,0,5,
2025-08-29,Russell ChipChilds,SkyWest,0,0,0,0,
2025-08-29,Christopher H Hunter,Acadia Healthcare,0,1,0,1,
2025-08-29,Prahlad Singh,Revvity,1,7,0,8,
2025-08-29,Maria M Pope,Portland General Electric,1,3,0,4,
2025-08-29,Charles Chip Blankenship,Woodward inc,0,2,0,2,
2025-08-29,Mike Steib,TEGNA,15,19,2,36,
2025-08-29,Kurt J Ekert,Sabre Corporation,0,1,0,1,
2025-08-29,Matt Wilson,Light & Wonder,16,21,3,40,
2025-08-29,Rob Katz,Vail Resorts,2,15,23,40,
2025-08-29,Schnitzer Steel Industries,Radius Recycling,8,25,6,39,
2025-08-29,David A Spector,PennyMac Financial Services,3,0,0,3,
2025-08-29,Frederick J Holzgrefe III,Saia inc,1,1,0,2,
2025-08-29,Mark J Parrell,Equity Residential,3,7,0,10,
2025-08-29,John W Lindsay,Helmerich & Payne,1,5,0,6,
2025-08-29,Gary D Burnison,Korn Ferry,4,12,0,16,
2025-08-29,Timothy J McGrath,PC Connection Inc,1,4,0,5,
2025-08-29,Lynn M Bamford,Curtiss-Wright,11,5,0,16,
2025-08-29,Jonathan W Witter,Sallie Mae,0,0,0,0,
2025-08-29,Jeff Benck,Benchmark Electronics,1,8,0,9,
2025-08-29,Charles H Giancarlo,Pure Storage,1,3,0,4,
2025-08-29,Brian R Gray,Knife River Corporation,0,2,0,2,
2025-08-29,Jay Schmidt,Caleres inc,3,4,2,9,
2025-08-29,Dale Asplund,BrightView Holdings,1,5,0,6,
2025-08-29,Jeffrey S Edwards,Cooper-Standard,0,6,0,6,
2025-08-29,Glenn J Williams,Primerica,6,2,2,10,
2025-08-29,Francois Locoh-Donou,F5,5,20,3,28,
2025-08-29,Joseph Wm Foran,Matador Resources,7,9,0,16,
2025-08-29,Sridhar Ramaswamy,Snowflake inc,13,24,3,40,
2025-08-29,Mark D Dankberg,Viasat,2,4,2,8,
2025-08-29,Francisco J Leon,California Resources,0,3,1,4,
2025-08-29,Peter Stern,Peloton,17,18,5,40,
2025-08-29,David Baszucki,Roblox,10,19,11,40,
2025-08-29,Jeffrey W Edwards,Installed Building Products,2,3,0,5,
2025-08-29,Clark Lauritzen,First National of Nebraska,1,7,0,8,
2025-08-29,Carlos Alberini,Guess inc,12,27,1,40,
2025-08-29,Shyam P Kambeyanda,ESAB,4,3,0,7,
2025-08-29,Edmund Shallcross III,Amica Mutual Insurance,1,4,0,5,
2025-08-29,Benjamin W Schall,AvalonBay Communities,1,7,1,9,
2025-08-29,Allan C Thygesen,DocuSign,2,8,0,10,
2025-08-29,Bryan J Knutson,Titan Machinery,2,0,2,4,
2025-08-29,Heath Sampson,ModivCare,7,2,1,10,
2025-08-29,Ara K Hovnanian,Hovnanian Enterprises,1,19,2,22,
2025-08-29,Joshua G Silverman,Etsy,2,4,0,6,
2025-08-29,Kevin Roycraft,Adams Resources & Energy,7,2,1,10,
2025-08-29,J Eric Evans,Surgery Partners,0,2,0,2,
2025-08-29,Clint E Stein,Columbia Banking System,1,6,0,7,
2025-08-29,Lee M Shavel,Verisk Analytics,4,6,0,10,
2025-08-29,Dave Banyard Jr,MasterBrand,0,0,0,0,
2025-08-29,Peter R Ingram,Hawaiian Airlines inc,1,1,0,2,
2025-08-29,Kristin A Dolan,AMC Networks,3,2,0,5,
2025-08-29,Brendan T Cavanagh,SBA Communications,1,2,0,3,
2025-08-29,George F Chappelle Jr,Americold Realty Trust,1,3,0,4,
2025-08-29,Thomas E Gottwald,NewMarket Corporation,2,7,0,9,
2025-08-29,Thomas J Baltimore Jr,Park Hotels & Resorts,3,26,0,29,
2025-08-29,Peter M Moglia,Alexandria Real Estate Equities,5,5,0,10,
2025-08-29,Ronald J Kramer,Griffon Corporation,2,5,0,7,
2025-08-29,John L Plueger,Air Lease,2,12,0,14,
2025-08-29,Jennifer F Scanlon,UL Solutions,2,6,0,8,
2025-08-29,Greg Smith,Teradyne,2,9,2,13,
2025-08-29,Sean Trauschke,OGE Energy,16,5,0,21,
2025-08-29,Norman D Schwartz,Bio-Rad Laboratories,1,0,1,2,
2025-08-29,Scott Doyle,Spire inc,4,5,1,10,
2025-08-29,Michael E Reed,Gannett,0,4,1,5,
2025-08-29,Cindy J Miller,Stericycle,2,6,1,9,
2025-08-29,Phillip D Green,Cullen Frost Bankers,1,4,2,7,
2025-08-29,Joseph D Margolis,Extra Space Storage,0,9,1,10,
2025-08-29,Mark A Skonieczny,REV Group,7,3,0,10,
2025-08-29,Ladd Wilks,ProFrac Holding,4,3,1,8,
2025-08-29,Sundaram Nagarajan,Nordson,2,10,1,13,
2025-08-29,Anne P Noonan,Summit Materials,0,1,0,1,
2025-08-29,Lori Flees,Valvoline inc,4,4,2,10,
2025-08-29,Scott H Baxter,Kontoor Brands,2,3,0,5,
2025-08-29,Tim Larson,Skyline Champion,7,0,0,7,
2025-08-29,Chuck Divita,Teladoc Health,10,17,4,31,
2025-08-29,W Bradley Southern,Louisiana-Pacific Corporation,0,1,0,1,
2025-08-29,George C Freeman III,Universal Corporation,4,6,0,10,
2025-08-29,James A Brock,Consol Energy,2,0,0,2,
2025-08-29,Robert Antokol,Playtika Holding,1,7,1,9,
2025-08-29,Joe Craft,Alliance Resource Partners,7,10,1,18,
2025-08-29,Paul Keel,Envista,2,6,1,9,
2025-08-29,Jared Isaacman,Shift4 Payments,9,27,4,40,
2025-08-29,Mark Mac McFarland,Talen Energy,4,1,1,6,
2025-08-29,Tony R Thene,Carpenter Technology,3,8,0,11,
2025-08-29,Melissa D Smith,WEX,3,6,0,9,
2025-08-29,James Jim C Ryan III,Old National Bancorp,1,0,0,1,
2025-08-29,Peter J Federico,AGNC Investment,2,0,0,2,
2025-08-29,Brent L Yeagy,Wabash National,0,1,0,1,
2025-08-29,Henry A Fernandez,MSCI,4,15,0,19,
2025-08-29,Mark Penn,Stagwell,12,25,2,39,
2025-08-29,Julie Schertell,Mativ,3,8,0,11,
2025-08-29,Ashish Chand,Belden,3,5,2,10,
2025-08-29,Greg Anderson,Allegiant Travel Company,4,6,0,10,
2025-08-29,Drew Houston,Dropbox,15,17,8,40,
2025-08-29,Kevin T Conroy,Exact Sciences,2,5,2,9,
2025-08-29,Rex D Geveden,BWX Technologies,3,7,0,10,
2025-08-29,Scott R Wells,Clear Channel Outdoor Hldgs,0,0,0,0,
2025-08-29,Paul Bay,Ingram Micro,11,24,5,40,
2025-08-30,Doug McMillon,Walmart,16,19,5,40,
2025-08-30,Andrew Jassy,Amazon,3,30,7,40,
2025-08-30,Tim Cook,Apple,16,18,6,40,
2025-08-30,Stephen Hemsley,UnitedHealth,7,26,7,40,
2025-08-30,Warren Buffett,Berkshire Hathaway,14,20,6,40,
2025-08-30,David Joyner,CVS Health,9,27,4,40,
2025-08-30,Darren Woods,Exxon Mobil,8,24,7,39,
2025-08-30,Sundar Pichai,Alphabet,16,18,6,40,
2025-08-30,Brian Tyler,McKesson,4,15,5,24,
2025-08-30,Robert Mauch,Cencora,3,7,0,10,
2025-08-30,Ron Vachris,Costco,5,33,2,40,
2025-08-30,Jamie Dimon,JPMorgan Chase,9,18,13,40,
2025-08-30,Satya Nadella,Microsoft,14,17,9,40,
2025-08-30,Jason Hollar,Cardinal Health,14,22,4,40,
2025-08-30,Mike Wirth,Chevron,18,16,6,40,
2025-08-30,David Cordani,Cigna,22,14,4,40,
2025-08-30,Jim Farley,Ford Motor,12,22,6,40,
2025-08-30,Brian Moynihan,Bank of America,6,27,7,40,
2025-08-30,Mary Barra,General Motors,14,22,4,40,
2025-08-30,Gail Boudreaux,Elevance Health,15,18,7,40,
2025-08-30,Jane Fraser,Citigroup,11,23,6,40,
2025-08-30,Sarah London,Centene,13,18,9,40,
2025-08-30,Ted Decker,Home Depot,10,23,7,40,
2025-08-30,Maryann Mannen,Marathon Petroleum,5,12,1,18,
2025-08-30,Ron Sargent,Kroger,5,22,13,40,
2025-08-30,Mark Lashier,Phillips 66,11,20,7,38,
2025-08-30,Priscilla Almodovar,Fannie Mae,11,18,11,40,
2025-08-30,Tim Wentworth,Walgreens,7,24,9,40,
2025-08-30,Lane Riggs,Valero Energy,14,9,0,23,
2025-08-30,Mark Zuckerberg,Meta,7,23,10,40,
2025-08-30,Hans Vestberg,Verizon,15,21,4,40,
2025-08-30,John Stankey,AT&T,12,25,3,40,
2025-08-30,Brian Roberts,Comcast,11,26,3,40,
2025-08-30,Charles Scharf,Wells Fargo,28,6,6,40,
2025-08-30,David Solomon,Goldman Sachs,7,22,11,40,
2025-08-30,Michael Hutchins,Freddie Mac,2,10,3,15,
2025-08-30,Michael Fiddelke,Target,10,22,8,40,
2025-08-30,Jim Rechtin,Humana,18,17,5,40,
2025-08-30,Jon Farney,State Farm Insurance,1,12,3,16,
2025-08-30,Elon Musk,Tesla,7,15,18,40,
2025-08-30,Ted Pick,Morgan Stanley,15,22,3,40,
2025-08-30,Joaquin Duato,Johnson & Johnson,11,25,4,40,
2025-08-30,Juan Luciano,Archer Daniels Midland,3,21,13,37,
2025-08-30,Ramon Laguarta,PepsiCo,7,28,5,40,
2025-08-30,Carol Tom√©,UPS,8,21,11,40,
2025-08-30,Rajesh Subramaniam,FedEx,8,27,0,35,
2025-08-30,Bob Iger,Walt Disney,11,27,2,40,
2025-08-30,Michael Dell,Dell Technologies,13,22,5,40,
2025-08-30,Marvin Ellison,Lowes,14,23,2,39,
2025-08-30,Jon Moeller,Procter & Gamble,6,28,6,40,
2025-08-30,Thomas Long,Energy Transfer,8,0,2,10,
2025-08-30,Kelly Ortberg,Boeing,11,25,4,40,
2025-08-30,Susan Morris,Albertsons,12,25,3,40,
2025-08-30,Kevin Hourican,Sysco,10,27,3,40,
2025-08-30,Christopher Calio,RTX,7,11,0,18,
2025-08-30,Larry Culp,General Electric,11,26,3,40,
2025-08-30,James Taiclet,Lockheed Martin,12,19,9,40,
2025-08-30,Stephen Squeri,American Express,13,25,2,40,
2025-08-30,Joe Creed,Caterpillar,11,26,3,40,
2025-08-30,Michel Khalaf,MetLife,11,16,0,27,
2025-08-30,Samuel Hazen,HCA Healthcare,8,7,0,15,
2025-08-30,Tricia Griffith,Progressive Insurance,10,26,4,40,
2025-08-30,Arvind Krishna,IBM,13,21,6,40,
2025-08-30,John May,Deere,10,25,5,40,
2025-08-30,Jensen Huang,Nvidia,11,27,2,40,
2025-08-30,Philip Smith,StoneX,0,8,1,9,
2025-08-30,Robert M Davis,Merck,4,19,0,23,
2025-08-30,Ryan Lance,ConocoPhillips,18,19,3,40,
2025-08-30,Albert Bourla,Pfizer,18,13,9,40,
2025-08-30,Ed Bastian,Delta Air Lines,11,21,8,40,
2025-08-30,Patrick Zammit,TD Synnex,10,15,0,25,
2025-08-30,Kevin Murphy,Publix Super Markets,9,22,1,32,
2025-08-30,Thomas J Wilson,Allstate,0,9,1,10,
2025-08-30,Chuck Robbins,Cisco Systems,15,23,2,40,
2025-08-30,Kirt Walker,Nationwide,14,17,2,33,
2025-08-30,Christopher Winfrey,Charter Communications,5,16,5,26,
2025-08-30,Bob Michael,AbbVie,0,0,0,0,
2025-08-30,Craig DeSanto,New York Life Insurance,3,17,0,20,
2025-08-30,Lip-Bu Tan,Intel,10,13,17,40,
2025-08-30,Ernie Herrman,TJX,14,24,2,40,
2025-08-30,Andrew Sullivan,Prudential Financial,12,21,0,33,
2025-08-30,Enrique Lores,Hewlett Packard,12,16,8,36,
2025-08-30,Scott Kirby,United Airlines,34,3,3,40,
2025-08-30,George Holm,Performance Food,11,22,2,35,
2025-08-30,Donnie King,Tyson Foods,10,25,5,40,
2025-08-30,Robert Isom,American Airlines,6,27,7,40,
2025-08-30,Timothy M Sweeney,Liberty Mutual Insurance,14,0,0,14,
2025-08-30,Elliott Hill,Nike,7,30,3,40,
2025-08-30,Safra Catz,Oracle,12,21,7,40,
2025-08-30,AJ Jim Teague,Enterprise Products Partners,4,6,0,10,
2025-08-30,Richard Fairbank,Capital One,14,24,2,40,
2025-08-30,Wilfred Chiang,Plains GP,0,1,0,1,
2025-08-30,Michael Kasbar,World Kinect,1,10,0,11,
2025-08-30,Peter Zaffino,American International Group,10,26,4,40,
2025-08-30,James Quincey,The Coca-Cola Company,9,28,3,40,
2025-08-30,Thasunda Brown Duckett,TIAA,20,20,0,40,
2025-08-30,Jay Debertin,CHS,3,9,4,16,
2025-08-30,Chris Boerner,Bristol-Myers Squibb,10,23,7,40,
2025-08-30,Corie Barry,Best Buy,39,1,0,40,
2025-08-30,Marc Casper,Thermo Fisher Scientific,14,23,3,40,
2025-08-30,Roger Crandall,Mass Mutual,3,7,0,10,
2025-08-30,Juan Andrade,USAA,5,16,0,21,
2025-08-30,Phebe Novakovic,General Dynamics,28,9,3,40,
2025-08-30,Alan Schnitzer,Travelers Insurance,3,6,1,10,
2025-08-30,David Zaslav,Warner Bros Discovery,6,21,12,39,
2025-08-30,Gunjan Kedia,US Bancorp,14,24,2,40,
2025-08-30,Robert Ford,Abbott Laboratories,10,24,6,40,
2025-08-30,Kathy Warden,Northrop Grumman,16,20,4,40,
2025-08-30,Tim Gerend,Northwestern Mutual,14,25,1,40,
2025-08-30,Todd Vasos,Dollar General,6,28,5,39,
2025-08-30,Matthew Lucey,PBF Energy,7,3,0,10,
2025-08-30,Dara Khosrowshahi,Uber,12,20,8,40,
2025-08-30,Vimal Kapur,Honeywell,12,28,0,40,
2025-08-30,Dirk Van de Put,Mondelez,10,27,3,40,
2025-08-30,Brian Niccol,Starbucks,10,30,0,40,
2025-08-30,Cristiano Amon,Qualcomm,12,27,1,40,
2025-08-30,Hock Tan,Broadcom,11,25,4,40,
2025-08-30,David Flitman,US Foods,2,7,0,9,
2025-08-30,Paul Romanowski,DR Horton,5,16,5,26,
2025-08-30,Jacek Olczak,Philip Morris,14,22,4,40,
2025-08-30,Preston Feight,Paccar,10,29,1,40,
2025-08-30,Marc Benioff,Salesforce,8,22,10,40,
2025-08-30,Leon Topalian,Nucor,16,22,2,40,
2025-08-30,Michael Dastoor,Jabil,1,8,0,9,
2025-08-30,Jonathan Jaffe,Lennar,1,8,1,10,
2025-08-30,David Ricks,Eli Lilly,10,22,8,40,
2025-08-30,Joe Zubretsky,Molina Healthcare,8,6,4,18,
2025-08-30,Jennifer Rumsey,Cummins,9,25,6,40,
2025-08-30,Robin Vince,Bank of New York Mellon,20,18,2,40,
2025-08-30,Ted Sarandos,Netflix,13,24,3,40,
2025-08-30,William H Rogers Jr,Truist Financial,2,7,1,10,
2025-08-30,Sean Kerins,Arrow Electronics,2,14,0,16,
2025-08-30,William M Brown,3M,2,8,0,10,
2025-08-30,Ryan McInerney,Visa,16,19,5,40,
2025-08-30,Marc Rowan,Apollo Global Management,18,18,4,40,
2025-08-30,Tim Go,HF Sinclair,6,3,0,9,
2025-08-30,Robert Sulentic,CBRE Group,1,7,1,9,
2025-08-30,William Demchak,PNC Financial Services,12,23,5,40,
2025-08-30,Bryan DeBoer,Lithia Motors,11,27,1,39,
2025-08-30,William Nash,CarMax,3,4,2,9,
2025-08-30,Brian Robbins,Paramount Global,6,31,0,37,
2025-08-30,Michael Creedon,Dollar Tree,3,34,3,40,
2025-08-30,Sandy Douglas,United Natural Foods,33,5,2,40,
2025-08-30,Alex Chriss,PayPal,12,25,3,40,
2025-08-30,Roger Penske,Penske Automotive,19,20,1,40,
2025-08-30,Antonio Neri,Hewlett Packard Enterprise,8,23,9,40,
2025-08-30,Harry Sideris,Duke Energy,37,3,0,40,
2025-08-30,Vicki Hollub,Occidental Petroleum,19,16,4,39,
2025-08-30,Lawrence Coben,NRG Energy,6,2,0,8,
2025-08-30,Robert Bradway,Amgen,10,28,2,40,
2025-08-30,John Ketchum,NextEra Energy,22,18,0,40,
2025-08-30,Rainer Blair,Danaher,6,16,2,24,
2025-08-30,Daniel O'Day,Gilead Sciences,18,18,4,40,
2025-08-30,Michael Manley,AutoNation,3,5,2,10,
2025-08-30,Carlos Abrams-Rivera,Kraft Heinz,15,18,7,40,
2025-08-30,Philip Gallagher,Avnet,1,6,1,8,
2025-08-30,Gary Dickerson,Applied Materials,7,22,11,40,
2025-08-30,Bob Jordan,Southwest Airlines,9,23,8,40,
2025-08-30,Rick Wurster,Charles Schwab,14,21,4,39,
2025-08-30,Lorenzo Simonelli,Baker Hughes,16,20,4,40,
2025-08-30,Chris Kempczinski,McDonalds,10,23,7,40,
2025-08-30,Christopher Womack,Southern Company,4,6,0,10,
2025-08-30,Michael Miebach,Mastercard,12,25,3,40,
2025-08-30,Joseph Dominguez,Constellation Energy,11,11,1,23,
2025-08-30,Christopher Swift,The Hartford,14,22,4,40,
2025-08-30,Patricia Poppe,PG&E,8,16,2,26,
2025-08-30,Bom Kim,Coupang,12,27,1,40,
2025-08-30,Ezra Yacob,EOG Resources,21,13,3,37,
2025-08-30,Jim Vena,Union Pacific,20,20,0,40,
2025-08-30,Matt Schroeder,Rite Aid,4,33,3,40,
2025-08-30,Tony Spring,Macys,10,27,3,40,
2025-08-30,Anthony Capuano,Marriott International,14,24,2,40,
2025-08-30,Raymond E Scott,Lear Corporation,5,4,1,10,
2025-08-30,William Stengel II,Genuine Parts,0,3,0,3,
2025-08-30,Heidi Petz,Sherwin-Williams,9,26,3,38,
2025-08-30,Jeff Miller,Halliburton,11,23,6,40,
2025-08-30,Kathleen Quirk,Freeport-McMoRan,14,17,2,33,
2025-08-30,Michael Rapino,Live Nation Entertainment,13,24,3,40,
2025-08-30,John Doyle,Marsh & McLennan,9,9,0,18,
2025-08-30,Lisa Su,Advanced Micro Devices,16,19,5,40,
2025-08-30,Frank Holding,First Citizens BancShares,8,15,2,25,
2025-08-30,John Engel,WESCO International,5,11,1,17,
2025-08-30,David Gitlin,Carrier Global,13,25,2,40,
2025-08-30,Lourenco Goncalves,Cleveland-Cliffs,8,22,10,40,
2025-08-30,Calvin G Butler Jr,Exelon,5,4,0,9,
2025-08-30,Joseph Bae,KKR,19,19,2,40,
2025-08-30,Christine Leahy,CDW,1,12,2,15,
2025-08-30,Glenn Fogel,Booking Holdings,11,24,5,40,
2025-08-30,Brian Doubles,Synchrony Financial,5,7,2,14,
2025-08-30,Earl Austin,Quanta Services,2,6,2,10,
2025-08-30,Christian Ulbrich,Jones Lang LaSalle,9,21,0,30,
2025-08-30,Saumya Sutaria,Tenet Healthcare,4,4,1,9,
2025-08-30,William Gifford,Altria,3,3,2,8,
2025-08-30,Kevin Lobo,Stryker,12,24,4,40,
2025-08-30,Michael Hsu,Kimberly-Clark,6,6,1,13,
2025-08-30,Jack Fusco,Cheniere Energy,18,19,3,40,
2025-08-30,James Conroy,Ross Stores,4,11,0,15,
2025-08-30,Anthony Smurfit,Smurfit Westrock,3,6,0,9,
2025-08-30,Jeffrey Harmening,General Mills,4,17,4,25,
2025-08-30,Mark Stewart,Goodyear Tire & Rubber,5,33,2,40,
2025-08-30,Bob Eddy,BJs Wholesale Club,5,22,3,30,
2025-08-30,Peter Arduini,GE HealthCare Technologies,6,12,0,18,
2025-08-30,Noel Wallace,Colgate-Palmolive,8,22,2,32,
2025-08-30,Marc Bitzer,Whirlpool,12,12,16,40,
2025-08-30,Chris Kubasik,L3Harris Technologies,7,12,1,20,
2025-08-30,Shantanu Narayen,Adobe,19,20,1,40,
2025-08-30,Thomas Polen,Becton Dickinson,7,3,0,10,
2025-08-30,Richard P Dealy,Pioneer Natural Resources,4,3,0,7,
2025-08-30,Ravi Kumar S,Cognizant Technology Solutions,10,25,3,38,
2025-08-30,Andrew Clyde,Murphy USA,14,25,1,40,
2025-08-30,Mike Lyons,Fiserv,4,11,1,16,
2025-08-30,Jennifer Parmentier,Parker-Hannifin,2,10,0,12,
2025-08-30,William Fehrman,American Electric Power,3,7,0,10,
2025-08-30,Andrew Silvernail,International Paper,6,20,1,27,
2025-08-30,Jonas Prising,ManpowerGroup,7,21,2,30,
2025-08-30,John Zillmer,Aramark,6,14,2,22,
2025-08-30,Mark Millett,Steel Dynamics,19,2,0,21,
2025-08-30,Dan Amos,Aflac,14,19,7,40,
2025-08-30,Tony Cheng,Reinsurance Group of America,3,11,2,16,
2025-08-30,Karsanbhai,Emerson Electric,9,16,2,27,
2025-08-30,Ronald P O'Hanley,State Street,5,12,0,17,
2025-08-30,Timothy Knavish,PPG Industries,1,4,1,6,
2025-08-30,David Burritt,United States Steel,7,19,14,40,
2025-08-30,Maria Black,Automatic Data Processing,3,7,0,10,
2025-08-30,Daryl Kenningham,Group 1 Automotive,9,29,2,40,
2025-08-30,Robert Blue,Dominion Energy,29,10,1,40,
2025-08-30,Larry Fink,BlackRock,7,25,8,40,
2025-08-30,Pierce Norton II,Oneok,5,5,0,10,
2025-08-30,David Bozeman,CH Robinson Worldwide,2,7,0,9,
2025-08-30,Haviv Ilan,Texas Instruments,13,24,3,40,
2025-08-30,Michael Bender,Kohls,2,24,14,40,
2025-08-30,Philip Daniele III,AutoZone,0,2,0,2,
2025-08-30,Timothy Archer,Lam Research,3,7,0,10,
2025-08-30,Charles Magro,Corteva,5,2,1,8,
2025-08-30,Rick Lanoha,Peter Kiewit Sons',0,2,0,2,
2025-08-30,Peter Jackson,Builders FirstSource,5,11,1,17,
2025-08-30,Martin Schroeter,Kyndryl,11,27,0,38,
2025-08-30,Hamid Akhavan,EchoStar,4,27,9,40,
2025-08-30,Bill Westrate,American Family Insurance,9,16,2,27,
2025-08-30,Avigal Soreq,Delek US,4,9,5,18,
2025-08-30,Beth Ford,Land O'Lakes,17,22,1,40,
2025-08-30,Walker Martin,Sempra,0,3,0,3,
2025-08-30,Eric Slifka,Global Partners,13,21,6,40,
2025-08-30,DG Macpherson,WW Grainger,2,7,1,10,
2025-08-30,Bob Pragada,Jacobs Solutions,6,6,0,12,
2025-08-30,Pedro Pizarro,Edison International,12,11,17,40,
2025-08-30,William Hornbuckle,MGM Resorts International,7,23,1,31,
2025-08-30,Andrew McMahon,Guardian Life insurance,6,13,0,19,
2025-08-30,Christopher O'Herlihy,Illinois Tool Works,4,5,1,10,
2025-08-30,James Cracchiolo,Ameriprise Financial,2,22,2,26,
2025-08-30,Ryan Marshall,PulteGroup,7,10,10,27,
2025-08-30,Matthew Meloy,Targa Resources,6,4,0,10,
2025-08-30,Michael Rhodes,Ally Financial,11,24,5,40,
2025-08-30,Joseph Fadool,BorgWarner,4,10,0,14,
2025-08-30,St√©phane de La Faverie,Est√©e Lauder,12,23,5,40,
2025-08-30,Benjamin Tisch,Loews,2,7,0,9,
2025-08-30,Brad Beckham,O'Reilly Automotive,4,14,1,19,
2025-08-30,Thomas Gayner,Markel Group,2,8,0,10,
2025-08-30,Donald Allan,Stanley Black & Decker,7,32,1,40,
2025-08-30,Sanjay Mehrotra,Micron Technology,17,21,2,40,
2025-08-30,James Breuer,Fluor,0,2,1,3,
2025-08-30,Thomas Bell,Leidos,8,20,2,30,
2025-08-30,Scott Smith,Viatris,5,4,0,9,
2025-08-30,Kimberly Dang,Kinder Morgan,11,1,0,12,
2025-08-30,Christophe Beck,Ecolab,20,20,0,40,
2025-08-30,Brent Shafer,Baxter International,1,9,0,10,
2025-08-30,Clay Gaspar,Devon Energy,19,3,0,22,
2025-08-30,Steven Cahillane,Kellanova,2,7,0,9,
2025-08-30,Raul Nicholas Vargas Ochoa,Farmers Insurance Exchange,0,0,0,0,
2025-08-30,Darren Rebelez,Caseys General Stores,3,6,0,9,
2025-08-30,Ari Bousbib,IQVIA,7,16,1,24,
2025-08-30,Jon Vander Ark,Republic Services,11,17,12,40,
2025-08-30,Timothy Cofer,Keurig Dr Pepper,1,3,0,4,
2025-08-30,Karla Lewis,Reliance Inc,2,6,0,8,
2025-08-30,David Hult,Asbury Automotive Group,7,32,1,40,
2025-08-30,Darryl Button,Pacific Life,1,7,0,8,
2025-08-30,James Burke,Vistra,6,3,1,10,
2025-08-30,John Barrett,Western & Southern Financial,9,29,2,40,
2025-08-30,William Krueger,The Andersons Inc,0,3,0,3,
2025-08-30,Erik Nordstrom,Nordstrom,6,28,5,39,
2025-08-30,John Wren,Omnicom Group,14,20,6,40,
2025-08-30,Stephanie Ferris,Fidelity National Information Services,15,22,3,40,
2025-08-30,Timothy Cawley,Consolidated Edison,4,6,0,10,
2025-08-30,Joseph Hinrichs,CSX,7,11,1,19,
2025-08-30,Troy Rudd,AECOM,8,24,5,37,
2025-08-30,Kathleen Johnson,Lumen Technologies,3,3,1,7,
2025-08-30,Harry Lawton III,Tractor Supply,1,1,0,2,
2025-08-30,Raul Fernandez,DXC Technology,2,34,2,38,
2025-08-30,Eric Hansotia,AGCO,14,20,1,35,
2025-08-30,David Bruton Smith,Sonic Automotive,5,9,9,23,
2025-08-30,Sasan Goodarzi,Intuit,10,26,4,40,
2025-08-30,Matthew Flannery,United Rentals,30,2,0,32,
2025-08-30,Marc Miller,Universal Health Services,5,23,3,31,
2025-08-30,Michael Mahoney,Boston Scientific,10,28,2,40,
2025-08-30,Judith Marks,Otis Worldwide,3,3,0,6,
2025-08-30,Robert Frenzel,Xcel Energy,3,2,2,7,
2025-08-30,Penny Pennington,Edward Jones,7,27,6,40,
2025-08-30,Daniel Fisher,Ball,3,18,4,25,
2025-08-30,Justin Jude,LKQ,4,6,1,11,
2025-08-30,James Blackledge,Mutual of Omaha,2,29,2,33,
2025-08-30,Bruce Bodine,Mosaic,3,7,0,10,
2025-08-30,Scott Donnelly,Textron,8,29,3,40,
2025-08-30,Adam Schechter,Labcorp Holdings,2,6,1,9,
2025-08-30,Deanna Strable-Soethout,Principal Financial,1,5,0,6,
2025-08-30,Leonard Schleifer,Regeneron Pharmaceuticals,5,28,7,40,
2025-08-30,Paul Shoukry,Raymond James Financial,14,26,0,40,
2025-08-30,Lauren Hobart,Dicks Sporting Goods,13,23,4,40,
2025-08-30,Jamie Whisnant,Auto-Owners Insurance,0,2,0,2,
2025-08-30,Ariane Gorin,Expedia,9,30,1,40,
2025-08-30,Shelley Simpson,JB Hunt Transport Services,9,28,3,40,
2025-08-30,Ren√© Jones,M&T Bank,14,23,3,40,
2025-08-30,Gerardo Norcia,DTE Energy,6,3,0,9,
2025-08-30,Andr√©s Gluski,AES,17,21,0,38,
2025-08-30,Timothy Spence,Fifth Third Bancorp,4,6,0,10,
2025-08-30,Eduardo Menezes,Air Products & Chemicals,3,6,1,10,
2025-08-30,Wendell Weeks,Corning,15,23,2,40,
2025-08-30,Anthony Guzzi,EMCOR Group,4,3,1,8,
2025-08-30,Adam Norwitt,Amphenol,3,16,0,19,
2025-08-30,Jean-Marc Gilson,Westlake Corporation,2,4,0,6,
2025-08-30,Lori Koch,DuPont,7,19,0,26,
2025-08-30,Derek Chang,Liberty Media,36,4,0,40,
2025-08-30,Martina Cheung,S&P Global,11,25,0,36,
2025-08-30,Tim Hingtgen,Community Health Systems,10,27,3,40,
2025-08-30,Brian Tierney,FirstEnergy,6,22,3,31,
2025-08-30,Rick McKenney,Unum Group,5,4,0,9,
2025-08-30,Stanley Bergman,Henry Schein,10,29,1,40,
2025-08-30,Tiang Yew Tan,Western Digital,0,1,0,1,
2025-08-30,Vincent Roche,Analog Devices,13,24,2,39,
2025-08-30,Sean Connolly,Conagra Brands,7,31,2,40,
2025-08-30,Bruce Van Saun,Citizens Financial Group,14,25,1,40,
2025-08-30,Mark George,Norfolk Southern,17,21,2,40,
2025-08-30,Andrew Marsh,Entergy,3,4,0,7,
2025-08-30,Robert Berkley,WR Berkley,8,30,2,40,
2025-08-30,Javier Rodriguez,DaVita,14,14,1,29,
2025-08-30,Michael O'Grady,Northern Trust,27,4,1,32,
2025-08-30,James Snee,Hormel Foods,3,26,1,30,
2025-08-30,Timothy J Donahue,Crown Holdings,1,9,0,10,
2025-08-30,Joseph Ferraro,Avis Budget,2,6,2,10,
2025-08-30,Niraj Shah,Wayfair,7,25,8,40,
2025-08-30,Jos√© Mas,MasTec,6,14,1,21,
2025-08-30,Joseph Nolan,Eversource Energy,5,3,1,9,
2025-08-30,Thomas Palmer,Newmont,7,3,0,10,
2025-08-30,Robert Sanchez,Ryder System,10,9,1,20,
2025-08-30,Michael Nolan,Fidelity National Financial,1,0,0,1,
2025-08-30,Gavin Hattersley,Molson Coors Beverage,6,30,4,40,
2025-08-30,Thomas Reeg,Caesars Entertainment,5,6,0,11,
2025-08-30,Ellen Cooper,Lincoln National,3,6,0,9,
2025-08-30,Bracken Darrell,VF Corporation,8,29,3,40,
2025-08-30,Erik Fyrwald,International Flavors & Fragrances,8,6,2,16,
2025-08-30,Christopher Kastner,Huntington Ingalls Industries,3,4,0,7,
2025-08-30,Shane O'Kelly,Advance Auto Parts,12,22,6,40,
2025-08-30,Ralph LaRossa,Public Service Enterprise Group,11,18,0,29,
2025-08-30,Kecia Steelman,Ulta Beauty,34,4,2,40,
2025-08-30,Michele Buck,Hershey,6,32,2,40,
2025-08-30,Sumit Singh,Chewy,13,22,5,40,
2025-08-30,Steven Vondran,American Tower,4,6,0,10,
2025-08-30,Jeffrey Lorberbaum,Mohawk Industries,11,6,1,18,
2025-08-30,Keith Demmings,Assurant,3,7,0,10,
2025-08-30,Robert Martin,Thor Industries,4,5,1,10,
2025-08-30,Kathleen Mazzarella,Graybar Electric,1,6,2,9,
2025-08-30,Joey Wat,Yum China,11,27,2,40,
2025-08-30,Scott Richardson,Celanese,9,26,5,40,
2025-08-30,David Rawlinson II,QVC,7,15,2,24,
2025-08-30,Alan Armstrong,Williams,24,12,4,40,
2025-08-30,Philippe Krakowsky,Interpublic Group,14,24,2,40,
2025-08-30,Brendan McCracken,Ovintiv,5,5,0,10,
2025-08-30,Andrew Teno,Icahn Enterprises,5,5,0,10,
2025-08-30,Stephen Steinour,Huntington Bancshares,2,8,0,10,
2025-08-30,Timothy NeCastro,Erie Insurance,3,6,1,10,
2025-08-30,Ernest Garcia III,Carvana,23,13,4,40,
2025-08-30,R Bruce McDonald,Dana Incorporated,3,6,1,10,
2025-08-30,William Oplinger,Alcoa Corporation,1,8,1,10,
2025-08-30,Mark Pearson,Equitable,8,8,0,16,
2025-08-30,Richard Wallace,KLA,4,5,0,9,
2025-08-30,Ricardo Cardenas,Darden Restaurants,4,2,1,7,
2025-08-30,Mikael Bratt,Autoliv,6,7,2,15,
2025-08-30,Benito Minicucci,Alaska Air,3,3,1,7,
2025-08-30,Christopher Gorman,KeyCorp,5,5,0,10,
2025-08-30,Robert Goldstein,Las Vegas Sands,4,31,5,40,
2025-08-30,Edward Pesicka,Owens & Minor,4,33,2,39,
2025-08-30,Christopher Nassetta,Hilton Worldwide,6,16,2,24,
2025-08-30,Jamie Iannone,Ebay,19,17,4,40,
2025-08-30,Patrick Gallagher,Arthur J Gallagher,10,28,2,40,
2025-08-30,Rich Steinmeier,LPL Financial,24,14,2,40,
2025-08-30,Stephen Spray,Cincinnati Financial,1,5,3,9,
2025-08-30,Douglas Yearley,Toll Brothers,10,24,6,40,
2025-08-30,Gregory Brown,Motorola Solutions,2,8,0,10,
2025-08-30,Brian Chesky,Airbnb,3,30,7,40,
2025-08-30,Jeffrey Sprecher,Intercontinental Exchange,15,23,2,40,
2025-08-30,Robert Thomson,News Corp,7,29,4,40,
2025-08-30,Scott Boatwright,Chipotle Mexican Grill,7,28,5,40,
2025-08-30,Reshma Kewalramani,Vertex Pharmaceuticals,19,16,5,40,
2025-08-30,Christopher Viehbacher,Biogen,0,28,2,30,
2025-08-30,Malcolm Wilson,GXO Logistics,8,21,0,29,
2025-08-30,Tony Sarsam,SpartanNash,20,18,2,40,
2025-08-30,Michael O‚ÄôSullivan,Burlington Stores,8,28,4,40,
2025-08-30,Teresa Rasmussen,Thrivent Financial for Lutherans,4,0,0,4,
2025-08-30,Eugene Bredow,NVR,0,4,0,4,
2025-08-30,Brian Chambers,Owens Corning,3,12,1,16,
2025-08-30,Rafael Santana,Westinghouse Air Brake Technologies,3,6,1,10,
2025-08-30,John Pfeifer,Oshkosh,5,25,4,34,
2025-08-30,Cameron Bready,Global Payments,8,30,2,40,
2025-08-30,Calvin McDonald,Lululemon athletica,8,31,1,40,
2025-08-30,J Kent Masters,Albemarle Corporation,3,7,0,10,
2025-08-30,Joanna Geraghty,JetBlue Airways,14,21,5,40,
2025-08-30,Robert Steer,Seaboard,0,4,0,4,
2025-08-30,William Newlands,Constellation Brands,0,2,2,4,
2025-08-30,Michael Doss,Graphic Packaging,6,7,1,14,
2025-08-30,Gil West,Hertz,7,25,8,40,
2025-08-30,Malcolm C Roberts,FM Global,1,11,2,14,
2025-08-30,Mick Beekhuizen,Campbell Soup,8,24,1,33,
2025-08-30,Daniel Wall,Expeditors International of Washington,2,5,0,7,
2025-08-30,Gregory Roberts,A-Mark Precious Metals,2,4,1,7,
2025-08-30,Horacio Rozanski,Booz Allen Hamilton,17,18,5,40,
2025-08-30,James Davis,Quest Diagnostics,5,5,0,10,
2025-08-30,Dennis Mathew,Altice,5,28,7,40,
2025-08-30,Stefan Larsson,PVH,12,23,5,40,
2025-08-30,Mark Costa,Eastman Chemical,6,17,4,27,
2025-08-30,Joyce Mullen,Insight Enterprises,6,9,1,16,
2025-08-30,John Turner,Regions Financial,19,19,2,40,
2025-08-30,Julian G Francis,Beacon Roofing Supply,0,1,0,1,
2025-08-30,Blake Moret,Rockwell Automation,12,26,2,40,
2025-08-30,Mike Speetzen,Polaris Inc,3,17,2,22,
2025-08-30,William McDermott,ServiceNow,3,6,0,9,
2025-08-30,Jure Sola,Sanmina,2,12,0,14,
2025-08-30,Bob Flexon,UGI Utilities Inc,0,1,0,1,
2025-08-30,Scott Lauber,WEC Energy,13,4,0,17,
2025-08-30,Jon Rousseau,BrightSpring Health Services,19,20,1,40,
2025-08-30,Todd Schneider,Cintas,12,18,2,32,
2025-08-30,Peter Matt,Commercial Metals,5,4,0,9,
2025-08-30,Robert D Lawler,Continental Resources,1,0,0,1,
2025-08-30,Domenic Dell‚ÄôOsso Jr,Expand Energy,4,0,0,4,
2025-08-30,Jason P Wells,CenterPoint Energy,8,3,1,12,
2025-08-30,H Michael Krimbill,NGL Energy Partners,6,2,0,8,
2025-08-30,Tony Xu,DoorDash,13,19,8,40,
2025-08-30,Clay Williams,NOV,10,19,4,33,
2025-08-30,Kristin Peck,Zoetis,13,18,1,32,
2025-08-30,Mark Smucker,JM Smucker,11,23,6,40,
2025-08-30,Steve Sanghi,Microchip Technology,8,26,6,40,
2025-08-30,Richard Tobin,Dover Corporation,6,3,1,10,
2025-08-30,Kaes Van‚Äôt Hof,Diamondback Energy,22,15,2,39,
2025-08-30,Deon Stander,Avery Dennison,0,13,0,13,
2025-08-30,Vincent Sorgi,PPL,8,8,1,17,
2025-08-30,Hassane El-Khoury,ON Semiconductor,1,19,3,23,
2025-08-30,Arie Kotler,ARKO,5,18,0,23,
2025-08-30,William Monteleone,Par Pacific,1,6,2,9,
2025-08-30,John Christmann IV,APA,5,5,0,10,
2025-08-30,Adaire Fox-Martin,Equinix,16,21,3,40,
2025-08-30,Joseph M Otting,Flagstar Financial,2,7,0,9,
2025-08-30,Mary Dillon,Foot Locker,9,25,6,40,
2025-08-30,James Zallie,Ingredion,5,5,0,10,
2025-08-30,Christopher Peterson,Newell Brands,0,8,2,10,
2025-08-30,Scott Salmirs,ABM Industries,6,8,1,15,
2025-08-30,Christopher Hilger,Securian Financial,0,8,1,9,
2025-08-30,Hamid Moghadam,Prologis,7,27,6,40,
2025-08-30,Stephen Schwarzman,Blackstone,14,20,6,40,
2025-08-30,Robert Greenberg,Skechers USA,6,23,3,32,
2025-08-30,Keith Allman,Masco,4,9,1,14,
2025-08-30,Rusty Rush,Rush Enterprises,15,22,3,40,
2025-08-30,Jennifer Johnson,Franklin Resources,1,6,2,9,
2025-08-30,Gerry P Smith,ODP Business Solutions,1,0,0,1,
2025-08-30,Carl Lindner lll,American Financial,0,0,0,0,
2025-08-30,Mark Kowlzan,Packaging Corp of America,0,9,1,10,
2025-08-30,Thomas Hill,Vulcan Materials,4,8,2,14,
2025-08-30,Milan Galik,Interactive Brokers,7,18,1,26,
2025-08-30,Laura Alber,Williams-Sonoma,14,22,4,40,
2025-08-30,Mario Harik,XPO,7,32,1,40,
2025-08-30,Devin Stockfish,Weyerhaeuser,5,5,0,10,
2025-08-30,Thomas J McInerney,Genworth Financial,0,6,0,6,
2025-08-30,Garrick Rochow,CMS Energy,10,3,0,13,
2025-08-30,Toni Townes-Whitley,Science Applications International,12,20,1,33,
2025-08-30,Rich Handler,Jefferies Financial,11,10,2,23,
2025-08-30,Daniel Heaf,Bath & Body Works,10,28,2,40,
2025-08-30,Andrew Wilson,Electronic Arts,14,18,8,40,
2025-08-30,Sheryl Palmer,Taylor Morrison Home,6,12,1,19,
2025-08-30,Ivan Tornos,Zimmer Biomet,10,29,1,40,
2025-08-30,Linda Rendle,Clorox,2,35,1,38,
2025-08-30,Matthew Pine,Xylem Inc,1,8,1,10,
2025-08-30,Heather Lavallee,Voya Financial,5,10,2,17,
2025-08-30,Daniel Florness,Fastenal,2,6,1,9,
2025-08-30,Albert Nahmad,Watsco,2,8,0,10,
2025-08-30,Carl Eschenbach,Workday,12,19,9,40,
2025-08-30,Craig Smiddy,Old Republic International,4,5,1,10,
2025-08-30,Frank C Sullivan,RPM International,2,10,1,13,
2025-08-30,Matthew Missad,UFP Industries,7,2,0,9,
2025-08-30,Martin J Lyons,Ameren,3,3,1,7,
2025-08-30,Adam W Miller,Knight Swift Transportation,2,2,1,5,
2025-08-30,Rodney Sacks,Monster Beverage,13,25,1,39,
2025-08-30,Gary Guthart,Intuitive Surgical,14,24,2,40,
2025-08-30,Charles Liang,Super Micro Computer,32,7,1,40,
2025-08-30,Christopher Caldwell,Concentrix,2,5,0,7,
2025-08-30,Gordon J Hardie,O-I Glass,1,5,0,6,
2025-08-30,David Gibbs,Yum Brands,3,36,1,40,
2025-08-30,Steve Henry,Domtar,4,5,0,9,
2025-08-30,Chuck Treadway,CommScope,8,21,3,32,
2025-08-30,Rob Vitale,Post Holdings,1,12,5,18,
2025-08-30,Steven J Moskowitz,Crown Castle,2,5,3,10,
2025-08-30,Emmanuel Ligner,Avantor,5,11,2,18,
2025-08-30,Stuart Bradie,KBR,15,13,4,32,
2025-08-30,Carrie Wheeler,Opendoor Technologies,10,27,3,40,
2025-08-30,Russell Becker,APi Group,3,6,0,9,
2025-08-30,Toby Rice,EQT,24,14,2,40,
2025-08-30,Jesse Arenivas,EnLink Midstream,7,10,0,17,
2025-08-30,Nikesh Arora,Palo Alto Networks,5,27,8,40,
2025-08-30,Steven Bandrowczak,Xerox,1,8,1,10,
2025-08-30,Vicente Reynal,Ingersoll Rand,9,27,0,36,
2025-08-30,William T Dillard II,Dillards,3,5,2,10,
2025-08-30,C Howard Nye,Martin Marietta Materials,4,4,2,10,
2025-08-30,Giordano Albertazzi,Vertiv,19,18,3,40,
2025-08-30,Stephane Bancel,Moderna,10,21,9,40,
2025-08-30,Nate R Jorgensen,Boise Cascade,0,1,0,1,
2025-08-30,Jack Sinclair,Sprouts Farmers Market,16,23,1,40,
2025-08-30,Padraig McDonnell,Agilent Technologies,12,13,0,25,
2025-08-30,Kenneth T Lane,Olin,1,0,0,1,
2025-08-30,Randall C Stuewe,Darling Ingredients,27,1,0,28,
2025-08-30,R Howard Coker,Sonoco Products,3,6,1,10,
2025-08-30,John Mengucci,CACI International,21,17,2,40,
2025-08-30,Mark Witkowski,Core & Main,0,6,1,7,
2025-08-30,Lee M Tillman,Marathon Oil,5,3,0,8,
2025-08-30,Mark Hoplamazian,Hyatt Hotels,14,22,4,40,
2025-08-30,David S Chernow,Select Medical,0,8,1,9,
2025-08-30,Brendan M Foley,McCormick & Company,0,8,0,8,
2025-08-30,Joanne Crevoiserat,Tapestry,13,22,5,40,
2025-08-30,John Plant,Howmet Aerospace,4,14,1,19,
2025-08-30,Shankh Mitra,Welltower,17,21,2,40,
2025-08-30,W Anthony Will,CF Industries,4,5,0,9,
2025-08-30,David A Zapico,Ametek,2,17,0,19,
2025-08-30,Kevin Stein,TransDigm,9,9,3,21,
2025-08-30,Craig Billings,Wynn Resorts,13,24,3,40,
2025-08-30,William J Way,Southwestern Energy,1,1,0,2,
2025-08-30,Giel Rutten,Amkor Technology,2,9,1,12,
2025-08-30,Paul Sarvadi,Insperity,3,6,1,10,
2025-08-30,Donald Zurbay,Patterson Companies Inc,0,1,0,1,
2025-08-30,Rob Sharps,T Rowe Price,11,21,7,39,
2025-08-30,Patrice Louvet,Ralph Lauren,14,17,9,40,
2025-08-30,Jeffrey Mezger,KB Home,2,28,10,40,
2025-08-30,David M Foulkes,Brunswick,0,8,0,8,
2025-08-30,M Keith Waddell,Robert Half,2,9,1,12,
2025-08-30,Jay Snowden,PENN Entertainment,18,19,3,40,
2025-08-30,George Kurian,NetApp,14,23,3,40,
2025-08-30,Kevin Ali,Organon,9,18,0,27,
2025-08-30,Joel D Anderson,Petco Health and Wellness,3,11,0,14,
2025-08-30,Louis V Pinkham,Regal Rexnord,0,1,0,1,
2025-08-30,Jay Geldmacher,Resideo Technologies,10,5,1,16,
2025-08-30,Marcus Lemonis,Camping World,6,25,9,40,
2025-08-30,Peter R Huntsman,Huntsman,6,13,4,23,
2025-08-30,Hillary Super,Victorias Secret,12,4,8,24,
2025-08-30,Michelle Gass,Levi Strauss,12,24,3,39,
2025-08-30,Neil Hunn,Roper Technologies,2,21,0,23,
2025-08-30,Steven P Lawrence,Academy Sports and Outdoors,1,1,0,2,
2025-08-30,Phillippe Lord,Meritage Homes,9,17,0,26,
2025-08-30,David C Dauch,American Axle & Manufacturing,5,8,2,15,
2025-08-30,Olumide Soroye,Fortive,1,9,0,10,
2025-08-30,Adena Friedman,Nasdaq,15,21,4,40,
2025-08-30,Tim Gokey,Broadridge Financial Solutions,3,13,1,17,
2025-08-30,Patrick M Shanahan,Spirit AeroSystems,1,9,0,10,
2025-08-30,Robert Kyncl,Warner Music Group,11,28,1,40,
2025-08-30,Denise Dignam,Chemours,2,19,3,24,
2025-08-30,Jim DeVries,ADT,9,7,1,17,
2025-08-30,Bernard Zovighian,Edwards Lifesciences,7,6,2,15,
2025-08-30,Mark E Seaton,First American Financial,1,9,0,10,
2025-08-30,John C Roche,Hanover Insurance Group,4,16,1,21,
2025-08-30,Adam J Greenlee,Silgan,0,4,0,4,
2025-08-30,Jayne Hrdlicka,Endeavor Group,0,1,0,1,
2025-08-30,Robert Fauber,Moodys Corporation,0,6,0,6,
2025-08-30,Thomas E Jorden,Coterra Energy,8,0,0,8,
2025-08-30,Eugene A Hall,Gartner,1,9,0,10,
2025-08-30,Kevin Plank,Under Armour,8,27,5,40,
2025-08-30,James W Lanning,Ingles Markets,3,4,0,7,
2025-08-30,Matthew T Farrell,Church & Dwight,8,7,0,15,
2025-08-30,Kevin M Freeman,Old Dominion Freight Line,1,1,0,2,
2025-08-30,Joe Shoen,U-Haul,14,21,4,39,
2025-08-30,Mark Bertolini,Oscar Health,11,20,9,40,
2025-08-30,Jayshree Ullal,Arista Networks,22,18,0,40,
2025-08-30,Sassine Ghazi,Synopsys,10,27,3,40,
2025-08-30,Jochen Zeitz,Harley-Davidson,6,25,9,40,
2025-08-30,Nick Jeffery,Frontier Communications,10,27,2,39,
2025-08-30,Thomas Edward McCormick,Primoris Services,0,4,0,4,
2025-08-30,D Christian Koch,Carlisle Companies,1,3,1,5,
2025-08-30,David E Simon,Simon Property Group,2,5,2,9,
2025-08-30,Stephen Bratspies,Hanesbrands,3,11,0,14,
2025-08-30,Ryan M. Schneider,Anywhere Real Estate Inc,0,2,0,2,
2025-08-30,George Bobb III,Teledyne Technologies,1,4,1,6,
2025-08-30,Terrence A Duffy,CME Group,6,9,1,16,
2025-08-30,Rami Rahim,Juniper Networks,11,27,2,40,
2025-08-30,Sue Nabi,Coty,18,16,6,40,
2025-08-30,Peter D Arvan,Pool Corporation,2,8,0,10,
2025-08-30,David Campbell,Evergy,13,8,0,21,
2025-08-30,Matthew J Murphy,Marvell Technology,4,5,1,10,
2025-08-30,Lloyd Yates,NiSource,6,4,0,10,
2025-08-30,William C Stone,SS&C Technologies,2,4,1,7,
2025-08-30,Mark Rourke,Schneider National,9,17,1,27,
2025-08-30,Andrew Anagnost,Autodesk,9,23,8,40,
2025-08-30,Dustin Semach,Sealed Air Corporation,0,7,0,7,
2025-08-30,William L Meaney,Iron Mountain,4,18,1,23,
2025-08-30,Andy P Power,Digital Realty Trust,0,0,0,0,
2025-08-30,Satish Dhanasekaran,Keysight Technologies,4,12,1,17,
2025-08-30,Frank M Svoboda,Globe Life,3,4,3,10,
2025-08-30,Carey A Smith,Parsons Corporation,1,3,0,4,
2025-08-30,Ynon Kreiz,Mattel,9,24,7,40,
2025-08-30,Karen S Haller,Southwest Gas,3,6,0,9,
2025-08-30,Terrance Williams,TruStage,4,7,1,12,
2025-08-30,Eric W Gerstenberg,Clean Harbors,5,2,1,8,
2025-08-30,Gunner Smith,Cornerstone Building Brands,1,7,0,8,
2025-08-30,Gerben W Bakker,Hubbell,1,5,0,6,
2025-08-30,Dave Davis,Spirit Airlines,2,33,5,40,
2025-08-30,Michael J Smith,Lamb Weston,0,6,3,9,
2025-08-30,Strauss Zelnick,Take-Two Interactive Software,15,17,8,40,
2025-08-30,John C Turner Jr,GMS,2,8,0,10,
2025-08-30,David M O'Malley,Penn Mutual Life Insurance,0,2,0,2,
2025-08-30,Frank A Lonegro,Landstar System,2,4,0,6,
2025-08-30,James F Risoleo,Host Hotels & Resorts,6,17,1,24,
2025-08-30,Ken Xie,Fortinet,14,19,7,40,
2025-08-30,Doug Shulman,OneMain,2,7,0,9,
2025-08-30,Ryan Cohen,GameStop,10,22,8,40,
2025-08-30,Mark W Begor,Equifax,2,11,0,13,
2025-08-30,Jay L Schottenstein,American Eagle Outfitters,10,17,1,28,
2025-08-30,Curtis C Farmer,Comerica,3,9,0,12,
2025-08-30,Ole Rosgaard,Greif,4,19,1,24,
2025-08-30,Brian E Lane,Comfort Systems USA,9,1,0,10,
2025-08-30,Robert M Buck,TopBuild,0,5,1,6,
2025-08-30,Ralph Andretta,Bread Financial,3,8,0,11,
2025-08-30,Jim Anderson,Coherent,6,34,0,40,
2025-08-30,Walter C. D. Carlson,Telephone & Data Systems,0,2,0,2,
2025-08-30,Ronald Kruszewski,Stifel Financial,6,6,0,12,
2025-08-30,Richard Hayne,Urban Outfitters,11,20,7,38,
2025-08-30,Simon Meester,Terex,4,8,0,12,
2025-08-30,Edward J Lehner,Ryerson Holding,0,3,0,3,
2025-08-30,Nicholas T Pinchuk,Snap-on,3,6,0,9,
2025-08-30,Ryals McMullian,Flowers Foods,3,28,2,33,
2025-08-30,D Bryan Jordan,First Horizon,4,7,1,12,
2025-08-30,John B Gibson,Paychex,3,6,0,9,
2025-08-30,Chris Cocks,Hasbro,13,18,9,40,
2025-08-30,Pete McPartland,Sentry Insurance Group,0,2,0,2,
2025-08-30,Michael Arougheti,Ares Management,17,22,1,40,
2025-08-30,Alok Maskara,Lennox International,5,4,1,10,
2025-08-30,James C Grech,Peabody Energy,3,0,0,3,
2025-08-30,Joseph P Lacher Jr,Kemper,4,17,4,25,
2025-08-30,Perry A Sook,Nexstar Media Group,6,30,1,37,
2025-08-30,Wade Davis,TelevisaUnivision,12,26,2,40,
2025-08-30,Scott L Thompson,Tempur Sealy International,0,7,0,7,
2025-08-30,Mike Simonds,TriNet Group,0,7,0,7,
2025-08-30,B Andrew Rose,Worthington Enterprises,1,2,0,3,
2025-08-30,Bruce L Caswell,Maximus,5,5,0,10,
2025-08-30,Robert L Reffkin,Compass,1,7,0,8,
2025-08-30,Mark Eubanks,Brinks Company,1,2,1,4,
2025-08-30,Peter Quigley,Kelly Services inc,1,8,0,9,
2025-08-30,David L Yowan,Navient,2,3,0,5,
2025-08-30,Mary E Kipp,Puget Sound Energy,4,0,1,5,
2025-08-30,Adam Aron,AMC Entertainment,19,14,7,40,
2025-08-30,Mark J Tarr,Encompass Health,2,5,1,8,
2025-08-30,Liam K Griffin,Skyworks Solutions,1,7,0,8,
2025-08-30,Richard G Kyle,Timken,6,18,1,25,
2025-08-30,Ron Gusek,Liberty Energy,25,1,0,26,
2025-08-30,John E Geller Jr,Marriott Vacations Worldwide,6,6,1,13,
2025-08-30,Karl G. Glassman,Leggett & Platt,0,5,0,5,
2025-08-30,Bruce K Thorn,Big Lots,3,5,2,10,
2025-08-30,Jonathan H Weis,Weis Markets,12,27,0,39,
2025-08-30,Jeffrey B Guldner,Pinnacle West Capital,1,3,0,4,
2025-08-30,Arkadiy Dobkin,EPAM Systems,9,15,2,26,
2025-08-30,Paul M Rady,Antero Resources,3,8,0,11,
2025-08-30,Michael Spanos,Bloomin Brands,1,8,1,10,
2025-08-30,Nicole A Kivisto,MDU Resources Group,2,6,0,8,
2025-08-30,Gerald L Morgan,Texas Roadhouse,3,3,4,10,
2025-08-30,Gabriel Tirador,Mercury General,3,5,2,10,
2025-08-30,Nicholas I Fink,Fortune Brands Innovations,4,2,0,6,
2025-08-30,Paul E Burdiss,Zions Bancorp,1,1,0,2,
2025-08-30,William J Christensen,JELD-WEN Holding,2,6,0,8,
2025-08-30,Evan Spiegel,Snap Inc,21,17,2,40,
2025-08-30,Bill Burns,Zebra Technologies,6,24,1,31,
2025-08-30,Steven Sell,Agilon Health,1,7,1,9,
2025-08-30,Richard M Olson,Toro Company,1,14,1,16,
2025-08-30,Eric S Yuan,Zoom Video Communications,4,8,0,12,
2025-08-30,Dan L Batrack,Tetra Tech,2,6,1,9,
2025-08-30,Joseph D Russell Jr,Public Storage,0,7,0,7,
2025-08-30,Jacob Thaysen,Illumina inc,5,6,0,11,
2025-08-30,Debra A Cafaro,Ventas inc,8,4,0,12,
2025-08-30,Pierre R Brondeau,FMC Corporation,0,4,0,4,
2025-08-30,Judy R McReynolds,ArcBest,6,14,1,21,
2025-08-30,Russell J Weiner,Dominos Pizza inc,0,0,0,0,
2025-08-30,Theodore S Hanson,ASGN,0,2,0,2,
2025-08-30,RJ Scaringe,Rivian Automotive,13,25,2,40,
2025-08-30,Jeffrey N Simmons,Elanco Animal Health,3,6,1,10,
2025-08-30,Tim O Shaughnessy,Graham Holdings Company,2,6,0,8,
2025-08-30,Thomas V Taylor,Floor & Decor,1,1,2,4,
2025-08-30,Neil A Schrimsher,Applied Industrial Technologies,6,23,1,30,
2025-08-30,Robert E Price,PriceSmart,5,5,0,10,
2025-08-30,John David Risher,Lyft,3,3,1,7,
2025-08-30,Gary B Smith,Ciena,3,9,0,12,
2025-08-30,Joey Levin,IAC,6,29,1,36,
2025-08-30,Jim Jacobs,Country Financial,7,3,1,11,
2025-08-30,Devin B McGranahan,Western Union,1,6,0,7,
2025-08-30,R Scott Rowe,Flowserve,4,6,0,10,
2025-08-30,Kenneth A Vecchione,Western Alliance Bancorp,0,0,1,1,
2025-08-30,John C Rademacher,Option Care Health,7,3,0,10,
2025-08-30,Doug Black,SiteOne Landscape Supply,3,22,1,26,
2025-08-30,Oliver G Brewer III,Topgolf Callaway Brands,2,0,0,2,
2025-08-30,Glenn Sanford,eXp World,14,23,3,40,
2025-08-30,Fran Horowitz,Abercrombie & Fitch,12,22,6,40,
2025-08-30,Kevin Akers,Atmos Energy,7,2,1,10,
2025-08-30,Alessandro Maselli,Catalent,4,11,2,17,
2025-08-30,J Powell Brown,Brown & Brown,11,21,8,40,
2025-08-30,Aman Bhutani,GoDaddy,16,22,2,40,
2025-08-30,John C. Griffith,American Water Works,1,2,0,3,
2025-08-30,John J Marchioni,Selective Insurance Group,4,14,2,20,
2025-08-30,Lawson E Whiting,Brown-Forman,1,7,1,9,
2025-08-30,Dave Peacock,Advantage Solutions,21,7,0,28,
2025-08-30,Mick Farrell,ResMed,16,21,3,40,
2025-08-30,Kamal Hathi,Splunk,2,4,0,6,
2025-08-30,Todd Kelsey,Plexus,2,8,0,10,
2025-08-30,Phillip D Yeager,Hub Group,3,6,0,9,
2025-08-30,Steven B Hedlund,Lincoln Electric,5,9,0,14,
2025-08-30,Timothy C Oliver,NCR Atleos,0,1,0,1,
2025-08-30,Bruce Fleming,Calumet,2,7,0,9,
2025-08-30,Daniel S. Peyovich,Dycom Industries,1,5,0,6,
2025-08-30,Avner M Applbaum,Valmont Industries,0,8,2,10,
2025-08-30,Kimberly A Fields,ATI inc,5,11,0,16,
2025-08-30,Khozema Z Shipchandler,Twilio,0,2,0,2,
2025-08-30,Gary C Bhojwani,CNO Financial Group,1,7,1,9,
2025-08-30,William Andrew Hendricks Jr,Patterson-UTI Energy,0,0,0,0,
2025-08-30,Kevin D Hochman,Brinker International,1,4,1,6,
2025-08-30,James C Foster,Charles River Laboratories International,2,9,1,12,
2025-08-30,Rajiv K Prasad,Hyster-Yale,2,5,0,7,
2025-08-30,Eric T Steigerwalt,Brighthouse Financial,1,4,0,5,
2025-08-30,Thomas L Ryan,Service Corp International,5,5,0,10,
2025-08-30,Charles M Nifong Jr,CrossAmerica Partners,0,0,0,0,
2025-08-30,Anirudh Devgan,Cadence,10,26,2,38,
2025-08-30,Andi Owen,MillerKnoll,15,16,9,40,
2025-08-30,Sumit Roy,Realty Income,13,19,2,34,
2025-08-30,Timothy John Fitzgerald,Middleby,0,0,0,0,
2025-08-30,Robert H Schottenstein,M/I Homes,3,11,0,14,
2025-08-30,Stephen P MacMillan,Hologic,1,7,0,8,
2025-08-30,Lisa M Barton,Alliant Energy,6,0,0,6,
2025-08-30,Aaron P Jagdfeld,Generac,1,5,1,7,
2025-08-30,Erik Gershwind,MSC Industrial Direct,1,6,2,9,
2025-08-30,Varun Krishna,Rocket Companies,7,31,2,40,
2025-08-30,Fahmi Karam,Upbound Group,5,4,0,9,
2025-08-30,NADominic Ng,East West Bancorp,0,0,0,0,
2025-08-30,Mark Wang,Hilton Grand Vacations,38,2,0,40,
2025-08-30,Robert J Sheedy Jr,Grocery Outlet Holding,0,0,0,0,
2025-08-30,Simon D Campion,Dentsply Sirona,0,3,0,3,
2025-08-30,Jeremy Wensinger,V2X,7,9,0,16,
2025-08-30,Andrew Rees,Crocs,16,17,7,40,
2025-08-30,David M Maura,Spectrum Brands,5,0,0,5,
2025-08-30,Sachin S Lawande,Visteon,0,1,0,1,
2025-08-30,Neil M Ashe,Acuity Inc,0,2,0,2,
2025-08-30,Lorie L Tekorius,Greenbrier,1,8,1,10,
2025-08-30,John R Ciulla,Webster Financial,5,5,0,10,
2025-08-30,Sean D Keohane,Cabot Corporation,3,5,0,8,
2025-08-30,Drew M Wilkerson,RXO inc,1,0,0,1,
2025-08-30,Daniel E Brown,Chord Energy,1,1,0,2,
2025-08-30,Javier D Ferrer Fernandez,Popular inc,0,0,0,0,
2025-08-30,Olivier Rabiller,Garrett Motion inc,4,9,0,13,
2025-08-30,Ronald N Tutor,Tutor Perini Corporation,1,7,1,9,
2025-08-30,Jeff Liaw,Copart,4,4,2,10,
2025-08-30,Aman Narang,Toast inc,6,4,1,11,
2025-08-30,Joseph M Hogan,Align Technology,2,4,1,7,
2025-08-30,Kevin J Wheeler,A O Smith,0,16,1,17,
2025-08-30,Christopher A Cartwright,TransUnion,2,0,1,3,
2025-08-30,James Kelly,NCR Voyix,2,12,1,15,
2025-08-30,Tom Leighton,Akamai Technologies,12,16,4,32,
2025-08-30,Robert G Painter,Trimble,6,2,0,8,
2025-08-30,Tony Helton,Medical Mutual of Ohio,1,3,1,5,
2025-08-30,Caroline S Grace,AMN Healthcare Services,0,0,0,0,
2025-08-30,Patrick Kaltenbach,Mettler-Toledo International,2,7,0,9,
2025-08-30,Michael L Baur,ScanSource,0,6,0,6,
2025-08-30,Jason Lippert,LCI Industries,4,11,0,15,
2025-08-30,Fredric J Tomczyk,Cboe Global Markets,1,6,0,7,
2025-08-30,Octavio Marquez,Diebold Nixdorf,6,11,1,18,
2025-08-30,Sivasankaran Somasundaram,ChampionX,7,1,0,8,
2025-08-30,Ronald F Clarke,Corpay,1,1,0,2,
2025-08-30,Robert W Pittman,iHeartMedia,4,3,0,7,
2025-08-30,Patrick Zalupski,Dream Finders Homes,24,14,2,40,
2025-08-30,Keith E Smith,Boyd Gaming,1,7,1,9,
2025-08-30,Mehran Assadi,NLV Financial,1,1,0,2,
2025-08-30,Barry R Port,Ensign Group,2,5,1,8,
2025-08-30,Denise A Paulonis,Sally Beauty,1,3,0,4,
2025-08-30,Clifford A Skelton,Conduent,0,0,0,0,
2025-08-30,Jean-Michel Ribieras,Sylvamo,2,7,0,9,
2025-08-30,Douglas F Bauer,Tri Pointe Homes,0,4,0,4,
2025-08-30,Shawn O'Connell,EnerSys,3,5,0,8,
2025-08-30,Bill Meury,Incyte,10,16,0,26,
2025-08-30,Dale Francescon,Century Communities,0,8,3,11,
2025-08-30,Michael Nierenberg,Rithm Capital,7,25,1,33,
2025-08-30,Michael J Brown,Euronet Worldwide,2,8,0,10,
2025-08-30,Scott Seu,Hawaiian Electric Industries,4,17,3,24,
2025-08-30,Jason D Robins,DraftKings,5,3,0,8,
2025-08-30,Jonathan J Mazelsky,IDEXX Laboratories,1,2,1,4,
2025-08-30,Richard S Swartz,MYR Group,0,2,0,2,
2025-08-30,Stefano Caroti,Deckers Outdoor,2,7,1,10,
2025-08-30,Kevin R Sayer,DexCom,3,4,0,7,
2025-08-30,John T C Lee,MKS Instruments,4,9,1,14,
2025-08-30,Edward B Pitoniak,VICI Properties,1,7,0,8,
2025-08-30,Albert White III,Cooper Cos,0,0,0,0,
2025-08-30,Barry L Biffle,Frontier Airlines,1,6,6,13,
2025-08-30,Robert A Bruggeworth,Qorvo,3,5,0,8,
2025-08-30,Winnie Park,Five Below,10,27,3,40,
2025-08-30,Steven Oakland,TreeHouse Foods,3,12,0,15,
2025-08-30,James S Hagedorn,Scotts Miracle-Gro,1,1,0,2,
2025-08-30,Michael Cannon-Brookes,Atlassian,19,19,2,40,
2025-08-30,Bertrand Loy,Entegris,3,11,1,15,
2025-08-30,William E Waltz,Atkore,2,6,0,8,
2025-08-30,Celeste B Mastin,H B Fuller,1,4,0,5,
2025-08-30,Kyle T Larkin,Granite Construction,1,7,0,8,
2025-08-30,Michael J Happe,Winnebago Industries,1,4,0,5,
2025-08-30,Steven H Gunby,FTI Consulting,4,12,0,16,
2025-08-30,Stephan B Tanda,AptarGroup,1,3,3,7,
2025-08-30,Timothy P Boyle,Columbia Sportswear,3,3,2,8,
2025-08-30,Anthony J Wood,Roku,5,2,1,8,
2025-08-30,M Christopher Doyle,Civitas Resources,1,2,0,3,
2025-08-30,Andy Eidson,Alpha Metallurgical Resources,1,7,2,10,
2025-08-30,Andy L Nemeth,Patrick Industries,3,2,0,5,
2025-08-30,Roger W Jenkins,Murphy Oil,4,14,0,18,
2025-08-30,Kevin S Blair,Synovus Financial,6,4,0,10,
2025-08-30,Julie Felss Masino,Cracker Barrel Old Country Store,6,19,15,40,
2025-08-30,David M Overton,Cheesecake Factory,1,9,0,10,
2025-08-30,Nick DeIuliis,CNX Resources,11,3,2,16,
2025-08-30,Christopher Pappas,Chefs Warehouse,3,9,1,13,
2025-08-30,Tod Carpenter,Donaldson Company,2,8,0,10,
2025-08-30,Gregory L Christopher,Mueller Industries,1,6,0,7,
2025-08-30,Rob Saltiel,MRC Global,6,13,2,21,
2025-08-30,Jillian C Evanko,Chart Industries,3,6,0,9,
2025-08-30,Dave Guilmette,Alight Solutions,3,7,0,10,
2025-08-30,Joel Smejkal,Vishay Intertechnology,5,4,1,10,
2025-08-30,Dennis Degner,Range Resources,4,6,0,10,
2025-08-30,Ira D Robbins,Valley National Bancorp,1,3,0,4,
2025-08-30,Bernard Kim,Match Group,15,18,7,40,
2025-08-30,Vincent Pilette,Gen Digital,3,13,1,17,
2025-08-30,Timothy S Crane,Wintrust Financial,2,7,0,9,
2025-08-30,Pat Roche,Moog inc,3,10,1,14,
2025-08-30,Mark R Widmar,First Solar,3,6,2,11,
2025-08-30,Niko Lahanas,Central Garden & Pet,1,11,0,12,
2025-08-30,Chris Osowski,Green Plains inc,8,14,1,23,
2025-08-30,Derek J Leathers,Werner Enterprises,1,8,1,10,
2025-08-30,Adam Foroughi,AppLovin,11,25,4,40,
2025-08-30,Luca Savi,ITT,3,6,0,9,
2025-08-30,Lawrence H Silber,Herc Rentals,0,0,0,0,
2025-08-30,Hilton H Howell Jr,Gray Television,7,20,1,28,
2025-08-30,Eric D Ashleman,IDEX,0,8,1,9,
2025-08-30,Owen D Thomas,Boston Properties,2,8,0,10,
2025-08-30,Kurt Wolf,Pitney Bowes,6,19,2,27,
2025-08-30,Sara E Armbruster,Steelcase,1,0,0,1,
2025-08-30,Charles D. Young,Sun Communities,2,5,0,7,
2025-08-30,Suzanne Foster,AdaptHealth,4,8,1,13,
2025-08-30,Grant E Sims,Genesis Energy,5,3,0,8,
2025-08-30,Laura Prieskorn,Jackson Financial,3,4,2,9,
2025-08-30,Rick L Wessel,FirstCash,2,6,1,9,
2025-08-30,Sherman Miller,Cal-Maine Foods,11,28,1,40,
2025-08-30,Paul A Lang,Arch Resources,4,3,1,8,
2025-08-30,Ashish K Khandpur,Avient,2,6,0,8,
2025-08-30,Shyam K Reddy,BlueLinx,1,7,0,8,
2025-08-30,Christopher S Ripley,Sinclair,1,7,0,8,
2025-08-30,Stacy Kymes,BOK Financial,8,5,0,13,
2025-08-30,James H Walter,Permian Resources,1,1,0,2,
2025-08-30,Jason Murray,PACS Group,4,13,3,20,
2025-08-30,Brian Armstrong,Coinbase Global,13,20,7,40,
2025-08-30,Oscar K Brown,Western Midstream Partners,1,3,0,4,
2025-08-30,Nicholas R Lower,Federated Mutual Insurance,0,0,0,0,
2025-08-30,Morris Goldfarb,G-III Apparel Group,11,24,5,40,
2025-08-30,Mark D Morelli,Vontier,0,4,0,4,
2025-08-30,Matthew J Cox,Matson inc,0,5,0,5,
2025-08-30,David W Grzebinski,Kirby Corporation,1,3,0,4,
2025-08-30,Keith A Harvey,Kaiser Aluminum,2,4,2,8,
2025-08-30,Eric Nyman,Vista Outdoor,4,10,1,15,
2025-08-30,Doug Howe,Designer Brands,4,18,0,22,
2025-08-30,Jerry E Gahlhoff Jr,Rollins inc,0,2,0,2,
2025-08-30,D Scott Barbour,Advanced Drainage Systems,3,3,0,6,
2025-08-30,Sean Gamble,Cinemark,17,22,1,40,
2025-08-30,George Kurtz,CrowdStrike,17,21,2,40,
2025-08-30,Bill Ready,Pinterest,26,14,0,40,
2025-08-30,Fidji Simo,Instacart,11,28,1,40,
2025-08-30,Kimberly K Ryan,Hillenbrand,3,5,0,8,
2025-08-30,David S Graziosi,Allison Transmission,2,16,2,20,
2025-08-30,Gary G Friedman,Restoration Hardware,2,4,0,6,
2025-08-30,Lucinda M Baier,Brookdale Senior Living,4,3,0,7,
2025-08-30,Brian J Blaser,QuidelOrtho,1,9,0,10,
2025-08-30,E Jean Savage,Trinity Industries,1,8,1,10,
2025-08-30,Liam J Kelly,Teleflex,1,4,1,6,
2025-08-30,Laurans A Mendelson,HEICO,8,21,2,31,
2025-08-30,Frank H Laukien,Bruker,1,10,0,11,
2025-08-30,Harvey M Schwartz,Carlyle Group,7,13,0,20,
2025-08-30,Mark S LaVigne,Energizer,2,0,0,2,
2025-08-30,Joel Quadracci,Quad/Graphics,9,23,5,37,
2025-08-30,Amar Maletira,Rackspace Technology,4,9,3,16,
2025-08-30,Udit Batra,Waters Corporation,12,23,1,36,
2025-08-30,Eric M Green,West Pharmaceutical Services,0,9,0,9,
2025-08-30,Doug Palladini,Carters inc,2,2,2,6,
2025-08-30,G Mike Mikan,NeueHealth,3,2,0,5,
2025-08-30,Russell ChipChilds,SkyWest,0,0,0,0,
2025-08-30,Christopher H Hunter,Acadia Healthcare,0,1,0,1,
2025-08-30,Prahlad Singh,Revvity,1,7,0,8,
2025-08-30,Maria M Pope,Portland General Electric,1,3,0,4,
2025-08-30,Charles Chip Blankenship,Woodward inc,0,2,0,2,
2025-08-30,Mike Steib,TEGNA,15,18,2,35,
2025-08-30,Kurt J Ekert,Sabre Corporation,0,1,0,1,
2025-08-30,Matt Wilson,Light & Wonder,16,21,3,40,
2025-08-30,Rob Katz,Vail Resorts,2,15,23,40,
2025-08-30,Schnitzer Steel Industries,Radius Recycling,8,25,5,38,
2025-08-30,David A Spector,PennyMac Financial Services,3,0,0,3,
2025-08-30,Frederick J Holzgrefe III,Saia inc,1,1,0,2,
2025-08-30,Mark J Parrell,Equity Residential,3,7,0,10,
2025-08-30,John W Lindsay,Helmerich & Payne,1,5,0,6,
2025-08-30,Gary D Burnison,Korn Ferry,3,13,0,16,
2025-08-30,Timothy J McGrath,PC Connection Inc,2,3,0,5,
2025-08-30,Lynn M Bamford,Curtiss-Wright,11,5,0,16,
2025-08-30,Jonathan W Witter,Sallie Mae,0,0,0,0,
2025-08-30,Jeff Benck,Benchmark Electronics,1,6,0,7,
2025-08-30,Charles H Giancarlo,Pure Storage,1,3,0,4,
2025-08-30,Brian R Gray,Knife River Corporation,0,2,0,2,
2025-08-30,Jay Schmidt,Caleres inc,4,4,2,10,
2025-08-30,Dale Asplund,BrightView Holdings,1,5,0,6,
2025-08-30,Jeffrey S Edwards,Cooper-Standard,0,6,0,6,
2025-08-30,Glenn J Williams,Primerica,6,2,2,10,
2025-08-30,Francois Locoh-Donou,F5,5,20,3,28,
2025-08-30,Joseph Wm Foran,Matador Resources,7,9,0,16,
2025-08-30,Sridhar Ramaswamy,Snowflake inc,13,24,3,40,
2025-08-30,Mark D Dankberg,Viasat,2,5,2,9,
2025-08-30,Francisco J Leon,California Resources,1,3,1,5,
2025-08-30,Peter Stern,Peloton,18,18,4,40,
2025-08-30,David Baszucki,Roblox,10,19,11,40,
2025-08-30,Jeffrey W Edwards,Installed Building Products,2,3,0,5,
2025-08-30,Clark Lauritzen,First National of Nebraska,1,7,0,8,
2025-08-30,Carlos Alberini,Guess inc,12,27,1,40,
2025-08-30,Shyam P Kambeyanda,ESAB,4,3,0,7,
2025-08-30,Edmund Shallcross III,Amica Mutual Insurance,1,5,0,6,
2025-08-30,Benjamin W Schall,AvalonBay Communities,1,7,1,9,
2025-08-30,Allan C Thygesen,DocuSign,3,7,0,10,
2025-08-30,Bryan J Knutson,Titan Machinery,2,1,2,5,
2025-08-30,Heath Sampson,ModivCare,6,2,1,9,
2025-08-30,Ara K Hovnanian,Hovnanian Enterprises,1,19,2,22,
2025-08-30,Joshua G Silverman,Etsy,2,4,0,6,
2025-08-30,Kevin Roycraft,Adams Resources & Energy,7,2,1,10,
2025-08-30,J Eric Evans,Surgery Partners,0,3,0,3,
2025-08-30,Clint E Stein,Columbia Banking System,1,6,0,7,
2025-08-30,Lee M Shavel,Verisk Analytics,3,6,0,9,
2025-08-30,Dave Banyard Jr,MasterBrand,0,0,0,0,
2025-08-30,Peter R Ingram,Hawaiian Airlines inc,1,1,0,2,
2025-08-30,Kristin A Dolan,AMC Networks,3,2,0,5,
2025-08-30,Brendan T Cavanagh,SBA Communications,1,2,0,3,
2025-08-30,George F Chappelle Jr,Americold Realty Trust,1,3,0,4,
2025-08-30,Thomas E Gottwald,NewMarket Corporation,3,7,0,10,
2025-08-30,Thomas J Baltimore Jr,Park Hotels & Resorts,3,25,0,28,
2025-08-30,Peter M Moglia,Alexandria Real Estate Equities,4,5,0,9,
2025-08-30,Ronald J Kramer,Griffon Corporation,2,5,0,7,
2025-08-30,John L Plueger,Air Lease,2,12,0,14,
2025-08-30,Jennifer F Scanlon,UL Solutions,1,6,0,7,
2025-08-30,Greg Smith,Teradyne,2,9,2,13,
2025-08-30,Sean Trauschke,OGE Energy,17,5,0,22,
2025-08-30,Norman D Schwartz,Bio-Rad Laboratories,1,0,1,2,
2025-08-30,Scott Doyle,Spire inc,4,5,1,10,
2025-08-30,Michael E Reed,Gannett,0,4,1,5,
2025-08-30,Cindy J Miller,Stericycle,2,5,1,8,
2025-08-30,Phillip D Green,Cullen Frost Bankers,1,4,2,7,
2025-08-30,Joseph D Margolis,Extra Space Storage,0,9,1,10,
2025-08-30,Mark A Skonieczny,REV Group,6,4,0,10,
2025-08-30,Ladd Wilks,ProFrac Holding,4,3,1,8,
2025-08-30,Sundaram Nagarajan,Nordson,0,11,1,12,
2025-08-30,Anne P Noonan,Summit Materials,0,1,0,1,
2025-08-30,Lori Flees,Valvoline inc,4,4,2,10,
2025-08-30,Scott H Baxter,Kontoor Brands,3,2,0,5,
2025-08-30,Tim Larson,Skyline Champion,7,0,0,7,
2025-08-30,Chuck Divita,Teladoc Health,9,17,4,30,
2025-08-30,W Bradley Southern,Louisiana-Pacific Corporation,0,0,0,0,
2025-08-30,George C Freeman III,Universal Corporation,4,6,0,10,
2025-08-30,James A Brock,Consol Energy,2,0,0,2,
2025-08-30,Robert Antokol,Playtika Holding,2,6,1,9,
2025-08-30,Joe Craft,Alliance Resource Partners,6,10,2,18,
2025-08-30,Paul Keel,Envista,2,7,1,10,
2025-08-30,Jared Isaacman,Shift4 Payments,7,28,5,40,
2025-08-30,Mark Mac McFarland,Talen Energy,4,1,1,6,
2025-08-30,Tony R Thene,Carpenter Technology,3,8,0,11,
2025-08-30,Melissa D Smith,WEX,3,6,0,9,
2025-08-30,James Jim C Ryan III,Old National Bancorp,1,0,0,1,
2025-08-30,Peter J Federico,AGNC Investment,2,0,0,2,
2025-08-30,Brent L Yeagy,Wabash National,0,1,0,1,
2025-08-30,Henry A Fernandez,MSCI,4,14,0,18,
2025-08-30,Mark Penn,Stagwell,12,25,2,39,
2025-08-30,Julie Schertell,Mativ,2,8,0,10,
2025-08-30,Ashish Chand,Belden,3,6,1,10,
2025-08-30,Greg Anderson,Allegiant Travel Company,4,7,0,11,
2025-08-30,Drew Houston,Dropbox,13,20,7,40,
2025-08-30,Kevin T Conroy,Exact Sciences,2,5,2,9,
2025-08-30,Rex D Geveden,BWX Technologies,3,7,0,10,
2025-08-30,Scott R Wells,Clear Channel Outdoor Hldgs,0,0,0,0,
2025-08-30,Paul Bay,Ingram Micro,11,26,3,40,
2025-08-31,Doug McMillon,Walmart,15,20,5,40,
2025-08-31,Andrew Jassy,Amazon,4,30,6,40,
2025-08-31,Tim Cook,Apple,16,19,5,40,
2025-08-31,Stephen Hemsley,UnitedHealth,8,27,5,40,
2025-08-31,Warren Buffett,Berkshire Hathaway,13,22,5,40,
2025-08-31,David Joyner,CVS Health,8,27,5,40,
2025-08-31,Darren Woods,Exxon Mobil,10,23,6,39,
2025-08-31,Sundar Pichai,Alphabet,16,19,5,40,
2025-08-31,Brian Tyler,McKesson,4,16,5,25,
2025-08-31,Robert Mauch,Cencora,3,7,0,10,
2025-08-31,Ron Vachris,Costco,6,32,2,40,
2025-08-31,Jamie Dimon,JPMorgan Chase,11,16,13,40,
2025-08-31,Satya Nadella,Microsoft,14,16,10,40,
2025-08-31,Jason Hollar,Cardinal Health,14,21,5,40,
2025-08-31,Mike Wirth,Chevron,18,17,5,40,
2025-08-31,David Cordani,Cigna,22,14,4,40,
2025-08-31,Jim Farley,Ford Motor,12,22,6,40,
2025-08-31,Brian Moynihan,Bank of America,5,29,6,40,
2025-08-31,Mary Barra,General Motors,14,22,4,40,
2025-08-31,Gail Boudreaux,Elevance Health,15,18,7,40,
2025-08-31,Jane Fraser,Citigroup,14,22,4,40,
2025-08-31,Sarah London,Centene,13,18,9,40,
2025-08-31,Ted Decker,Home Depot,10,24,6,40,
2025-08-31,Maryann Mannen,Marathon Petroleum,5,12,1,18,
2025-08-31,Ron Sargent,Kroger,5,22,13,40,
2025-08-31,Mark Lashier,Phillips 66,11,20,7,38,
2025-08-31,Priscilla Almodovar,Fannie Mae,11,17,12,40,
2025-08-31,Tim Wentworth,Walgreens,7,24,9,40,
2025-08-31,Lane Riggs,Valero Energy,14,8,0,22,
2025-08-31,Mark Zuckerberg,Meta,10,19,11,40,
2025-08-31,Hans Vestberg,Verizon,14,21,5,40,
2025-08-31,John Stankey,AT&T,13,24,3,40,
2025-08-31,Brian Roberts,Comcast,9,29,2,40,
2025-08-31,Charles Scharf,Wells Fargo,28,6,6,40,
2025-08-31,David Solomon,Goldman Sachs,7,23,10,40,
2025-08-31,Michael Hutchins,Freddie Mac,2,10,3,15,
2025-08-31,Michael Fiddelke,Target,9,22,9,40,
2025-08-31,Jim Rechtin,Humana,18,17,5,40,
2025-08-31,Jon Farney,State Farm Insurance,1,13,3,17,
2025-08-31,Elon Musk,Tesla,10,12,18,40,
2025-08-31,Ted Pick,Morgan Stanley,16,22,2,40,
2025-08-31,Joaquin Duato,Johnson & Johnson,11,25,4,40,
2025-08-31,Juan Luciano,Archer Daniels Midland,3,20,14,37,
2025-08-31,Ramon Laguarta,PepsiCo,6,29,5,40,
2025-08-31,Carol Tom√©,UPS,8,21,11,40,
2025-08-31,Rajesh Subramaniam,FedEx,8,29,0,37,
2025-08-31,Bob Iger,Walt Disney,8,30,2,40,
2025-08-31,Michael Dell,Dell Technologies,11,24,5,40,
2025-08-31,Marvin Ellison,Lowes,14,24,2,40,
2025-08-31,Jon Moeller,Procter & Gamble,7,27,6,40,
2025-08-31,Thomas Long,Energy Transfer,8,0,2,10,
2025-08-31,Kelly Ortberg,Boeing,11,26,3,40,
2025-08-31,Susan Morris,Albertsons,12,25,3,40,
2025-08-31,Kevin Hourican,Sysco,9,28,3,40,
2025-08-31,Christopher Calio,RTX,7,12,0,19,
2025-08-31,Larry Culp,General Electric,11,26,3,40,
2025-08-31,James Taiclet,Lockheed Martin,13,18,9,40,
2025-08-31,Stephen Squeri,American Express,15,23,2,40,
2025-08-31,Joe Creed,Caterpillar,11,26,3,40,
2025-08-31,Michel Khalaf,MetLife,12,17,1,30,
2025-08-31,Samuel Hazen,HCA Healthcare,8,7,0,15,
2025-08-31,Tricia Griffith,Progressive Insurance,10,26,4,40,
2025-08-31,Arvind Krishna,IBM,12,22,6,40,
2025-08-31,John May,Deere,9,26,5,40,
2025-08-31,Jensen Huang,Nvidia,10,27,3,40,
2025-08-31,Philip Smith,StoneX,0,8,1,9,
2025-08-31,Robert M Davis,Merck,4,19,0,23,
2025-08-31,Ryan Lance,ConocoPhillips,16,21,3,40,
2025-08-31,Albert Bourla,Pfizer,16,14,10,40,
2025-08-31,Ed Bastian,Delta Air Lines,11,20,9,40,
2025-08-31,Patrick Zammit,TD Synnex,9,14,0,23,
2025-08-31,Kevin Murphy,Publix Super Markets,10,22,1,33,
2025-08-31,Thomas J Wilson,Allstate,0,9,1,10,
2025-08-31,Chuck Robbins,Cisco Systems,16,21,2,39,
2025-08-31,Kirt Walker,Nationwide,15,17,2,34,
2025-08-31,Christopher Winfrey,Charter Communications,5,16,5,26,
2025-08-31,Bob Michael,AbbVie,0,0,0,0,
2025-08-31,Craig DeSanto,New York Life Insurance,3,17,0,20,
2025-08-31,Lip-Bu Tan,Intel,9,15,16,40,
2025-08-31,Ernie Herrman,TJX,14,24,2,40,
2025-08-31,Andrew Sullivan,Prudential Financial,11,19,0,30,
2025-08-31,Enrique Lores,Hewlett Packard,12,15,7,34,
2025-08-31,Scott Kirby,United Airlines,34,3,3,40,
2025-08-31,George Holm,Performance Food,11,22,2,35,
2025-08-31,Donnie King,Tyson Foods,10,24,6,40,
2025-08-31,Robert Isom,American Airlines,7,27,6,40,
2025-08-31,Timothy M Sweeney,Liberty Mutual Insurance,13,0,0,13,
2025-08-31,Elliott Hill,Nike,10,26,4,40,
2025-08-31,Safra Catz,Oracle,10,23,7,40,
2025-08-31,AJ Jim Teague,Enterprise Products Partners,4,7,0,11,
2025-08-31,Richard Fairbank,Capital One,15,22,3,40,
2025-08-31,Wilfred Chiang,Plains GP,0,1,0,1,
2025-08-31,Michael Kasbar,World Kinect,1,10,0,11,
2025-08-31,Peter Zaffino,American International Group,9,27,4,40,
2025-08-31,James Quincey,The Coca-Cola Company,8,29,3,40,
2025-08-31,Thasunda Brown Duckett,TIAA,21,19,0,40,
2025-08-31,Jay Debertin,CHS,3,9,3,15,
2025-08-31,Chris Boerner,Bristol-Myers Squibb,10,23,7,40,
2025-08-31,Corie Barry,Best Buy,39,1,0,40,
2025-08-31,Marc Casper,Thermo Fisher Scientific,14,23,3,40,
2025-08-31,Roger Crandall,Mass Mutual,3,7,0,10,
2025-08-31,Juan Andrade,USAA,5,16,0,21,
2025-08-31,Phebe Novakovic,General Dynamics,28,9,3,40,
2025-08-31,Alan Schnitzer,Travelers Insurance,3,5,2,10,
2025-08-31,David Zaslav,Warner Bros Discovery,5,22,12,39,
2025-08-31,Gunjan Kedia,US Bancorp,12,26,2,40,
2025-08-31,Robert Ford,Abbott Laboratories,10,24,6,40,
2025-08-31,Kathy Warden,Northrop Grumman,15,20,5,40,
2025-08-31,Tim Gerend,Northwestern Mutual,14,25,1,40,
2025-08-31,Todd Vasos,Dollar General,8,25,6,39,
2025-08-31,Matthew Lucey,PBF Energy,7,3,0,10,
2025-08-31,Dara Khosrowshahi,Uber,11,22,7,40,
2025-08-31,Vimal Kapur,Honeywell,11,29,0,40,
2025-08-31,Dirk Van de Put,Mondelez,10,26,4,40,
2025-08-31,Brian Niccol,Starbucks,11,29,0,40,
2025-08-31,Cristiano Amon,Qualcomm,12,27,1,40,
2025-08-31,Hock Tan,Broadcom,10,27,3,40,
2025-08-31,David Flitman,US Foods,2,7,0,9,
2025-08-31,Paul Romanowski,DR Horton,5,16,4,25,
2025-08-31,Jacek Olczak,Philip Morris,13,23,4,40,
2025-08-31,Preston Feight,Paccar,9,28,2,39,
2025-08-31,Marc Benioff,Salesforce,9,22,9,40,
2025-08-31,Leon Topalian,Nucor,15,23,2,40,
2025-08-31,Michael Dastoor,Jabil,1,8,0,9,
2025-08-31,Jonathan Jaffe,Lennar,1,8,1,10,
2025-08-31,David Ricks,Eli Lilly,11,21,8,40,
2025-08-31,Joe Zubretsky,Molina Healthcare,8,6,4,18,
2025-08-31,Jennifer Rumsey,Cummins,8,26,6,40,
2025-08-31,Robin Vince,Bank of New York Mellon,20,18,2,40,
2025-08-31,Ted Sarandos,Netflix,13,24,3,40,
2025-08-31,William H Rogers Jr,Truist Financial,2,7,1,10,
2025-08-31,Sean Kerins,Arrow Electronics,2,12,0,14,
2025-08-31,William M Brown,3M,2,8,0,10,
2025-08-31,Ryan McInerney,Visa,15,20,5,40,
2025-08-31,Marc Rowan,Apollo Global Management,19,17,4,40,
2025-08-31,Tim Go,HF Sinclair,6,3,0,9,
2025-08-31,Robert Sulentic,CBRE Group,1,7,1,9,
2025-08-31,William Demchak,PNC Financial Services,14,22,4,40,
2025-08-31,Bryan DeBoer,Lithia Motors,11,27,1,39,
2025-08-31,William Nash,CarMax,4,3,2,9,
2025-08-31,Brian Robbins,Paramount Global,7,31,0,38,
2025-08-31,Michael Creedon,Dollar Tree,3,34,3,40,
2025-08-31,Sandy Douglas,United Natural Foods,33,5,2,40,
2025-08-31,Alex Chriss,PayPal,12,25,3,40,
2025-08-31,Roger Penske,Penske Automotive,19,20,1,40,
2025-08-31,Antonio Neri,Hewlett Packard Enterprise,8,24,8,40,
2025-08-31,Harry Sideris,Duke Energy,37,3,0,40,
2025-08-31,Vicki Hollub,Occidental Petroleum,21,14,4,39,
2025-08-31,Lawrence Coben,NRG Energy,5,2,0,7,
2025-08-31,Robert Bradway,Amgen,9,28,3,40,
2025-08-31,John Ketchum,NextEra Energy,23,17,0,40,
2025-08-31,Rainer Blair,Danaher,6,15,2,23,
2025-08-31,Daniel O'Day,Gilead Sciences,20,16,4,40,
2025-08-31,Michael Manley,AutoNation,2,6,2,10,
2025-08-31,Carlos Abrams-Rivera,Kraft Heinz,15,18,7,40,
2025-08-31,Philip Gallagher,Avnet,1,6,1,8,
2025-08-31,Gary Dickerson,Applied Materials,8,21,11,40,
2025-08-31,Bob Jordan,Southwest Airlines,10,23,6,39,
2025-08-31,Rick Wurster,Charles Schwab,14,21,4,39,
2025-08-31,Lorenzo Simonelli,Baker Hughes,16,20,4,40,
2025-08-31,Chris Kempczinski,McDonalds,10,23,7,40,
2025-08-31,Christopher Womack,Southern Company,4,6,0,10,
2025-08-31,Michael Miebach,Mastercard,11,26,3,40,
2025-08-31,Joseph Dominguez,Constellation Energy,12,11,1,24,
2025-08-31,Christopher Swift,The Hartford,14,22,4,40,
2025-08-31,Patricia Poppe,PG&E,8,16,2,26,
2025-08-31,Bom Kim,Coupang,12,27,1,40,
2025-08-31,Ezra Yacob,EOG Resources,21,13,3,37,
2025-08-31,Jim Vena,Union Pacific,19,21,0,40,
2025-08-31,Matt Schroeder,Rite Aid,4,33,3,40,
2025-08-31,Tony Spring,Macys,10,27,3,40,
2025-08-31,Anthony Capuano,Marriott International,14,24,2,40,
2025-08-31,Raymond E Scott,Lear Corporation,4,5,1,10,
2025-08-31,William Stengel II,Genuine Parts,0,3,0,3,
2025-08-31,Heidi Petz,Sherwin-Williams,8,28,3,39,
2025-08-31,Jeff Miller,Halliburton,11,23,6,40,
2025-08-31,Kathleen Quirk,Freeport-McMoRan,14,17,2,33,
2025-08-31,Michael Rapino,Live Nation Entertainment,13,24,3,40,
2025-08-31,John Doyle,Marsh & McLennan,9,9,0,18,
2025-08-31,Lisa Su,Advanced Micro Devices,16,20,4,40,
2025-08-31,Frank Holding,First Citizens BancShares,8,15,2,25,
2025-08-31,John Engel,WESCO International,5,11,1,17,
2025-08-31,David Gitlin,Carrier Global,14,24,2,40,
2025-08-31,Lourenco Goncalves,Cleveland-Cliffs,7,22,11,40,
2025-08-31,Calvin G Butler Jr,Exelon,5,4,0,9,
2025-08-31,Joseph Bae,KKR,19,19,2,40,
2025-08-31,Christine Leahy,CDW,0,12,2,14,
2025-08-31,Glenn Fogel,Booking Holdings,10,24,6,40,
2025-08-31,Brian Doubles,Synchrony Financial,5,7,2,14,
2025-08-31,Earl Austin,Quanta Services,2,6,2,10,
2025-08-31,Christian Ulbrich,Jones Lang LaSalle,8,20,0,28,
2025-08-31,Saumya Sutaria,Tenet Healthcare,5,3,1,9,
2025-08-31,William Gifford,Altria,3,4,2,9,
2025-08-31,Kevin Lobo,Stryker,11,25,4,40,
2025-08-31,Michael Hsu,Kimberly-Clark,6,6,1,13,
2025-08-31,Jack Fusco,Cheniere Energy,18,19,3,40,
2025-08-31,James Conroy,Ross Stores,4,11,0,15,
2025-08-31,Anthony Smurfit,Smurfit Westrock,2,7,0,9,
2025-08-31,Jeffrey Harmening,General Mills,4,18,4,26,
2025-08-31,Mark Stewart,Goodyear Tire & Rubber,5,34,1,40,
2025-08-31,Bob Eddy,BJs Wholesale Club,4,23,3,30,
2025-08-31,Peter Arduini,GE HealthCare Technologies,6,12,0,18,
2025-08-31,Noel Wallace,Colgate-Palmolive,10,22,2,34,
2025-08-31,Marc Bitzer,Whirlpool,12,12,16,40,
2025-08-31,Chris Kubasik,L3Harris Technologies,8,13,1,22,
2025-08-31,Shantanu Narayen,Adobe,20,19,1,40,
2025-08-31,Thomas Polen,Becton Dickinson,7,3,0,10,
2025-08-31,Richard P Dealy,Pioneer Natural Resources,4,2,0,6,
2025-08-31,Ravi Kumar S,Cognizant Technology Solutions,10,24,3,37,
2025-08-31,Andrew Clyde,Murphy USA,13,25,2,40,
2025-08-31,Mike Lyons,Fiserv,4,11,1,16,
2025-08-31,Jennifer Parmentier,Parker-Hannifin,2,10,0,12,
2025-08-31,William Fehrman,American Electric Power,4,6,0,10,
2025-08-31,Andrew Silvernail,International Paper,6,21,1,28,
2025-08-31,Jonas Prising,ManpowerGroup,7,21,2,30,
2025-08-31,John Zillmer,Aramark,6,14,2,22,
2025-08-31,Mark Millett,Steel Dynamics,19,2,0,21,
2025-08-31,Dan Amos,Aflac,14,19,7,40,
2025-08-31,Tony Cheng,Reinsurance Group of America,2,11,2,15,
2025-08-31,Karsanbhai,Emerson Electric,9,15,3,27,
2025-08-31,Ronald P O'Hanley,State Street,5,12,0,17,
2025-08-31,Timothy Knavish,PPG Industries,1,4,1,6,
2025-08-31,David Burritt,United States Steel,7,20,12,39,
2025-08-31,Maria Black,Automatic Data Processing,3,6,0,9,
2025-08-31,Daryl Kenningham,Group 1 Automotive,9,29,2,40,
2025-08-31,Robert Blue,Dominion Energy,29,10,1,40,
2025-08-31,Larry Fink,BlackRock,6,27,7,40,
2025-08-31,Pierce Norton II,Oneok,5,5,0,10,
2025-08-31,David Bozeman,CH Robinson Worldwide,2,7,0,9,
2025-08-31,Haviv Ilan,Texas Instruments,13,24,3,40,
2025-08-31,Michael Bender,Kohls,1,26,13,40,
2025-08-31,Philip Daniele III,AutoZone,0,2,0,2,
2025-08-31,Timothy Archer,Lam Research,3,7,0,10,
2025-08-31,Charles Magro,Corteva,5,2,1,8,
2025-08-31,Rick Lanoha,Peter Kiewit Sons',0,2,0,2,
2025-08-31,Peter Jackson,Builders FirstSource,5,11,1,17,
2025-08-31,Martin Schroeter,Kyndryl,11,27,0,38,
2025-08-31,Hamid Akhavan,EchoStar,4,25,8,37,
2025-08-31,Bill Westrate,American Family Insurance,9,16,2,27,
2025-08-31,Avigal Soreq,Delek US,4,8,5,17,
2025-08-31,Beth Ford,Land O'Lakes,17,22,1,40,
2025-08-31,Walker Martin,Sempra,0,3,0,3,
2025-08-31,Eric Slifka,Global Partners,13,21,6,40,
2025-08-31,DG Macpherson,WW Grainger,2,7,1,10,
2025-08-31,Bob Pragada,Jacobs Solutions,6,8,0,14,
2025-08-31,Pedro Pizarro,Edison International,15,8,17,40,
2025-08-31,William Hornbuckle,MGM Resorts International,6,23,1,30,
2025-08-31,Andrew McMahon,Guardian Life insurance,6,13,0,19,
2025-08-31,Christopher O'Herlihy,Illinois Tool Works,4,4,2,10,
2025-08-31,James Cracchiolo,Ameriprise Financial,2,22,2,26,
2025-08-31,Ryan Marshall,PulteGroup,11,14,10,35,
2025-08-31,Matthew Meloy,Targa Resources,6,4,0,10,
2025-08-31,Michael Rhodes,Ally Financial,12,23,5,40,
2025-08-31,Joseph Fadool,BorgWarner,4,11,0,15,
2025-08-31,St√©phane de La Faverie,Est√©e Lauder,9,26,5,40,
2025-08-31,Benjamin Tisch,Loews,2,8,0,10,
2025-08-31,Brad Beckham,O'Reilly Automotive,4,15,1,20,
2025-08-31,Thomas Gayner,Markel Group,2,8,0,10,
2025-08-31,Donald Allan,Stanley Black & Decker,8,31,1,40,
2025-08-31,Sanjay Mehrotra,Micron Technology,16,22,2,40,
2025-08-31,James Breuer,Fluor,0,2,1,3,
2025-08-31,Thomas Bell,Leidos,8,19,2,29,
2025-08-31,Scott Smith,Viatris,5,4,0,9,
2025-08-31,Kimberly Dang,Kinder Morgan,11,1,0,12,
2025-08-31,Christophe Beck,Ecolab,20,20,0,40,
2025-08-31,Brent Shafer,Baxter International,1,9,0,10,
2025-08-31,Clay Gaspar,Devon Energy,19,4,0,23,
2025-08-31,Steven Cahillane,Kellanova,2,7,0,9,
2025-08-31,Raul Nicholas Vargas Ochoa,Farmers Insurance Exchange,0,0,0,0,
2025-08-31,Darren Rebelez,Caseys General Stores,3,6,0,9,
2025-08-31,Ari Bousbib,IQVIA,7,15,1,23,
2025-08-31,Jon Vander Ark,Republic Services,11,18,11,40,
2025-08-31,Timothy Cofer,Keurig Dr Pepper,2,5,1,8,
2025-08-31,Karla Lewis,Reliance Inc,3,7,0,10,
2025-08-31,David Hult,Asbury Automotive Group,6,32,2,40,
2025-08-31,Darryl Button,Pacific Life,1,7,0,8,
2025-08-31,James Burke,Vistra,6,3,1,10,
2025-08-31,John Barrett,Western & Southern Financial,11,27,2,40,
2025-08-31,William Krueger,The Andersons Inc,0,2,0,2,
2025-08-31,Erik Nordstrom,Nordstrom,6,27,6,39,
2025-08-31,John Wren,Omnicom Group,14,20,6,40,
2025-08-31,Stephanie Ferris,Fidelity National Information Services,16,22,2,40,
2025-08-31,Timothy Cawley,Consolidated Edison,4,5,0,9,
2025-08-31,Joseph Hinrichs,CSX,7,11,1,19,
2025-08-31,Troy Rudd,AECOM,8,25,5,38,
2025-08-31,Kathleen Johnson,Lumen Technologies,3,4,1,8,
2025-08-31,Harry Lawton III,Tractor Supply,1,1,0,2,
2025-08-31,Raul Fernandez,DXC Technology,3,34,2,39,
2025-08-31,Eric Hansotia,AGCO,17,22,1,40,
2025-08-31,David Bruton Smith,Sonic Automotive,5,9,9,23,
2025-08-31,Sasan Goodarzi,Intuit,10,26,4,40,
2025-08-31,Matthew Flannery,United Rentals,30,2,0,32,
2025-08-31,Marc Miller,Universal Health Services,4,22,3,29,
2025-08-31,Michael Mahoney,Boston Scientific,13,27,0,40,
2025-08-31,Judith Marks,Otis Worldwide,3,3,0,6,
2025-08-31,Robert Frenzel,Xcel Energy,4,2,2,8,
2025-08-31,Penny Pennington,Edward Jones,9,25,6,40,
2025-08-31,Daniel Fisher,Ball,3,17,5,25,
2025-08-31,Justin Jude,LKQ,4,6,1,11,
2025-08-31,James Blackledge,Mutual of Omaha,1,31,2,34,
2025-08-31,Bruce Bodine,Mosaic,3,8,0,11,
2025-08-31,Scott Donnelly,Textron,7,24,2,33,
2025-08-31,Adam Schechter,Labcorp Holdings,3,7,0,10,
2025-08-31,Deanna Strable-Soethout,Principal Financial,1,6,0,7,
2025-08-31,Leonard Schleifer,Regeneron Pharmaceuticals,6,27,7,40,
2025-08-31,Paul Shoukry,Raymond James Financial,15,24,1,40,
2025-08-31,Lauren Hobart,Dicks Sporting Goods,12,21,4,37,
2025-08-31,Jamie Whisnant,Auto-Owners Insurance,0,2,0,2,
2025-08-31,Ariane Gorin,Expedia,9,30,1,40,
2025-08-31,Shelley Simpson,JB Hunt Transport Services,8,29,3,40,
2025-08-31,Ren√© Jones,M&T Bank,14,24,2,40,
2025-08-31,Gerardo Norcia,DTE Energy,6,3,0,9,
2025-08-31,Andr√©s Gluski,AES,17,21,0,38,
2025-08-31,Timothy Spence,Fifth Third Bancorp,5,5,0,10,
2025-08-31,Eduardo Menezes,Air Products & Chemicals,4,5,1,10,
2025-08-31,Wendell Weeks,Corning,15,23,2,40,
2025-08-31,Anthony Guzzi,EMCOR Group,4,3,1,8,
2025-08-31,Adam Norwitt,Amphenol,3,17,0,20,
2025-08-31,Jean-Marc Gilson,Westlake Corporation,2,4,0,6,
2025-08-31,Lori Koch,DuPont,7,18,0,25,
2025-08-31,Derek Chang,Liberty Media,37,3,0,40,
2025-08-31,Martina Cheung,S&P Global,11,26,0,37,
2025-08-31,Tim Hingtgen,Community Health Systems,10,27,3,40,
2025-08-31,Brian Tierney,FirstEnergy,6,24,3,33,
2025-08-31,Rick McKenney,Unum Group,5,4,0,9,
2025-08-31,Stanley Bergman,Henry Schein,11,28,1,40,
2025-08-31,Tiang Yew Tan,Western Digital,0,0,0,0,
2025-08-31,Vincent Roche,Analog Devices,12,20,3,35,
2025-08-31,Sean Connolly,Conagra Brands,7,31,2,40,
2025-08-31,Bruce Van Saun,Citizens Financial Group,14,26,0,40,
2025-08-31,Mark George,Norfolk Southern,17,20,3,40,
2025-08-31,Andrew Marsh,Entergy,4,4,0,8,
2025-08-31,Robert Berkley,WR Berkley,8,29,3,40,
2025-08-31,Javier Rodriguez,DaVita,14,14,1,29,
2025-08-31,Michael O'Grady,Northern Trust,26,5,1,32,
2025-08-31,James Snee,Hormel Foods,3,26,1,30,
2025-08-31,Timothy J Donahue,Crown Holdings,1,9,0,10,
2025-08-31,Joseph Ferraro,Avis Budget,3,5,2,10,
2025-08-31,Niraj Shah,Wayfair,8,24,8,40,
2025-08-31,Jos√© Mas,MasTec,6,14,1,21,
2025-08-31,Joseph Nolan,Eversource Energy,5,3,1,9,
2025-08-31,Thomas Palmer,Newmont,6,4,0,10,
2025-08-31,Robert Sanchez,Ryder System,10,9,1,20,
2025-08-31,Michael Nolan,Fidelity National Financial,3,0,0,3,
2025-08-31,Gavin Hattersley,Molson Coors Beverage,6,30,4,40,
2025-08-31,Thomas Reeg,Caesars Entertainment,6,5,0,11,
2025-08-31,Ellen Cooper,Lincoln National,3,6,0,9,
2025-08-31,Bracken Darrell,VF Corporation,7,30,3,40,
2025-08-31,Erik Fyrwald,International Flavors & Fragrances,7,7,2,16,
2025-08-31,Christopher Kastner,Huntington Ingalls Industries,3,4,0,7,
2025-08-31,Shane O'Kelly,Advance Auto Parts,13,21,6,40,
2025-08-31,Ralph LaRossa,Public Service Enterprise Group,10,18,0,28,
2025-08-31,Kecia Steelman,Ulta Beauty,32,5,3,40,
2025-08-31,Michele Buck,Hershey,7,31,2,40,
2025-08-31,Sumit Singh,Chewy,12,23,5,40,
2025-08-31,Steven Vondran,American Tower,4,6,0,10,
2025-08-31,Jeffrey Lorberbaum,Mohawk Industries,11,6,1,18,
2025-08-31,Keith Demmings,Assurant,3,7,0,10,
2025-08-31,Robert Martin,Thor Industries,4,5,1,10,
2025-08-31,Kathleen Mazzarella,Graybar Electric,1,7,2,10,
2025-08-31,Joey Wat,Yum China,12,26,2,40,
2025-08-31,Scott Richardson,Celanese,8,27,5,40,
2025-08-31,David Rawlinson II,QVC,7,16,2,25,
2025-08-31,Alan Armstrong,Williams,23,13,4,40,
2025-08-31,Philippe Krakowsky,Interpublic Group,13,25,2,40,
2025-08-31,Brendan McCracken,Ovintiv,5,5,0,10,
2025-08-31,Andrew Teno,Icahn Enterprises,5,6,0,11,
2025-08-31,Stephen Steinour,Huntington Bancshares,2,8,0,10,
2025-08-31,Timothy NeCastro,Erie Insurance,3,6,1,10,
2025-08-31,Ernest Garcia III,Carvana,23,13,4,40,
2025-08-31,R Bruce McDonald,Dana Incorporated,3,8,1,12,
2025-08-31,William Oplinger,Alcoa Corporation,2,7,1,10,
2025-08-31,Mark Pearson,Equitable,8,7,0,15,
2025-08-31,Richard Wallace,KLA,4,5,0,9,
2025-08-31,Ricardo Cardenas,Darden Restaurants,4,2,1,7,
2025-08-31,Mikael Bratt,Autoliv,6,7,2,15,
2025-08-31,Benito Minicucci,Alaska Air,3,4,1,8,
2025-08-31,Christopher Gorman,KeyCorp,5,5,0,10,
2025-08-31,Robert Goldstein,Las Vegas Sands,4,31,5,40,
2025-08-31,Edward Pesicka,Owens & Minor,4,34,2,40,
2025-08-31,Christopher Nassetta,Hilton Worldwide,8,16,2,26,
2025-08-31,Jamie Iannone,Ebay,18,18,4,40,
2025-08-31,Patrick Gallagher,Arthur J Gallagher,8,30,2,40,
2025-08-31,Rich Steinmeier,LPL Financial,24,14,2,40,
2025-08-31,Stephen Spray,Cincinnati Financial,1,6,3,10,
2025-08-31,Douglas Yearley,Toll Brothers,10,24,6,40,
2025-08-31,Gregory Brown,Motorola Solutions,2,8,0,10,
2025-08-31,Brian Chesky,Airbnb,3,30,7,40,
2025-08-31,Jeffrey Sprecher,Intercontinental Exchange,15,23,2,40,
2025-08-31,Robert Thomson,News Corp,7,29,4,40,
2025-08-31,Scott Boatwright,Chipotle Mexican Grill,8,28,4,40,
2025-08-31,Reshma Kewalramani,Vertex Pharmaceuticals,21,14,5,40,
2025-08-31,Christopher Viehbacher,Biogen,0,27,2,29,
2025-08-31,Malcolm Wilson,GXO Logistics,8,20,0,28,
2025-08-31,Tony Sarsam,SpartanNash,18,20,2,40,
2025-08-31,Michael O‚ÄôSullivan,Burlington Stores,6,30,4,40,
2025-08-31,Teresa Rasmussen,Thrivent Financial for Lutherans,4,0,0,4,
2025-08-31,Eugene Bredow,NVR,0,4,0,4,
2025-08-31,Brian Chambers,Owens Corning,3,12,1,16,
2025-08-31,Rafael Santana,Westinghouse Air Brake Technologies,3,6,1,10,
2025-08-31,John Pfeifer,Oshkosh,3,21,4,28,
2025-08-31,Cameron Bready,Global Payments,8,30,2,40,
2025-08-31,Calvin McDonald,Lululemon athletica,8,31,1,40,
2025-08-31,J Kent Masters,Albemarle Corporation,3,7,0,10,
2025-08-31,Joanna Geraghty,JetBlue Airways,14,20,6,40,
2025-08-31,Robert Steer,Seaboard,0,4,0,4,
2025-08-31,William Newlands,Constellation Brands,0,2,2,4,
2025-08-31,Michael Doss,Graphic Packaging,4,9,1,14,
2025-08-31,Gil West,Hertz,7,25,8,40,
2025-08-31,Malcolm C Roberts,FM Global,1,11,2,14,
2025-08-31,Mick Beekhuizen,Campbell Soup,8,24,1,33,
2025-08-31,Daniel Wall,Expeditors International of Washington,2,5,0,7,
2025-08-31,Gregory Roberts,A-Mark Precious Metals,1,4,1,6,
2025-08-31,Horacio Rozanski,Booz Allen Hamilton,16,19,5,40,
2025-08-31,James Davis,Quest Diagnostics,5,5,0,10,
2025-08-31,Dennis Mathew,Altice,4,29,7,40,
2025-08-31,Stefan Larsson,PVH,11,24,5,40,
2025-08-31,Mark Costa,Eastman Chemical,6,16,4,26,
2025-08-31,Joyce Mullen,Insight Enterprises,6,9,1,16,
2025-08-31,John Turner,Regions Financial,19,19,2,40,
2025-08-31,Julian G Francis,Beacon Roofing Supply,0,1,0,1,
2025-08-31,Blake Moret,Rockwell Automation,11,27,2,40,
2025-08-31,Mike Speetzen,Polaris Inc,3,17,2,22,
2025-08-31,William McDermott,ServiceNow,3,6,0,9,
2025-08-31,Jure Sola,Sanmina,2,12,0,14,
2025-08-31,Bob Flexon,UGI Utilities Inc,0,1,0,1,
2025-08-31,Scott Lauber,WEC Energy,15,6,0,21,
2025-08-31,Jon Rousseau,BrightSpring Health Services,20,19,1,40,
2025-08-31,Todd Schneider,Cintas,12,18,2,32,
2025-08-31,Peter Matt,Commercial Metals,5,3,0,8,
2025-08-31,Robert D Lawler,Continental Resources,1,0,0,1,
2025-08-31,Domenic Dell‚ÄôOsso Jr,Expand Energy,4,0,0,4,
2025-08-31,Jason P Wells,CenterPoint Energy,9,3,1,13,
2025-08-31,H Michael Krimbill,NGL Energy Partners,5,2,0,7,
2025-08-31,Tony Xu,DoorDash,13,19,8,40,
2025-08-31,Clay Williams,NOV,9,20,4,33,
2025-08-31,Kristin Peck,Zoetis,13,19,1,33,
2025-08-31,Mark Smucker,JM Smucker,10,23,7,40,
2025-08-31,Steve Sanghi,Microchip Technology,8,28,4,40,
2025-08-31,Richard Tobin,Dover Corporation,5,2,0,7,
2025-08-31,Kaes Van‚Äôt Hof,Diamondback Energy,23,14,2,39,
2025-08-31,Deon Stander,Avery Dennison,0,13,0,13,
2025-08-31,Vincent Sorgi,PPL,8,10,1,19,
2025-08-31,Hassane El-Khoury,ON Semiconductor,2,19,3,24,
2025-08-31,Arie Kotler,ARKO,5,24,0,29,
2025-08-31,William Monteleone,Par Pacific,1,7,2,10,
2025-08-31,John Christmann IV,APA,5,4,1,10,
2025-08-31,Adaire Fox-Martin,Equinix,19,18,3,40,
2025-08-31,Joseph M Otting,Flagstar Financial,2,6,1,9,
2025-08-31,Mary Dillon,Foot Locker,11,24,5,40,
2025-08-31,James Zallie,Ingredion,4,6,0,10,
2025-08-31,Christopher Peterson,Newell Brands,0,8,2,10,
2025-08-31,Scott Salmirs,ABM Industries,6,8,1,15,
2025-08-31,Christopher Hilger,Securian Financial,0,8,1,9,
2025-08-31,Hamid Moghadam,Prologis,6,28,6,40,
2025-08-31,Stephen Schwarzman,Blackstone,15,20,5,40,
2025-08-31,Robert Greenberg,Skechers USA,6,24,3,33,
2025-08-31,Keith Allman,Masco,4,9,1,14,
2025-08-31,Rusty Rush,Rush Enterprises,14,23,3,40,
2025-08-31,Jennifer Johnson,Franklin Resources,1,7,2,10,
2025-08-31,Gerry P Smith,ODP Business Solutions,0,0,0,0,
2025-08-31,Carl Lindner lll,American Financial,0,0,0,0,
2025-08-31,Mark Kowlzan,Packaging Corp of America,0,9,1,10,
2025-08-31,Thomas Hill,Vulcan Materials,4,7,2,13,
2025-08-31,Milan Galik,Interactive Brokers,7,20,1,28,
2025-08-31,Laura Alber,Williams-Sonoma,14,22,4,40,
2025-08-31,Mario Harik,XPO,7,32,1,40,
2025-08-31,Devin Stockfish,Weyerhaeuser,5,5,0,10,
2025-08-31,Thomas J McInerney,Genworth Financial,0,7,0,7,
2025-08-31,Garrick Rochow,CMS Energy,10,3,0,13,
2025-08-31,Toni Townes-Whitley,Science Applications International,11,21,1,33,
2025-08-31,Rich Handler,Jefferies Financial,11,10,2,23,
2025-08-31,Daniel Heaf,Bath & Body Works,9,29,2,40,
2025-08-31,Andrew Wilson,Electronic Arts,14,18,8,40,
2025-08-31,Sheryl Palmer,Taylor Morrison Home,7,12,1,20,
2025-08-31,Ivan Tornos,Zimmer Biomet,10,30,0,40,
2025-08-31,Linda Rendle,Clorox,2,35,1,38,
2025-08-31,Matthew Pine,Xylem Inc,1,8,1,10,
2025-08-31,Heather Lavallee,Voya Financial,5,10,2,17,
2025-08-31,Daniel Florness,Fastenal,2,6,1,9,
2025-08-31,Albert Nahmad,Watsco,3,7,0,10,
2025-08-31,Carl Eschenbach,Workday,12,19,9,40,
2025-08-31,Craig Smiddy,Old Republic International,4,5,1,10,
2025-08-31,Frank C Sullivan,RPM International,4,10,1,15,
2025-08-31,Matthew Missad,UFP Industries,7,3,0,10,
2025-08-31,Martin J Lyons,Ameren,3,3,1,7,
2025-08-31,Adam W Miller,Knight Swift Transportation,2,2,1,5,
2025-08-31,Rodney Sacks,Monster Beverage,13,25,1,39,
2025-08-31,Gary Guthart,Intuitive Surgical,11,26,3,40,
2025-08-31,Charles Liang,Super Micro Computer,33,6,1,40,
2025-08-31,Christopher Caldwell,Concentrix,2,5,0,7,
2025-08-31,Gordon J Hardie,O-I Glass,1,5,0,6,
2025-08-31,David Gibbs,Yum Brands,3,36,1,40,
2025-08-31,Steve Henry,Domtar,5,5,0,10,
2025-08-31,Chuck Treadway,CommScope,8,20,3,31,
2025-08-31,Rob Vitale,Post Holdings,1,11,5,17,
2025-08-31,Steven J Moskowitz,Crown Castle,2,6,2,10,
2025-08-31,Emmanuel Ligner,Avantor,3,10,1,14,
2025-08-31,Stuart Bradie,KBR,16,15,4,35,
2025-08-31,Carrie Wheeler,Opendoor Technologies,10,27,3,40,
2025-08-31,Russell Becker,APi Group,3,6,0,9,
2025-08-31,Toby Rice,EQT,24,14,2,40,
2025-08-31,Jesse Arenivas,EnLink Midstream,7,10,0,17,
2025-08-31,Nikesh Arora,Palo Alto Networks,5,27,8,40,
2025-08-31,Steven Bandrowczak,Xerox,1,8,1,10,
2025-08-31,Vicente Reynal,Ingersoll Rand,9,26,0,35,
2025-08-31,William T Dillard II,Dillards,3,5,2,10,
2025-08-31,C Howard Nye,Martin Marietta Materials,3,5,2,10,
2025-08-31,Giordano Albertazzi,Vertiv,10,12,3,25,
2025-08-31,Stephane Bancel,Moderna,10,19,11,40,
2025-08-31,Nate R Jorgensen,Boise Cascade,0,0,0,0,
2025-08-31,Jack Sinclair,Sprouts Farmers Market,16,23,1,40,
2025-08-31,Padraig McDonnell,Agilent Technologies,13,13,0,26,
2025-08-31,Kenneth T Lane,Olin,0,0,0,0,
2025-08-31,Randall C Stuewe,Darling Ingredients,27,1,0,28,
2025-08-31,R Howard Coker,Sonoco Products,2,7,1,10,
2025-08-31,John Mengucci,CACI International,22,16,2,40,
2025-08-31,Mark Witkowski,Core & Main,0,6,1,7,
2025-08-31,Lee M Tillman,Marathon Oil,5,4,0,9,
2025-08-31,Mark Hoplamazian,Hyatt Hotels,14,21,5,40,
2025-08-31,David S Chernow,Select Medical,0,8,1,9,
2025-08-31,Brendan M Foley,McCormick & Company,0,8,0,8,
2025-08-31,Joanne Crevoiserat,Tapestry,13,23,4,40,
2025-08-31,John Plant,Howmet Aerospace,5,12,1,18,
2025-08-31,Shankh Mitra,Welltower,18,20,2,40,
2025-08-31,W Anthony Will,CF Industries,5,4,0,9,
2025-08-31,David A Zapico,Ametek,2,16,0,18,
2025-08-31,Kevin Stein,TransDigm,10,9,3,22,
2025-08-31,Craig Billings,Wynn Resorts,13,25,2,40,
2025-08-31,William J Way,Southwestern Energy,1,1,0,2,
2025-08-31,Giel Rutten,Amkor Technology,2,9,1,12,
2025-08-31,Paul Sarvadi,Insperity,4,5,1,10,
2025-08-31,Donald Zurbay,Patterson Companies Inc,0,2,0,2,
2025-08-31,Rob Sharps,T Rowe Price,11,21,7,39,
2025-08-31,Patrice Louvet,Ralph Lauren,13,17,10,40,
2025-08-31,Jeffrey Mezger,KB Home,2,28,10,40,
2025-08-31,David M Foulkes,Brunswick,0,8,0,8,
2025-08-31,M Keith Waddell,Robert Half,2,9,1,12,
2025-08-31,Jay Snowden,PENN Entertainment,18,19,3,40,
2025-08-31,George Kurian,NetApp,14,22,4,40,
2025-08-31,Kevin Ali,Organon,9,19,0,28,
2025-08-31,Joel D Anderson,Petco Health and Wellness,3,11,0,14,
2025-08-31,Louis V Pinkham,Regal Rexnord,0,1,0,1,
2025-08-31,Jay Geldmacher,Resideo Technologies,11,5,1,17,
2025-08-31,Marcus Lemonis,Camping World,6,24,10,40,
2025-08-31,Peter R Huntsman,Huntsman,6,12,4,22,
2025-08-31,Hillary Super,Victorias Secret,11,5,9,25,
2025-08-31,Michelle Gass,Levi Strauss,12,24,3,39,
2025-08-31,Neil Hunn,Roper Technologies,2,21,0,23,
2025-08-31,Steven P Lawrence,Academy Sports and Outdoors,1,1,0,2,
2025-08-31,Phillippe Lord,Meritage Homes,9,15,0,24,
2025-08-31,David C Dauch,American Axle & Manufacturing,5,7,2,14,
2025-08-31,Olumide Soroye,Fortive,1,9,0,10,
2025-08-31,Adena Friedman,Nasdaq,15,22,3,40,
2025-08-31,Tim Gokey,Broadridge Financial Solutions,3,12,1,16,
2025-08-31,Patrick M Shanahan,Spirit AeroSystems,1,9,0,10,
2025-08-31,Robert Kyncl,Warner Music Group,10,29,1,40,
2025-08-31,Denise Dignam,Chemours,2,19,3,24,
2025-08-31,Jim DeVries,ADT,9,7,1,17,
2025-08-31,Bernard Zovighian,Edwards Lifesciences,7,5,2,14,
2025-08-31,Mark E Seaton,First American Financial,1,9,0,10,
2025-08-31,John C Roche,Hanover Insurance Group,5,16,1,22,
2025-08-31,Adam J Greenlee,Silgan,0,4,0,4,
2025-08-31,Jayne Hrdlicka,Endeavor Group,0,1,0,1,
2025-08-31,Robert Fauber,Moodys Corporation,0,6,0,6,
2025-08-31,Thomas E Jorden,Coterra Energy,8,0,0,8,
2025-08-31,Eugene A Hall,Gartner,1,9,0,10,
2025-08-31,Kevin Plank,Under Armour,8,29,3,40,
2025-08-31,James W Lanning,Ingles Markets,3,4,0,7,
2025-08-31,Matthew T Farrell,Church & Dwight,8,7,0,15,
2025-08-31,Kevin M Freeman,Old Dominion Freight Line,0,0,0,0,
2025-08-31,Joe Shoen,U-Haul,15,20,4,39,
2025-08-31,Mark Bertolini,Oscar Health,12,19,9,40,
2025-08-31,Jayshree Ullal,Arista Networks,22,18,0,40,
2025-08-31,Sassine Ghazi,Synopsys,11,26,3,40,
2025-08-31,Jochen Zeitz,Harley-Davidson,6,24,10,40,
2025-08-31,Nick Jeffery,Frontier Communications,10,25,2,37,
2025-08-31,Thomas Edward McCormick,Primoris Services,0,4,0,4,
2025-08-31,D Christian Koch,Carlisle Companies,1,4,1,6,
2025-08-31,David E Simon,Simon Property Group,3,5,2,10,
2025-08-31,Stephen Bratspies,Hanesbrands,4,11,1,16,
2025-08-31,Ryan M. Schneider,Anywhere Real Estate Inc,0,2,0,2,
2025-08-31,George Bobb III,Teledyne Technologies,1,4,1,6,
2025-08-31,Terrence A Duffy,CME Group,6,9,1,16,
2025-08-31,Rami Rahim,Juniper Networks,11,27,2,40,
2025-08-31,Sue Nabi,Coty,18,16,6,40,
2025-08-31,Peter D Arvan,Pool Corporation,2,6,0,8,
2025-08-31,David Campbell,Evergy,13,8,0,21,
2025-08-31,Matthew J Murphy,Marvell Technology,4,5,1,10,
2025-08-31,Lloyd Yates,NiSource,5,4,0,9,
2025-08-31,William C Stone,SS&C Technologies,2,6,1,9,
2025-08-31,Mark Rourke,Schneider National,10,16,1,27,
2025-08-31,Andrew Anagnost,Autodesk,9,24,7,40,
2025-08-31,Dustin Semach,Sealed Air Corporation,1,7,0,8,
2025-08-31,William L Meaney,Iron Mountain,4,18,0,22,
2025-08-31,Andy P Power,Digital Realty Trust,0,0,0,0,
2025-08-31,Satish Dhanasekaran,Keysight Technologies,5,11,1,17,
2025-08-31,Frank M Svoboda,Globe Life,2,5,3,10,
2025-08-31,Carey A Smith,Parsons Corporation,1,3,0,4,
2025-08-31,Ynon Kreiz,Mattel,10,23,7,40,
2025-08-31,Karen S Haller,Southwest Gas,3,6,0,9,
2025-08-31,Terrance Williams,TruStage,4,7,1,12,
2025-08-31,Eric W Gerstenberg,Clean Harbors,4,2,1,7,
2025-08-31,Gunner Smith,Cornerstone Building Brands,1,8,0,9,
2025-08-31,Gerben W Bakker,Hubbell,1,6,0,7,
2025-08-31,Dave Davis,Spirit Airlines,1,33,6,40,
2025-08-31,Michael J Smith,Lamb Weston,0,6,3,9,
2025-08-31,Strauss Zelnick,Take-Two Interactive Software,15,17,8,40,
2025-08-31,John C Turner Jr,GMS,2,7,0,9,
2025-08-31,David M O'Malley,Penn Mutual Life Insurance,0,2,0,2,
2025-08-31,Frank A Lonegro,Landstar System,3,4,0,7,
2025-08-31,James F Risoleo,Host Hotels & Resorts,6,17,1,24,
2025-08-31,Ken Xie,Fortinet,14,19,7,40,
2025-08-31,Doug Shulman,OneMain,2,7,0,9,
2025-08-31,Ryan Cohen,GameStop,11,21,8,40,
2025-08-31,Mark W Begor,Equifax,2,10,0,12,
2025-08-31,Jay L Schottenstein,American Eagle Outfitters,9,17,1,27,
2025-08-31,Curtis C Farmer,Comerica,3,9,0,12,
2025-08-31,Ole Rosgaard,Greif,3,17,1,21,
2025-08-31,Brian E Lane,Comfort Systems USA,9,1,0,10,
2025-08-31,Robert M Buck,TopBuild,0,5,1,6,
2025-08-31,Ralph Andretta,Bread Financial,3,8,0,11,
2025-08-31,Jim Anderson,Coherent,6,34,0,40,
2025-08-31,Walter C. D. Carlson,Telephone & Data Systems,0,2,0,2,
2025-08-31,Ronald Kruszewski,Stifel Financial,7,5,0,12,
2025-08-31,Richard Hayne,Urban Outfitters,11,20,7,38,
2025-08-31,Simon Meester,Terex,4,8,0,12,
2025-08-31,Edward J Lehner,Ryerson Holding,0,3,0,3,
2025-08-31,Nicholas T Pinchuk,Snap-on,3,6,0,9,
2025-08-31,Ryals McMullian,Flowers Foods,3,29,2,34,
2025-08-31,D Bryan Jordan,First Horizon,4,8,1,13,
2025-08-31,John B Gibson,Paychex,3,6,0,9,
2025-08-31,Chris Cocks,Hasbro,12,18,10,40,
2025-08-31,Pete McPartland,Sentry Insurance Group,0,2,0,2,
2025-08-31,Michael Arougheti,Ares Management,16,22,2,40,
2025-08-31,Alok Maskara,Lennox International,6,3,1,10,
2025-08-31,James C Grech,Peabody Energy,3,0,0,3,
2025-08-31,Joseph P Lacher Jr,Kemper,4,17,4,25,
2025-08-31,Perry A Sook,Nexstar Media Group,8,29,1,38,
2025-08-31,Wade Davis,TelevisaUnivision,13,25,2,40,
2025-08-31,Scott L Thompson,Tempur Sealy International,0,7,0,7,
2025-08-31,Mike Simonds,TriNet Group,0,9,0,9,
2025-08-31,B Andrew Rose,Worthington Enterprises,1,2,0,3,
2025-08-31,Bruce L Caswell,Maximus,5,5,0,10,
2025-08-31,Robert L Reffkin,Compass,1,7,0,8,
2025-08-31,Mark Eubanks,Brinks Company,1,2,1,4,
2025-08-31,Peter Quigley,Kelly Services inc,1,9,0,10,
2025-08-31,David L Yowan,Navient,2,3,0,5,
2025-08-31,Mary E Kipp,Puget Sound Energy,4,0,1,5,
2025-08-31,Adam Aron,AMC Entertainment,19,14,7,40,
2025-08-31,Mark J Tarr,Encompass Health,2,5,1,8,
2025-08-31,Liam K Griffin,Skyworks Solutions,1,6,1,8,
2025-08-31,Richard G Kyle,Timken,7,18,1,26,
2025-08-31,Ron Gusek,Liberty Energy,24,1,0,25,
2025-08-31,John E Geller Jr,Marriott Vacations Worldwide,6,6,1,13,
2025-08-31,Karl G. Glassman,Leggett & Platt,0,5,0,5,
2025-08-31,Bruce K Thorn,Big Lots,2,5,3,10,
2025-08-31,Jonathan H Weis,Weis Markets,12,27,0,39,
2025-08-31,Jeffrey B Guldner,Pinnacle West Capital,1,5,0,6,
2025-08-31,Arkadiy Dobkin,EPAM Systems,9,15,2,26,
2025-08-31,Paul M Rady,Antero Resources,3,7,0,10,
2025-08-31,Michael Spanos,Bloomin Brands,1,8,1,10,
2025-08-31,Nicole A Kivisto,MDU Resources Group,2,5,0,7,
2025-08-31,Gerald L Morgan,Texas Roadhouse,4,2,4,10,
2025-08-31,Gabriel Tirador,Mercury General,3,5,2,10,
2025-08-31,Nicholas I Fink,Fortune Brands Innovations,4,2,0,6,
2025-08-31,Paul E Burdiss,Zions Bancorp,1,1,0,2,
2025-08-31,William J Christensen,JELD-WEN Holding,3,5,0,8,
2025-08-31,Evan Spiegel,Snap Inc,20,16,4,40,
2025-08-31,Bill Burns,Zebra Technologies,7,24,1,32,
2025-08-31,Steven Sell,Agilon Health,1,6,1,8,
2025-08-31,Richard M Olson,Toro Company,1,14,1,16,
2025-08-31,Eric S Yuan,Zoom Video Communications,4,8,0,12,
2025-08-31,Dan L Batrack,Tetra Tech,2,6,1,9,
2025-08-31,Joseph D Russell Jr,Public Storage,0,8,0,8,
2025-08-31,Jacob Thaysen,Illumina inc,5,7,0,12,
2025-08-31,Debra A Cafaro,Ventas inc,8,4,0,12,
2025-08-31,Pierre R Brondeau,FMC Corporation,0,4,0,4,
2025-08-31,Judy R McReynolds,ArcBest,6,14,1,21,
2025-08-31,Russell J Weiner,Dominos Pizza inc,0,0,0,0,
2025-08-31,Theodore S Hanson,ASGN,0,3,0,3,
2025-08-31,RJ Scaringe,Rivian Automotive,11,27,2,40,
2025-08-31,Jeffrey N Simmons,Elanco Animal Health,3,6,0,9,
2025-08-31,Tim O Shaughnessy,Graham Holdings Company,2,6,0,8,
2025-08-31,Thomas V Taylor,Floor & Decor,1,1,2,4,
2025-08-31,Neil A Schrimsher,Applied Industrial Technologies,6,22,1,29,
2025-08-31,Robert E Price,PriceSmart,5,5,0,10,
2025-08-31,John David Risher,Lyft,3,3,2,8,
2025-08-31,Gary B Smith,Ciena,4,8,0,12,
2025-08-31,Joey Levin,IAC,7,31,1,39,
2025-08-31,Jim Jacobs,Country Financial,7,3,1,11,
2025-08-31,Devin B McGranahan,Western Union,1,5,0,6,
2025-08-31,R Scott Rowe,Flowserve,5,5,0,10,
2025-08-31,Kenneth A Vecchione,Western Alliance Bancorp,0,0,1,1,
2025-08-31,John C Rademacher,Option Care Health,8,2,0,10,
2025-08-31,Doug Black,SiteOne Landscape Supply,3,23,1,27,
2025-08-31,Oliver G Brewer III,Topgolf Callaway Brands,2,0,0,2,
2025-08-31,Glenn Sanford,eXp World,14,22,4,40,
2025-08-31,Fran Horowitz,Abercrombie & Fitch,14,22,4,40,
2025-08-31,Kevin Akers,Atmos Energy,7,2,1,10,
2025-08-31,Alessandro Maselli,Catalent,4,11,2,17,
2025-08-31,J Powell Brown,Brown & Brown,12,21,7,40,
2025-08-31,Aman Bhutani,GoDaddy,17,21,2,40,
2025-08-31,John C. Griffith,American Water Works,1,3,0,4,
2025-08-31,John J Marchioni,Selective Insurance Group,4,14,2,20,
2025-08-31,Lawson E Whiting,Brown-Forman,1,6,1,8,
2025-08-31,Dave Peacock,Advantage Solutions,21,7,0,28,
2025-08-31,Mick Farrell,ResMed,15,24,1,40,
2025-08-31,Kamal Hathi,Splunk,2,4,0,6,
2025-08-31,Todd Kelsey,Plexus,2,7,0,9,
2025-08-31,Phillip D Yeager,Hub Group,3,4,0,7,
2025-08-31,Steven B Hedlund,Lincoln Electric,5,10,0,15,
2025-08-31,Timothy C Oliver,NCR Atleos,0,1,0,1,
2025-08-31,Bruce Fleming,Calumet,2,8,0,10,
2025-08-31,Daniel S. Peyovich,Dycom Industries,1,5,0,6,
2025-08-31,Avner M Applbaum,Valmont Industries,0,8,2,10,
2025-08-31,Kimberly A Fields,ATI inc,5,11,0,16,
2025-08-31,Khozema Z Shipchandler,Twilio,0,2,0,2,
2025-08-31,Gary C Bhojwani,CNO Financial Group,1,6,1,8,
2025-08-31,William Andrew Hendricks Jr,Patterson-UTI Energy,0,0,0,0,
2025-08-31,Kevin D Hochman,Brinker International,1,4,1,6,
2025-08-31,James C Foster,Charles River Laboratories International,2,9,0,11,
2025-08-31,Rajiv K Prasad,Hyster-Yale,2,5,0,7,
2025-08-31,Eric T Steigerwalt,Brighthouse Financial,1,3,0,4,
2025-08-31,Thomas L Ryan,Service Corp International,5,5,0,10,
2025-08-31,Charles M Nifong Jr,CrossAmerica Partners,0,0,0,0,
2025-08-31,Anirudh Devgan,Cadence,9,25,3,37,
2025-08-31,Andi Owen,MillerKnoll,16,15,9,40,
2025-08-31,Sumit Roy,Realty Income,13,17,2,32,
2025-08-31,Timothy John Fitzgerald,Middleby,0,0,0,0,
2025-08-31,Robert H Schottenstein,M/I Homes,3,9,0,12,
2025-08-31,Stephen P MacMillan,Hologic,1,7,0,8,
2025-08-31,Lisa M Barton,Alliant Energy,6,0,0,6,
2025-08-31,Aaron P Jagdfeld,Generac,1,5,1,7,
2025-08-31,Erik Gershwind,MSC Industrial Direct,2,6,2,10,
2025-08-31,Varun Krishna,Rocket Companies,7,31,2,40,
2025-08-31,Fahmi Karam,Upbound Group,4,5,0,9,
2025-08-31,NADominic Ng,East West Bancorp,0,0,0,0,
2025-08-31,Mark Wang,Hilton Grand Vacations,38,2,0,40,
2025-08-31,Robert J Sheedy Jr,Grocery Outlet Holding,0,0,0,0,
2025-08-31,Simon D Campion,Dentsply Sirona,0,3,0,3,
2025-08-31,Jeremy Wensinger,V2X,7,9,0,16,
2025-08-31,Andrew Rees,Crocs,16,14,10,40,
2025-08-31,David M Maura,Spectrum Brands,5,0,0,5,
2025-08-31,Sachin S Lawande,Visteon,0,1,0,1,
2025-08-31,Neil M Ashe,Acuity Inc,0,1,0,1,
2025-08-31,Lorie L Tekorius,Greenbrier,1,8,0,9,
2025-08-31,John R Ciulla,Webster Financial,5,5,0,10,
2025-08-31,Sean D Keohane,Cabot Corporation,3,5,0,8,
2025-08-31,Drew M Wilkerson,RXO inc,0,0,0,0,
2025-08-31,Daniel E Brown,Chord Energy,1,1,0,2,
2025-08-31,Javier D Ferrer Fernandez,Popular inc,0,0,0,0,
2025-08-31,Olivier Rabiller,Garrett Motion inc,4,9,0,13,
2025-08-31,Ronald N Tutor,Tutor Perini Corporation,1,7,1,9,
2025-08-31,Jeff Liaw,Copart,4,4,1,9,
2025-08-31,Aman Narang,Toast inc,5,5,1,11,
2025-08-31,Joseph M Hogan,Align Technology,2,4,1,7,
2025-08-31,Kevin J Wheeler,A O Smith,0,16,1,17,
2025-08-31,Christopher A Cartwright,TransUnion,2,0,1,3,
2025-08-31,James Kelly,NCR Voyix,2,12,1,15,
2025-08-31,Tom Leighton,Akamai Technologies,13,15,5,33,
2025-08-31,Robert G Painter,Trimble,7,2,0,9,
2025-08-31,Tony Helton,Medical Mutual of Ohio,1,4,1,6,
2025-08-31,Caroline S Grace,AMN Healthcare Services,0,0,0,0,
2025-08-31,Patrick Kaltenbach,Mettler-Toledo International,2,7,0,9,
2025-08-31,Michael L Baur,ScanSource,0,4,0,4,
2025-08-31,Jason Lippert,LCI Industries,4,11,0,15,
2025-08-31,Fredric J Tomczyk,Cboe Global Markets,1,6,0,7,
2025-08-31,Octavio Marquez,Diebold Nixdorf,5,11,1,17,
2025-08-31,Sivasankaran Somasundaram,ChampionX,7,1,0,8,
2025-08-31,Ronald F Clarke,Corpay,1,1,0,2,
2025-08-31,Robert W Pittman,iHeartMedia,3,3,0,6,
2025-08-31,Patrick Zalupski,Dream Finders Homes,23,15,2,40,
2025-08-31,Keith E Smith,Boyd Gaming,1,7,1,9,
2025-08-31,Mehran Assadi,NLV Financial,1,1,0,2,
2025-08-31,Barry R Port,Ensign Group,3,5,1,9,
2025-08-31,Denise A Paulonis,Sally Beauty,1,3,0,4,
2025-08-31,Clifford A Skelton,Conduent,0,0,0,0,
2025-08-31,Jean-Michel Ribieras,Sylvamo,2,6,0,8,
2025-08-31,Douglas F Bauer,Tri Pointe Homes,0,5,0,5,
2025-08-31,Shawn O'Connell,EnerSys,3,5,0,8,
2025-08-31,Bill Meury,Incyte,9,16,0,25,
2025-08-31,Dale Francescon,Century Communities,1,8,3,12,
2025-08-31,Michael Nierenberg,Rithm Capital,8,26,1,35,
2025-08-31,Michael J Brown,Euronet Worldwide,2,8,0,10,
2025-08-31,Scott Seu,Hawaiian Electric Industries,4,16,1,21,
2025-08-31,Jason D Robins,DraftKings,5,3,0,8,
2025-08-31,Jonathan J Mazelsky,IDEXX Laboratories,1,3,1,5,
2025-08-31,Richard S Swartz,MYR Group,0,2,0,2,
2025-08-31,Stefano Caroti,Deckers Outdoor,2,6,1,9,
2025-08-31,Kevin R Sayer,DexCom,1,5,0,6,
2025-08-31,John T C Lee,MKS Instruments,4,9,1,14,
2025-08-31,Edward B Pitoniak,VICI Properties,1,6,0,7,
2025-08-31,Albert White III,Cooper Cos,0,0,0,0,
2025-08-31,Barry L Biffle,Frontier Airlines,1,6,6,13,
2025-08-31,Robert A Bruggeworth,Qorvo,4,5,0,9,
2025-08-31,Winnie Park,Five Below,10,27,3,40,
2025-08-31,Steven Oakland,TreeHouse Foods,2,11,0,13,
2025-08-31,James S Hagedorn,Scotts Miracle-Gro,1,1,0,2,
2025-08-31,Michael Cannon-Brookes,Atlassian,19,20,1,40,
2025-08-31,Bertrand Loy,Entegris,3,11,1,15,
2025-08-31,William E Waltz,Atkore,2,6,0,8,
2025-08-31,Celeste B Mastin,H B Fuller,1,4,0,5,
2025-08-31,Kyle T Larkin,Granite Construction,1,6,0,7,
2025-08-31,Michael J Happe,Winnebago Industries,1,4,0,5,
2025-08-31,Steven H Gunby,FTI Consulting,5,12,0,17,
2025-08-31,Stephan B Tanda,AptarGroup,1,4,3,8,
2025-08-31,Timothy P Boyle,Columbia Sportswear,3,3,2,8,
2025-08-31,Anthony J Wood,Roku,5,2,1,8,
2025-08-31,M Christopher Doyle,Civitas Resources,1,2,0,3,
2025-08-31,Andy Eidson,Alpha Metallurgical Resources,1,6,2,9,
2025-08-31,Andy L Nemeth,Patrick Industries,4,1,0,5,
2025-08-31,Roger W Jenkins,Murphy Oil,3,15,0,18,
2025-08-31,Kevin S Blair,Synovus Financial,7,3,0,10,
2025-08-31,Julie Felss Masino,Cracker Barrel Old Country Store,6,18,16,40,
2025-08-31,David M Overton,Cheesecake Factory,1,9,0,10,
2025-08-31,Nick DeIuliis,CNX Resources,9,3,2,14,
2025-08-31,Christopher Pappas,Chefs Warehouse,3,9,1,13,
2025-08-31,Tod Carpenter,Donaldson Company,2,8,0,10,
2025-08-31,Gregory L Christopher,Mueller Industries,2,5,0,7,
2025-08-31,Rob Saltiel,MRC Global,7,12,2,21,
2025-08-31,Jillian C Evanko,Chart Industries,3,6,0,9,
2025-08-31,Dave Guilmette,Alight Solutions,3,7,0,10,
2025-08-31,Joel Smejkal,Vishay Intertechnology,6,3,1,10,
2025-08-31,Dennis Degner,Range Resources,4,6,0,10,
2025-08-31,Ira D Robbins,Valley National Bancorp,1,2,0,3,
2025-08-31,Bernard Kim,Match Group,15,19,6,40,
2025-08-31,Vincent Pilette,Gen Digital,3,12,1,16,
2025-08-31,Timothy S Crane,Wintrust Financial,2,7,0,9,
2025-08-31,Pat Roche,Moog inc,3,10,1,14,
2025-08-31,Mark R Widmar,First Solar,3,6,2,11,
2025-08-31,Niko Lahanas,Central Garden & Pet,2,11,0,13,
2025-08-31,Chris Osowski,Green Plains inc,7,15,1,23,
2025-08-31,Derek J Leathers,Werner Enterprises,1,9,0,10,
2025-08-31,Adam Foroughi,AppLovin,10,26,4,40,
2025-08-31,Luca Savi,ITT,3,6,0,9,
2025-08-31,Lawrence H Silber,Herc Rentals,0,0,0,0,
2025-08-31,Hilton H Howell Jr,Gray Television,7,20,1,28,
2025-08-31,Eric D Ashleman,IDEX,0,8,1,9,
2025-08-31,Owen D Thomas,Boston Properties,2,7,0,9,
2025-08-31,Kurt Wolf,Pitney Bowes,5,18,2,25,
2025-08-31,Sara E Armbruster,Steelcase,1,0,0,1,
2025-08-31,Charles D. Young,Sun Communities,2,5,0,7,
2025-08-31,Suzanne Foster,AdaptHealth,5,8,1,14,
2025-08-31,Grant E Sims,Genesis Energy,4,2,0,6,
2025-08-31,Laura Prieskorn,Jackson Financial,3,5,2,10,
2025-08-31,Rick L Wessel,FirstCash,2,6,1,9,
2025-08-31,Sherman Miller,Cal-Maine Foods,11,28,1,40,
2025-08-31,Paul A Lang,Arch Resources,4,3,1,8,
2025-08-31,Ashish K Khandpur,Avient,2,7,0,9,
2025-08-31,Shyam K Reddy,BlueLinx,1,7,0,8,
2025-08-31,Christopher S Ripley,Sinclair,1,7,0,8,
2025-08-31,Stacy Kymes,BOK Financial,8,7,0,15,
2025-08-31,James H Walter,Permian Resources,1,0,0,1,
2025-08-31,Jason Murray,PACS Group,4,13,3,20,
2025-08-31,Brian Armstrong,Coinbase Global,12,22,6,40,
2025-08-31,Oscar K Brown,Western Midstream Partners,1,3,0,4,
2025-08-31,Nicholas R Lower,Federated Mutual Insurance,0,0,0,0,
2025-08-31,Morris Goldfarb,G-III Apparel Group,11,24,5,40,
2025-08-31,Mark D Morelli,Vontier,0,4,0,4,
2025-08-31,Matthew J Cox,Matson inc,0,6,0,6,
2025-08-31,David W Grzebinski,Kirby Corporation,1,3,0,4,
2025-08-31,Keith A Harvey,Kaiser Aluminum,3,4,2,9,
2025-08-31,Eric Nyman,Vista Outdoor,4,10,1,15,
2025-08-31,Doug Howe,Designer Brands,5,17,0,22,
2025-08-31,Jerry E Gahlhoff Jr,Rollins inc,0,2,0,2,
2025-08-31,D Scott Barbour,Advanced Drainage Systems,3,3,0,6,
2025-08-31,Sean Gamble,Cinemark,17,22,1,40,
2025-08-31,George Kurtz,CrowdStrike,17,21,2,40,
2025-08-31,Bill Ready,Pinterest,25,15,0,40,
2025-08-31,Fidji Simo,Instacart,9,30,1,40,
2025-08-31,Kimberly K Ryan,Hillenbrand,3,5,0,8,
2025-08-31,David S Graziosi,Allison Transmission,2,17,2,21,
2025-08-31,Gary G Friedman,Restoration Hardware,1,4,0,5,
2025-08-31,Lucinda M Baier,Brookdale Senior Living,4,3,0,7,
2025-08-31,Brian J Blaser,QuidelOrtho,1,9,0,10,
2025-08-31,E Jean Savage,Trinity Industries,1,6,1,8,
2025-08-31,Liam J Kelly,Teleflex,1,6,1,8,
2025-08-31,Laurans A Mendelson,HEICO,8,21,2,31,
2025-08-31,Frank H Laukien,Bruker,1,10,0,11,
2025-08-31,Harvey M Schwartz,Carlyle Group,7,13,0,20,
2025-08-31,Mark S LaVigne,Energizer,2,0,0,2,
2025-08-31,Joel Quadracci,Quad/Graphics,9,23,5,37,
2025-08-31,Amar Maletira,Rackspace Technology,4,9,3,16,
2025-08-31,Udit Batra,Waters Corporation,12,25,0,37,
2025-08-31,Eric M Green,West Pharmaceutical Services,0,9,0,9,
2025-08-31,Doug Palladini,Carters inc,2,2,2,6,
2025-08-31,G Mike Mikan,NeueHealth,3,2,0,5,
2025-08-31,Russell ChipChilds,SkyWest,0,0,0,0,
2025-08-31,Christopher H Hunter,Acadia Healthcare,0,1,0,1,
2025-08-31,Prahlad Singh,Revvity,1,7,0,8,
2025-08-31,Maria M Pope,Portland General Electric,1,1,0,2,
2025-08-31,Charles Chip Blankenship,Woodward inc,0,2,0,2,
2025-08-31,Mike Steib,TEGNA,15,18,1,34,
2025-08-31,Kurt J Ekert,Sabre Corporation,0,1,0,1,
2025-08-31,Matt Wilson,Light & Wonder,14,22,4,40,
2025-08-31,Rob Katz,Vail Resorts,3,14,23,40,
2025-08-31,Schnitzer Steel Industries,Radius Recycling,7,23,5,35,
2025-08-31,David A Spector,PennyMac Financial Services,3,0,0,3,
2025-08-31,Frederick J Holzgrefe III,Saia inc,1,1,0,2,
2025-08-31,Mark J Parrell,Equity Residential,4,5,0,9,
2025-08-31,John W Lindsay,Helmerich & Payne,1,5,0,6,
2025-08-31,Gary D Burnison,Korn Ferry,3,13,0,16,
2025-08-31,Timothy J McGrath,PC Connection Inc,2,3,0,5,
2025-08-31,Lynn M Bamford,Curtiss-Wright,11,6,0,17,
2025-08-31,Jonathan W Witter,Sallie Mae,0,1,0,1,
2025-08-31,Jeff Benck,Benchmark Electronics,1,7,0,8,
2025-08-31,Charles H Giancarlo,Pure Storage,0,3,0,3,
2025-08-31,Brian R Gray,Knife River Corporation,0,2,0,2,
2025-08-31,Jay Schmidt,Caleres inc,4,4,2,10,
2025-08-31,Dale Asplund,BrightView Holdings,1,5,0,6,
2025-08-31,Jeffrey S Edwards,Cooper-Standard,0,6,0,6,
2025-08-31,Glenn J Williams,Primerica,6,2,2,10,
2025-08-31,Francois Locoh-Donou,F5,5,20,3,28,
2025-08-31,Joseph Wm Foran,Matador Resources,7,9,0,16,
2025-08-31,Sridhar Ramaswamy,Snowflake inc,13,22,4,39,
2025-08-31,Mark D Dankberg,Viasat,2,5,2,9,
2025-08-31,Francisco J Leon,California Resources,1,3,1,5,
2025-08-31,Peter Stern,Peloton,18,18,4,40,
2025-08-31,David Baszucki,Roblox,11,20,9,40,
2025-08-31,Jeffrey W Edwards,Installed Building Products,1,3,0,4,
2025-08-31,Clark Lauritzen,First National of Nebraska,1,7,0,8,
2025-08-31,Carlos Alberini,Guess inc,13,26,1,40,
2025-08-31,Shyam P Kambeyanda,ESAB,4,3,0,7,
2025-08-31,Edmund Shallcross III,Amica Mutual Insurance,1,5,0,6,
2025-08-31,Benjamin W Schall,AvalonBay Communities,1,7,1,9,
2025-08-31,Allan C Thygesen,DocuSign,2,8,0,10,
2025-08-31,Bryan J Knutson,Titan Machinery,2,1,2,5,
2025-08-31,Heath Sampson,ModivCare,7,2,1,10,
2025-08-31,Ara K Hovnanian,Hovnanian Enterprises,1,18,2,21,
2025-08-31,Joshua G Silverman,Etsy,2,3,0,5,
2025-08-31,Kevin Roycraft,Adams Resources & Energy,6,3,1,10,
2025-08-31,J Eric Evans,Surgery Partners,1,3,0,4,
2025-08-31,Clint E Stein,Columbia Banking System,1,6,0,7,
2025-08-31,Lee M Shavel,Verisk Analytics,3,6,0,9,
2025-08-31,Dave Banyard Jr,MasterBrand,0,0,0,0,
2025-08-31,Peter R Ingram,Hawaiian Airlines inc,1,1,0,2,
2025-08-31,Kristin A Dolan,AMC Networks,3,2,0,5,
2025-08-31,Brendan T Cavanagh,SBA Communications,1,2,0,3,
2025-08-31,George F Chappelle Jr,Americold Realty Trust,1,3,0,4,
2025-08-31,Thomas E Gottwald,NewMarket Corporation,3,7,0,10,
2025-08-31,Thomas J Baltimore Jr,Park Hotels & Resorts,3,28,0,31,
2025-08-31,Peter M Moglia,Alexandria Real Estate Equities,4,6,0,10,
2025-08-31,Ronald J Kramer,Griffon Corporation,2,5,0,7,
2025-08-31,John L Plueger,Air Lease,2,12,0,14,
2025-08-31,Jennifer F Scanlon,UL Solutions,1,6,0,7,
2025-08-31,Greg Smith,Teradyne,2,8,2,12,
2025-08-31,Sean Trauschke,OGE Energy,16,5,0,21,
2025-08-31,Norman D Schwartz,Bio-Rad Laboratories,1,1,1,3,
2025-08-31,Scott Doyle,Spire inc,4,5,1,10,
2025-08-31,Michael E Reed,Gannett,0,4,2,6,
2025-08-31,Cindy J Miller,Stericycle,2,5,2,9,
2025-08-31,Phillip D Green,Cullen Frost Bankers,1,5,2,8,
2025-08-31,Joseph D Margolis,Extra Space Storage,0,8,1,9,
2025-08-31,Mark A Skonieczny,REV Group,7,3,0,10,
2025-08-31,Ladd Wilks,ProFrac Holding,4,3,1,8,
2025-08-31,Sundaram Nagarajan,Nordson,1,10,1,12,
2025-08-31,Anne P Noonan,Summit Materials,0,1,0,1,
2025-08-31,Lori Flees,Valvoline inc,4,4,2,10,
2025-08-31,Scott H Baxter,Kontoor Brands,3,2,0,5,
2025-08-31,Tim Larson,Skyline Champion,7,0,0,7,
2025-08-31,Chuck Divita,Teladoc Health,8,18,5,31,
2025-08-31,W Bradley Southern,Louisiana-Pacific Corporation,0,0,0,0,
2025-08-31,George C Freeman III,Universal Corporation,4,6,0,10,
2025-08-31,James A Brock,Consol Energy,2,0,0,2,
2025-08-31,Robert Antokol,Playtika Holding,2,6,1,9,
2025-08-31,Joe Craft,Alliance Resource Partners,6,10,2,18,
2025-08-31,Paul Keel,Envista,1,7,1,9,
2025-08-31,Jared Isaacman,Shift4 Payments,7,27,6,40,
2025-08-31,Mark Mac McFarland,Talen Energy,4,1,1,6,
2025-08-31,Tony R Thene,Carpenter Technology,3,9,0,12,
2025-08-31,Melissa D Smith,WEX,3,6,0,9,
2025-08-31,James Jim C Ryan III,Old National Bancorp,1,0,0,1,
2025-08-31,Peter J Federico,AGNC Investment,2,0,0,2,
2025-08-31,Brent L Yeagy,Wabash National,0,1,0,1,
2025-08-31,Henry A Fernandez,MSCI,4,15,0,19,
2025-08-31,Mark Penn,Stagwell,12,25,2,39,
2025-08-31,Julie Schertell,Mativ,3,8,0,11,
2025-08-31,Ashish Chand,Belden,3,6,1,10,
2025-08-31,Greg Anderson,Allegiant Travel Company,4,7,0,11,
2025-08-31,Drew Houston,Dropbox,14,20,6,40,
2025-08-31,Kevin T Conroy,Exact Sciences,2,5,2,9,
2025-08-31,Rex D Geveden,BWX Technologies,5,6,0,11,
2025-08-31,Scott R Wells,Clear Channel Outdoor Hldgs,0,0,0,0,
2025-08-31,Paul Bay,Ingram Micro,11,24,5,40,
2025-09-01,Doug McMillon,Walmart,16,19,5,40,
2025-09-01,Andrew Jassy,Amazon,4,30,6,40,
2025-09-01,Tim Cook,Apple,13,23,4,40,
2025-09-01,Stephen Hemsley,UnitedHealth,9,26,5,40,
2025-09-01,Warren Buffett,Berkshire Hathaway,12,23,5,40,
2025-09-01,David Joyner,CVS Health,7,28,5,40,
2025-09-01,Darren Woods,Exxon Mobil,11,22,6,39,
2025-09-01,Sundar Pichai,Alphabet,16,18,6,40,
2025-09-01,Brian Tyler,McKesson,4,15,5,24,
2025-09-01,Robert Mauch,Cencora,3,7,0,10,
2025-09-01,Ron Vachris,Costco,5,33,2,40,
2025-09-01,Jamie Dimon,JPMorgan Chase,10,16,14,40,
2025-09-01,Satya Nadella,Microsoft,14,17,9,40,
2025-09-01,Jason Hollar,Cardinal Health,14,21,5,40,
2025-09-01,Mike Wirth,Chevron,17,18,5,40,
2025-09-01,David Cordani,Cigna,21,15,4,40,
2025-09-01,Jim Farley,Ford Motor,14,21,5,40,
2025-09-01,Brian Moynihan,Bank of America,5,30,5,40,
2025-09-01,Mary Barra,General Motors,14,22,4,40,
2025-09-01,Gail Boudreaux,Elevance Health,15,18,7,40,
2025-09-01,Jane Fraser,Citigroup,14,21,5,40,
2025-09-01,Sarah London,Centene,13,18,9,40,
2025-09-01,Ted Decker,Home Depot,10,25,5,40,
2025-09-01,Maryann Mannen,Marathon Petroleum,5,13,1,19,
2025-09-01,Ron Sargent,Kroger,5,21,14,40,
2025-09-01,Mark Lashier,Phillips 66,11,19,8,38,
2025-09-01,Priscilla Almodovar,Fannie Mae,11,17,12,40,
2025-09-01,Tim Wentworth,Walgreens,8,23,9,40,
2025-09-01,Lane Riggs,Valero Energy,14,9,0,23,
2025-09-01,Mark Zuckerberg,Meta,8,19,13,40,
2025-09-01,Hans Vestberg,Verizon,17,19,4,40,
2025-09-01,John Stankey,AT&T,12,23,5,40,
2025-09-01,Brian Roberts,Comcast,10,28,2,40,
2025-09-01,Charles Scharf,Wells Fargo,29,6,5,40,
2025-09-01,David Solomon,Goldman Sachs,8,22,10,40,
2025-09-01,Michael Hutchins,Freddie Mac,3,10,3,16,
2025-09-01,Michael Fiddelke,Target,9,23,8,40,
2025-09-01,Jim Rechtin,Humana,18,17,5,40,
2025-09-01,Jon Farney,State Farm Insurance,1,13,3,17,
2025-09-01,Elon Musk,Tesla,7,17,16,40,
2025-09-01,Ted Pick,Morgan Stanley,16,21,3,40,
2025-09-01,Joaquin Duato,Johnson & Johnson,12,24,4,40,
2025-09-01,Juan Luciano,Archer Daniels Midland,3,20,15,38,
2025-09-01,Ramon Laguarta,PepsiCo,7,28,5,40,
2025-09-01,Carol Tom√©,UPS,9,20,11,40,
2025-09-01,Rajesh Subramaniam,FedEx,8,29,0,37,
2025-09-01,Bob Iger,Walt Disney,9,29,2,40,
2025-09-01,Michael Dell,Dell Technologies,12,23,5,40,
2025-09-01,Marvin Ellison,Lowes,14,24,2,40,
2025-09-01,Jon Moeller,Procter & Gamble,6,28,6,40,
2025-09-01,Thomas Long,Energy Transfer,8,0,1,9,
2025-09-01,Kelly Ortberg,Boeing,11,26,3,40,
2025-09-01,Susan Morris,Albertsons,12,25,3,40,
2025-09-01,Kevin Hourican,Sysco,9,27,4,40,
2025-09-01,Christopher Calio,RTX,6,12,0,18,
2025-09-01,Larry Culp,General Electric,11,26,3,40,
2025-09-01,James Taiclet,Lockheed Martin,11,20,9,40,
2025-09-01,Stephen Squeri,American Express,16,22,2,40,
2025-09-01,Joe Creed,Caterpillar,11,27,2,40,
2025-09-01,Michel Khalaf,MetLife,12,17,1,30,
2025-09-01,Samuel Hazen,HCA Healthcare,8,7,0,15,
2025-09-01,Tricia Griffith,Progressive Insurance,9,26,5,40,
2025-09-01,Arvind Krishna,IBM,13,22,5,40,
2025-09-01,John May,Deere,8,27,5,40,
2025-09-01,Jensen Huang,Nvidia,11,27,2,40,
2025-09-01,Philip Smith,StoneX,0,8,1,9,
2025-09-01,Robert M Davis,Merck,4,18,0,22,
2025-09-01,Ryan Lance,ConocoPhillips,17,20,3,40,
2025-09-01,Albert Bourla,Pfizer,16,14,10,40,
2025-09-01,Ed Bastian,Delta Air Lines,11,21,8,40,
2025-09-01,Patrick Zammit,TD Synnex,9,14,0,23,
2025-09-01,Kevin Murphy,Publix Super Markets,10,21,1,32,
2025-09-01,Thomas J Wilson,Allstate,0,9,1,10,
2025-09-01,Chuck Robbins,Cisco Systems,13,24,3,40,
2025-09-01,Kirt Walker,Nationwide,15,18,2,35,
2025-09-01,Christopher Winfrey,Charter Communications,6,16,5,27,
2025-09-01,Bob Michael,AbbVie,0,0,0,0,
2025-09-01,Craig DeSanto,New York Life Insurance,3,17,0,20,
2025-09-01,Lip-Bu Tan,Intel,9,14,17,40,
2025-09-01,Ernie Herrman,TJX,15,23,2,40,
2025-09-01,Andrew Sullivan,Prudential Financial,11,20,0,31,
2025-09-01,Enrique Lores,Hewlett Packard,11,16,7,34,
2025-09-01,Scott Kirby,United Airlines,33,4,3,40,
2025-09-01,George Holm,Performance Food,11,22,2,35,
2025-09-01,Donnie King,Tyson Foods,9,25,6,40,
2025-09-01,Robert Isom,American Airlines,7,27,6,40,
2025-09-01,Timothy M Sweeney,Liberty Mutual Insurance,12,0,0,12,
2025-09-01,Elliott Hill,Nike,8,30,2,40,
2025-09-01,Safra Catz,Oracle,11,22,7,40,
2025-09-01,AJ Jim Teague,Enterprise Products Partners,6,8,0,14,
2025-09-01,Richard Fairbank,Capital One,16,21,3,40,
2025-09-01,Wilfred Chiang,Plains GP,1,1,0,2,
2025-09-01,Michael Kasbar,World Kinect,2,9,0,11,
2025-09-01,Peter Zaffino,American International Group,8,28,4,40,
2025-09-01,James Quincey,The Coca-Cola Company,9,29,2,40,
2025-09-01,Thasunda Brown Duckett,TIAA,20,20,0,40,
2025-09-01,Jay Debertin,CHS,4,9,3,16,
2025-09-01,Chris Boerner,Bristol-Myers Squibb,10,24,6,40,
2025-09-01,Corie Barry,Best Buy,39,1,0,40,
2025-09-01,Marc Casper,Thermo Fisher Scientific,12,25,3,40,
2025-09-01,Roger Crandall,Mass Mutual,3,7,0,10,
2025-09-01,Juan Andrade,USAA,5,16,0,21,
2025-09-01,Phebe Novakovic,General Dynamics,28,9,3,40,
2025-09-01,Alan Schnitzer,Travelers Insurance,3,5,2,10,
2025-09-01,David Zaslav,Warner Bros Discovery,5,22,12,39,
2025-09-01,Gunjan Kedia,US Bancorp,12,26,2,40,
2025-09-01,Robert Ford,Abbott Laboratories,10,24,6,40,
2025-09-01,Kathy Warden,Northrop Grumman,15,21,4,40,
2025-09-01,Tim Gerend,Northwestern Mutual,13,26,1,40,
2025-09-01,Todd Vasos,Dollar General,8,26,6,40,
2025-09-01,Matthew Lucey,PBF Energy,5,3,0,8,
2025-09-01,Dara Khosrowshahi,Uber,12,22,6,40,
2025-09-01,Vimal Kapur,Honeywell,11,29,0,40,
2025-09-01,Dirk Van de Put,Mondelez,10,27,3,40,
2025-09-01,Brian Niccol,Starbucks,13,27,0,40,
2025-09-01,Cristiano Amon,Qualcomm,13,26,1,40,
2025-09-01,Hock Tan,Broadcom,10,27,3,40,
2025-09-01,David Flitman,US Foods,2,7,0,9,
2025-09-01,Paul Romanowski,DR Horton,5,16,5,26,
2025-09-01,Jacek Olczak,Philip Morris,13,23,4,40,
2025-09-01,Preston Feight,Paccar,5,25,1,31,
2025-09-01,Marc Benioff,Salesforce,8,21,11,40,
2025-09-01,Leon Topalian,Nucor,15,22,3,40,
2025-09-01,Michael Dastoor,Jabil,1,7,0,8,
2025-09-01,Jonathan Jaffe,Lennar,1,8,1,10,
2025-09-01,David Ricks,Eli Lilly,11,20,9,40,
2025-09-01,Joe Zubretsky,Molina Healthcare,8,7,4,19,
2025-09-01,Jennifer Rumsey,Cummins,9,25,6,40,
2025-09-01,Robin Vince,Bank of New York Mellon,19,19,2,40,
2025-09-01,Ted Sarandos,Netflix,14,24,2,40,
2025-09-01,William H Rogers Jr,Truist Financial,2,7,1,10,
2025-09-01,Sean Kerins,Arrow Electronics,2,13,0,15,
2025-09-01,William M Brown,3M,2,8,0,10,
2025-09-01,Ryan McInerney,Visa,15,20,5,40,
2025-09-01,Marc Rowan,Apollo Global Management,18,18,4,40,
2025-09-01,Tim Go,HF Sinclair,6,2,0,8,
2025-09-01,Robert Sulentic,CBRE Group,1,7,1,9,
2025-09-01,William Demchak,PNC Financial Services,13,21,6,40,
2025-09-01,Bryan DeBoer,Lithia Motors,11,27,1,39,
2025-09-01,William Nash,CarMax,4,3,2,9,
2025-09-01,Brian Robbins,Paramount Global,5,33,0,38,
2025-09-01,Michael Creedon,Dollar Tree,3,34,3,40,
2025-09-01,Sandy Douglas,United Natural Foods,33,5,2,40,
2025-09-01,Alex Chriss,PayPal,13,24,3,40,
2025-09-01,Roger Penske,Penske Automotive,18,21,1,40,
2025-09-01,Antonio Neri,Hewlett Packard Enterprise,8,24,8,40,
2025-09-01,Harry Sideris,Duke Energy,36,4,0,40,
2025-09-01,Vicki Hollub,Occidental Petroleum,19,16,4,39,
2025-09-01,Lawrence Coben,NRG Energy,6,2,0,8,
2025-09-01,Robert Bradway,Amgen,9,29,2,40,
2025-09-01,John Ketchum,NextEra Energy,23,17,0,40,
2025-09-01,Rainer Blair,Danaher,7,16,2,25,
2025-09-01,Daniel O'Day,Gilead Sciences,19,17,4,40,
2025-09-01,Michael Manley,AutoNation,3,5,2,10,
2025-09-01,Carlos Abrams-Rivera,Kraft Heinz,15,18,7,40,
2025-09-01,Philip Gallagher,Avnet,1,7,1,9,
2025-09-01,Gary Dickerson,Applied Materials,7,21,12,40,
2025-09-01,Bob Jordan,Southwest Airlines,9,24,7,40,
2025-09-01,Rick Wurster,Charles Schwab,13,21,5,39,
2025-09-01,Lorenzo Simonelli,Baker Hughes,15,21,4,40,
2025-09-01,Chris Kempczinski,McDonalds,10,23,7,40,
2025-09-01,Christopher Womack,Southern Company,3,7,0,10,
2025-09-01,Michael Miebach,Mastercard,12,24,4,40,
2025-09-01,Joseph Dominguez,Constellation Energy,12,11,1,24,
2025-09-01,Christopher Swift,The Hartford,15,22,3,40,
2025-09-01,Patricia Poppe,PG&E,10,18,2,30,
2025-09-01,Bom Kim,Coupang,12,27,1,40,
2025-09-01,Ezra Yacob,EOG Resources,21,12,3,36,
2025-09-01,Jim Vena,Union Pacific,19,21,0,40,
2025-09-01,Matt Schroeder,Rite Aid,4,33,3,40,
2025-09-01,Tony Spring,Macys,10,27,3,40,
2025-09-01,Anthony Capuano,Marriott International,14,24,2,40,
2025-09-01,Raymond E Scott,Lear Corporation,5,5,0,10,
2025-09-01,William Stengel II,Genuine Parts,0,2,0,2,
2025-09-01,Heidi Petz,Sherwin-Williams,8,28,3,39,
2025-09-01,Jeff Miller,Halliburton,11,23,6,40,
2025-09-01,Kathleen Quirk,Freeport-McMoRan,14,17,2,33,
2025-09-01,Michael Rapino,Live Nation Entertainment,15,22,3,40,
2025-09-01,John Doyle,Marsh & McLennan,10,8,0,18,
2025-09-01,Lisa Su,Advanced Micro Devices,18,18,4,40,
2025-09-01,Frank Holding,First Citizens BancShares,9,15,2,26,
2025-09-01,John Engel,WESCO International,5,11,1,17,
2025-09-01,David Gitlin,Carrier Global,15,23,2,40,
2025-09-01,Lourenco Goncalves,Cleveland-Cliffs,8,20,12,40,
2025-09-01,Calvin G Butler Jr,Exelon,5,4,0,9,
2025-09-01,Joseph Bae,KKR,19,19,2,40,
2025-09-01,Christine Leahy,CDW,0,12,2,14,
2025-09-01,Glenn Fogel,Booking Holdings,10,24,6,40,
2025-09-01,Brian Doubles,Synchrony Financial,4,7,2,13,
2025-09-01,Earl Austin,Quanta Services,2,7,1,10,
2025-09-01,Christian Ulbrich,Jones Lang LaSalle,8,21,0,29,
2025-09-01,Saumya Sutaria,Tenet Healthcare,5,3,1,9,
2025-09-01,William Gifford,Altria,3,4,2,9,
2025-09-01,Kevin Lobo,Stryker,11,25,4,40,
2025-09-01,Michael Hsu,Kimberly-Clark,6,6,1,13,
2025-09-01,Jack Fusco,Cheniere Energy,17,20,3,40,
2025-09-01,James Conroy,Ross Stores,4,11,0,15,
2025-09-01,Anthony Smurfit,Smurfit Westrock,2,7,0,9,
2025-09-01,Jeffrey Harmening,General Mills,4,19,4,27,
2025-09-01,Mark Stewart,Goodyear Tire & Rubber,5,33,2,40,
2025-09-01,Bob Eddy,BJs Wholesale Club,4,22,3,29,
2025-09-01,Peter Arduini,GE HealthCare Technologies,5,12,0,17,
2025-09-01,Noel Wallace,Colgate-Palmolive,9,20,2,31,
2025-09-01,Marc Bitzer,Whirlpool,12,13,15,40,
2025-09-01,Chris Kubasik,L3Harris Technologies,8,13,1,22,
2025-09-01,Shantanu Narayen,Adobe,20,19,1,40,
2025-09-01,Thomas Polen,Becton Dickinson,7,3,0,10,
2025-09-01,Richard P Dealy,Pioneer Natural Resources,5,1,0,6,
2025-09-01,Ravi Kumar S,Cognizant Technology Solutions,10,23,3,36,
2025-09-01,Andrew Clyde,Murphy USA,13,25,2,40,
2025-09-01,Mike Lyons,Fiserv,4,11,1,16,
2025-09-01,Jennifer Parmentier,Parker-Hannifin,2,11,0,13,
2025-09-01,William Fehrman,American Electric Power,4,5,0,9,
2025-09-01,Andrew Silvernail,International Paper,6,22,0,28,
2025-09-01,Jonas Prising,ManpowerGroup,7,22,1,30,
2025-09-01,John Zillmer,Aramark,6,14,2,22,
2025-09-01,Mark Millett,Steel Dynamics,19,2,0,21,
2025-09-01,Dan Amos,Aflac,14,19,7,40,
2025-09-01,Tony Cheng,Reinsurance Group of America,2,11,2,15,
2025-09-01,Karsanbhai,Emerson Electric,10,14,3,27,
2025-09-01,Ronald P O'Hanley,State Street,5,12,0,17,
2025-09-01,Timothy Knavish,PPG Industries,1,3,1,5,
2025-09-01,David Burritt,United States Steel,8,18,14,40,
2025-09-01,Maria Black,Automatic Data Processing,4,6,0,10,
2025-09-01,Daryl Kenningham,Group 1 Automotive,9,29,2,40,
2025-09-01,Robert Blue,Dominion Energy,29,10,1,40,
2025-09-01,Larry Fink,BlackRock,7,27,6,40,
2025-09-01,Pierce Norton II,Oneok,5,5,0,10,
2025-09-01,David Bozeman,CH Robinson Worldwide,2,7,0,9,
2025-09-01,Haviv Ilan,Texas Instruments,13,24,3,40,
2025-09-01,Michael Bender,Kohls,1,26,13,40,
2025-09-01,Philip Daniele III,AutoZone,0,2,0,2,
2025-09-01,Timothy Archer,Lam Research,3,7,0,10,
2025-09-01,Charles Magro,Corteva,5,2,1,8,
2025-09-01,Rick Lanoha,Peter Kiewit Sons',0,2,0,2,
2025-09-01,Peter Jackson,Builders FirstSource,5,11,1,17,
2025-09-01,Martin Schroeter,Kyndryl,11,27,1,39,
2025-09-01,Hamid Akhavan,EchoStar,4,24,8,36,
2025-09-01,Bill Westrate,American Family Insurance,9,16,2,27,
2025-09-01,Avigal Soreq,Delek US,3,8,5,16,
2025-09-01,Beth Ford,Land O'Lakes,17,22,1,40,
2025-09-01,Walker Martin,Sempra,0,3,0,3,
2025-09-01,Eric Slifka,Global Partners,12,22,6,40,
2025-09-01,DG Macpherson,WW Grainger,2,7,1,10,
2025-09-01,Bob Pragada,Jacobs Solutions,6,8,0,14,
2025-09-01,Pedro Pizarro,Edison International,15,8,17,40,
2025-09-01,William Hornbuckle,MGM Resorts International,6,23,1,30,
2025-09-01,Andrew McMahon,Guardian Life insurance,6,12,0,18,
2025-09-01,Christopher O'Herlihy,Illinois Tool Works,2,6,2,10,
2025-09-01,James Cracchiolo,Ameriprise Financial,2,22,2,26,
2025-09-01,Ryan Marshall,PulteGroup,10,14,11,35,
2025-09-01,Matthew Meloy,Targa Resources,5,5,0,10,
2025-09-01,Michael Rhodes,Ally Financial,12,23,5,40,
2025-09-01,Joseph Fadool,BorgWarner,4,10,0,14,
2025-09-01,St√©phane de La Faverie,Est√©e Lauder,9,26,5,40,
2025-09-01,Benjamin Tisch,Loews,2,8,0,10,
2025-09-01,Brad Beckham,O'Reilly Automotive,4,15,1,20,
2025-09-01,Thomas Gayner,Markel Group,2,8,0,10,
2025-09-01,Donald Allan,Stanley Black & Decker,8,31,1,40,
2025-09-01,Sanjay Mehrotra,Micron Technology,18,20,2,40,
2025-09-01,James Breuer,Fluor,1,2,1,4,
2025-09-01,Thomas Bell,Leidos,9,19,2,30,
2025-09-01,Scott Smith,Viatris,5,4,0,9,
2025-09-01,Kimberly Dang,Kinder Morgan,11,1,0,12,
2025-09-01,Christophe Beck,Ecolab,19,21,0,40,
2025-09-01,Brent Shafer,Baxter International,1,10,0,11,
2025-09-01,Clay Gaspar,Devon Energy,20,4,0,24,
2025-09-01,Steven Cahillane,Kellanova,2,7,0,9,
2025-09-01,Raul Nicholas Vargas Ochoa,Farmers Insurance Exchange,0,0,0,0,
2025-09-01,Darren Rebelez,Caseys General Stores,3,5,0,8,
2025-09-01,Ari Bousbib,IQVIA,7,15,1,23,
2025-09-01,Jon Vander Ark,Republic Services,11,18,11,40,
2025-09-01,Timothy Cofer,Keurig Dr Pepper,2,4,1,7,
2025-09-01,Karla Lewis,Reliance Inc,3,7,0,10,
2025-09-01,David Hult,Asbury Automotive Group,7,32,1,40,
2025-09-01,Darryl Button,Pacific Life,1,7,0,8,
2025-09-01,James Burke,Vistra,7,3,0,10,
2025-09-01,John Barrett,Western & Southern Financial,11,27,2,40,
2025-09-01,William Krueger,The Andersons Inc,0,2,0,2,
2025-09-01,Erik Nordstrom,Nordstrom,5,29,5,39,
2025-09-01,John Wren,Omnicom Group,15,19,6,40,
2025-09-01,Stephanie Ferris,Fidelity National Information Services,15,22,3,40,
2025-09-01,Timothy Cawley,Consolidated Edison,4,5,0,9,
2025-09-01,Joseph Hinrichs,CSX,7,11,1,19,
2025-09-01,Troy Rudd,AECOM,8,24,5,37,
2025-09-01,Kathleen Johnson,Lumen Technologies,4,4,1,9,
2025-09-01,Harry Lawton III,Tractor Supply,1,1,0,2,
2025-09-01,Raul Fernandez,DXC Technology,3,29,1,33,
2025-09-01,Eric Hansotia,AGCO,15,22,1,38,
2025-09-01,David Bruton Smith,Sonic Automotive,5,9,9,23,
2025-09-01,Sasan Goodarzi,Intuit,10,26,4,40,
2025-09-01,Matthew Flannery,United Rentals,32,2,0,34,
2025-09-01,Marc Miller,Universal Health Services,4,22,3,29,
2025-09-01,Michael Mahoney,Boston Scientific,13,27,0,40,
2025-09-01,Judith Marks,Otis Worldwide,3,3,0,6,
2025-09-01,Robert Frenzel,Xcel Energy,4,2,2,8,
2025-09-01,Penny Pennington,Edward Jones,8,26,6,40,
2025-09-01,Daniel Fisher,Ball,2,19,4,25,
2025-09-01,Justin Jude,LKQ,4,6,1,11,
2025-09-01,James Blackledge,Mutual of Omaha,3,32,2,37,
2025-09-01,Bruce Bodine,Mosaic,3,8,0,11,
2025-09-01,Scott Donnelly,Textron,8,29,3,40,
2025-09-01,Adam Schechter,Labcorp Holdings,3,7,0,10,
2025-09-01,Deanna Strable-Soethout,Principal Financial,1,6,0,7,
2025-09-01,Leonard Schleifer,Regeneron Pharmaceuticals,6,27,7,40,
2025-09-01,Paul Shoukry,Raymond James Financial,15,24,1,40,
2025-09-01,Lauren Hobart,Dicks Sporting Goods,14,22,4,40,
2025-09-01,Jamie Whisnant,Auto-Owners Insurance,0,2,0,2,
2025-09-01,Ariane Gorin,Expedia,9,30,1,40,
2025-09-01,Shelley Simpson,JB Hunt Transport Services,9,28,3,40,
2025-09-01,Ren√© Jones,M&T Bank,13,24,3,40,
2025-09-01,Gerardo Norcia,DTE Energy,5,4,0,9,
2025-09-01,Andr√©s Gluski,AES,19,19,0,38,
2025-09-01,Timothy Spence,Fifth Third Bancorp,5,5,0,10,
2025-09-01,Eduardo Menezes,Air Products & Chemicals,4,5,1,10,
2025-09-01,Wendell Weeks,Corning,15,23,2,40,
2025-09-01,Anthony Guzzi,EMCOR Group,4,4,1,9,
2025-09-01,Adam Norwitt,Amphenol,3,18,0,21,
2025-09-01,Jean-Marc Gilson,Westlake Corporation,2,5,0,7,
2025-09-01,Lori Koch,DuPont,7,17,0,24,
2025-09-01,Derek Chang,Liberty Media,37,3,0,40,
2025-09-01,Martina Cheung,S&P Global,11,26,0,37,
2025-09-01,Tim Hingtgen,Community Health Systems,10,28,2,40,
2025-09-01,Brian Tierney,FirstEnergy,6,23,3,32,
2025-09-01,Rick McKenney,Unum Group,5,4,0,9,
2025-09-01,Stanley Bergman,Henry Schein,11,28,1,40,
2025-09-01,Tiang Yew Tan,Western Digital,0,0,0,0,
2025-09-01,Vincent Roche,Analog Devices,14,23,3,40,
2025-09-01,Sean Connolly,Conagra Brands,7,31,2,40,
2025-09-01,Bruce Van Saun,Citizens Financial Group,13,27,0,40,
2025-09-01,Mark George,Norfolk Southern,18,19,3,40,
2025-09-01,Andrew Marsh,Entergy,4,4,0,8,
2025-09-01,Robert Berkley,WR Berkley,9,28,3,40,
2025-09-01,Javier Rodriguez,DaVita,13,14,1,28,
2025-09-01,Michael O'Grady,Northern Trust,26,5,1,32,
2025-09-01,James Snee,Hormel Foods,3,27,1,31,
2025-09-01,Timothy J Donahue,Crown Holdings,1,8,0,9,
2025-09-01,Joseph Ferraro,Avis Budget,3,5,2,10,
2025-09-01,Niraj Shah,Wayfair,8,24,8,40,
2025-09-01,Jos√© Mas,MasTec,7,15,0,22,
2025-09-01,Joseph Nolan,Eversource Energy,5,3,1,9,
2025-09-01,Thomas Palmer,Newmont,5,5,0,10,
2025-09-01,Robert Sanchez,Ryder System,11,8,1,20,
2025-09-01,Michael Nolan,Fidelity National Financial,4,0,0,4,
2025-09-01,Gavin Hattersley,Molson Coors Beverage,6,30,4,40,
2025-09-01,Thomas Reeg,Caesars Entertainment,6,5,0,11,
2025-09-01,Ellen Cooper,Lincoln National,3,6,0,9,
2025-09-01,Bracken Darrell,VF Corporation,8,29,3,40,
2025-09-01,Erik Fyrwald,International Flavors & Fragrances,7,7,2,16,
2025-09-01,Christopher Kastner,Huntington Ingalls Industries,3,5,0,8,
2025-09-01,Shane O'Kelly,Advance Auto Parts,12,24,4,40,
2025-09-01,Ralph LaRossa,Public Service Enterprise Group,12,18,0,30,
2025-09-01,Kecia Steelman,Ulta Beauty,33,4,3,40,
2025-09-01,Michele Buck,Hershey,7,31,2,40,
2025-09-01,Sumit Singh,Chewy,12,23,5,40,
2025-09-01,Steven Vondran,American Tower,4,6,0,10,
2025-09-01,Jeffrey Lorberbaum,Mohawk Industries,11,6,1,18,
2025-09-01,Keith Demmings,Assurant,3,7,0,10,
2025-09-01,Robert Martin,Thor Industries,3,6,1,10,
2025-09-01,Kathleen Mazzarella,Graybar Electric,1,7,2,10,
2025-09-01,Joey Wat,Yum China,11,26,3,40,
2025-09-01,Scott Richardson,Celanese,9,26,5,40,
2025-09-01,David Rawlinson II,QVC,7,15,2,24,
2025-09-01,Alan Armstrong,Williams,25,12,3,40,
2025-09-01,Philippe Krakowsky,Interpublic Group,13,25,2,40,
2025-09-01,Brendan McCracken,Ovintiv,5,5,0,10,
2025-09-01,Andrew Teno,Icahn Enterprises,5,6,0,11,
2025-09-01,Stephen Steinour,Huntington Bancshares,1,8,0,9,
2025-09-01,Timothy NeCastro,Erie Insurance,3,6,1,10,
2025-09-01,Ernest Garcia III,Carvana,23,13,4,40,
2025-09-01,R Bruce McDonald,Dana Incorporated,3,8,1,12,
2025-09-01,William Oplinger,Alcoa Corporation,2,7,1,10,
2025-09-01,Mark Pearson,Equitable,8,8,0,16,
2025-09-01,Richard Wallace,KLA,4,5,0,9,
2025-09-01,Ricardo Cardenas,Darden Restaurants,4,2,1,7,
2025-09-01,Mikael Bratt,Autoliv,5,8,2,15,
2025-09-01,Benito Minicucci,Alaska Air,3,4,1,8,
2025-09-01,Christopher Gorman,KeyCorp,4,6,0,10,
2025-09-01,Robert Goldstein,Las Vegas Sands,4,31,5,40,
2025-09-01,Edward Pesicka,Owens & Minor,3,33,2,38,
2025-09-01,Christopher Nassetta,Hilton Worldwide,8,16,2,26,
2025-09-01,Jamie Iannone,Ebay,19,17,4,40,
2025-09-01,Patrick Gallagher,Arthur J Gallagher,8,30,2,40,
2025-09-01,Rich Steinmeier,LPL Financial,24,14,2,40,
2025-09-01,Stephen Spray,Cincinnati Financial,1,6,3,10,
2025-09-01,Douglas Yearley,Toll Brothers,10,24,6,40,
2025-09-01,Gregory Brown,Motorola Solutions,1,8,0,9,
2025-09-01,Brian Chesky,Airbnb,3,29,8,40,
2025-09-01,Jeffrey Sprecher,Intercontinental Exchange,14,24,2,40,
2025-09-01,Robert Thomson,News Corp,7,29,4,40,
2025-09-01,Scott Boatwright,Chipotle Mexican Grill,8,28,4,40,
2025-09-01,Reshma Kewalramani,Vertex Pharmaceuticals,20,15,5,40,
2025-09-01,Christopher Viehbacher,Biogen,0,26,2,28,
2025-09-01,Malcolm Wilson,GXO Logistics,8,19,0,27,
2025-09-01,Tony Sarsam,SpartanNash,17,21,2,40,
2025-09-01,Michael O‚ÄôSullivan,Burlington Stores,7,29,4,40,
2025-09-01,Teresa Rasmussen,Thrivent Financial for Lutherans,4,0,0,4,
2025-09-01,Eugene Bredow,NVR,0,4,0,4,
2025-09-01,Brian Chambers,Owens Corning,3,12,0,15,
2025-09-01,Rafael Santana,Westinghouse Air Brake Technologies,3,6,1,10,
2025-09-01,John Pfeifer,Oshkosh,5,25,4,34,
2025-09-01,Cameron Bready,Global Payments,8,30,2,40,
2025-09-01,Calvin McDonald,Lululemon athletica,8,32,0,40,
2025-09-01,J Kent Masters,Albemarle Corporation,3,7,0,10,
2025-09-01,Joanna Geraghty,JetBlue Airways,14,21,5,40,
2025-09-01,Robert Steer,Seaboard,1,4,0,5,
2025-09-01,William Newlands,Constellation Brands,0,2,2,4,
2025-09-01,Michael Doss,Graphic Packaging,4,9,1,14,
2025-09-01,Gil West,Hertz,7,24,9,40,
2025-09-01,Malcolm C Roberts,FM Global,2,10,2,14,
2025-09-01,Mick Beekhuizen,Campbell Soup,8,23,1,32,
2025-09-01,Daniel Wall,Expeditors International of Washington,2,5,0,7,
2025-09-01,Gregory Roberts,A-Mark Precious Metals,1,4,1,6,
2025-09-01,Horacio Rozanski,Booz Allen Hamilton,15,20,5,40,
2025-09-01,James Davis,Quest Diagnostics,5,5,0,10,
2025-09-01,Dennis Mathew,Altice,5,28,7,40,
2025-09-01,Stefan Larsson,PVH,11,24,5,40,
2025-09-01,Mark Costa,Eastman Chemical,6,15,4,25,
2025-09-01,Joyce Mullen,Insight Enterprises,6,9,1,16,
2025-09-01,John Turner,Regions Financial,20,19,1,40,
2025-09-01,Julian G Francis,Beacon Roofing Supply,0,1,0,1,
2025-09-01,Blake Moret,Rockwell Automation,10,28,2,40,
2025-09-01,Mike Speetzen,Polaris Inc,2,16,2,20,
2025-09-01,William McDermott,ServiceNow,2,7,0,9,
2025-09-01,Jure Sola,Sanmina,2,12,0,14,
2025-09-01,Bob Flexon,UGI Utilities Inc,0,1,0,1,
2025-09-01,Scott Lauber,WEC Energy,14,6,0,20,
2025-09-01,Jon Rousseau,BrightSpring Health Services,20,20,0,40,
2025-09-01,Todd Schneider,Cintas,13,18,2,33,
2025-09-01,Peter Matt,Commercial Metals,5,4,0,9,
2025-09-01,Robert D Lawler,Continental Resources,1,0,0,1,
2025-09-01,Domenic Dell‚ÄôOsso Jr,Expand Energy,4,0,0,4,
2025-09-01,Jason P Wells,CenterPoint Energy,9,3,1,13,
2025-09-01,H Michael Krimbill,NGL Energy Partners,5,3,0,8,
2025-09-01,Tony Xu,DoorDash,13,20,7,40,
2025-09-01,Clay Williams,NOV,9,19,5,33,
2025-09-01,Kristin Peck,Zoetis,12,20,1,33,
2025-09-01,Mark Smucker,JM Smucker,11,23,6,40,
2025-09-01,Steve Sanghi,Microchip Technology,8,28,4,40,
2025-09-01,Richard Tobin,Dover Corporation,5,3,0,8,
2025-09-01,Kaes Van‚Äôt Hof,Diamondback Energy,23,14,2,39,
2025-09-01,Deon Stander,Avery Dennison,0,13,0,13,
2025-09-01,Vincent Sorgi,PPL,8,11,1,20,
2025-09-01,Hassane El-Khoury,ON Semiconductor,2,19,3,24,
2025-09-01,Arie Kotler,ARKO,5,24,0,29,
2025-09-01,William Monteleone,Par Pacific,1,7,2,10,
2025-09-01,John Christmann IV,APA,5,4,1,10,
2025-09-01,Adaire Fox-Martin,Equinix,17,20,3,40,
2025-09-01,Joseph M Otting,Flagstar Financial,2,6,2,10,
2025-09-01,Mary Dillon,Foot Locker,10,24,6,40,
2025-09-01,James Zallie,Ingredion,3,5,1,9,
2025-09-01,Christopher Peterson,Newell Brands,0,9,1,10,
2025-09-01,Scott Salmirs,ABM Industries,6,7,1,14,
2025-09-01,Christopher Hilger,Securian Financial,0,8,1,9,
2025-09-01,Hamid Moghadam,Prologis,8,26,6,40,
2025-09-01,Stephen Schwarzman,Blackstone,13,21,6,40,
2025-09-01,Robert Greenberg,Skechers USA,6,24,3,33,
2025-09-01,Keith Allman,Masco,4,9,1,14,
2025-09-01,Rusty Rush,Rush Enterprises,14,23,3,40,
2025-09-01,Jennifer Johnson,Franklin Resources,1,7,2,10,
2025-09-01,Gerry P Smith,ODP Business Solutions,0,0,0,0,
2025-09-01,Carl Lindner lll,American Financial,0,0,0,0,
2025-09-01,Mark Kowlzan,Packaging Corp of America,0,9,1,10,
2025-09-01,Thomas Hill,Vulcan Materials,4,6,2,12,
2025-09-01,Milan Galik,Interactive Brokers,7,20,1,28,
2025-09-01,Laura Alber,Williams-Sonoma,14,22,4,40,
2025-09-01,Mario Harik,XPO,7,32,1,40,
2025-09-01,Devin Stockfish,Weyerhaeuser,5,5,0,10,
2025-09-01,Thomas J McInerney,Genworth Financial,0,7,0,7,
2025-09-01,Garrick Rochow,CMS Energy,10,3,1,14,
2025-09-01,Toni Townes-Whitley,Science Applications International,11,21,1,33,
2025-09-01,Rich Handler,Jefferies Financial,11,10,2,23,
2025-09-01,Daniel Heaf,Bath & Body Works,10,28,2,40,
2025-09-01,Andrew Wilson,Electronic Arts,15,16,9,40,
2025-09-01,Sheryl Palmer,Taylor Morrison Home,7,12,1,20,
2025-09-01,Ivan Tornos,Zimmer Biomet,9,30,1,40,
2025-09-01,Linda Rendle,Clorox,2,35,1,38,
2025-09-01,Matthew Pine,Xylem Inc,1,8,1,10,
2025-09-01,Heather Lavallee,Voya Financial,5,11,2,18,
2025-09-01,Daniel Florness,Fastenal,3,5,1,9,
2025-09-01,Albert Nahmad,Watsco,3,6,0,9,
2025-09-01,Carl Eschenbach,Workday,11,20,9,40,
2025-09-01,Craig Smiddy,Old Republic International,4,5,1,10,
2025-09-01,Frank C Sullivan,RPM International,4,9,1,14,
2025-09-01,Matthew Missad,UFP Industries,8,2,0,10,
2025-09-01,Martin J Lyons,Ameren,1,4,1,6,
2025-09-01,Adam W Miller,Knight Swift Transportation,1,2,1,4,
2025-09-01,Rodney Sacks,Monster Beverage,13,25,1,39,
2025-09-01,Gary Guthart,Intuitive Surgical,12,25,3,40,
2025-09-01,Charles Liang,Super Micro Computer,33,6,1,40,
2025-09-01,Christopher Caldwell,Concentrix,2,5,0,7,
2025-09-01,Gordon J Hardie,O-I Glass,1,4,0,5,
2025-09-01,David Gibbs,Yum Brands,3,36,1,40,
2025-09-01,Steve Henry,Domtar,4,5,0,9,
2025-09-01,Chuck Treadway,CommScope,7,19,3,29,
2025-09-01,Rob Vitale,Post Holdings,1,11,5,17,
2025-09-01,Steven J Moskowitz,Crown Castle,2,6,2,10,
2025-09-01,Emmanuel Ligner,Avantor,3,11,1,15,
2025-09-01,Stuart Bradie,KBR,16,15,4,35,
2025-09-01,Carrie Wheeler,Opendoor Technologies,10,28,2,40,
2025-09-01,Russell Becker,APi Group,4,5,0,9,
2025-09-01,Toby Rice,EQT,25,13,2,40,
2025-09-01,Jesse Arenivas,EnLink Midstream,7,10,0,17,
2025-09-01,Nikesh Arora,Palo Alto Networks,5,26,9,40,
2025-09-01,Steven Bandrowczak,Xerox,1,8,1,10,
2025-09-01,Vicente Reynal,Ingersoll Rand,9,26,0,35,
2025-09-01,William T Dillard II,Dillards,3,4,2,9,
2025-09-01,C Howard Nye,Martin Marietta Materials,2,5,3,10,
2025-09-01,Giordano Albertazzi,Vertiv,13,14,4,31,
2025-09-01,Stephane Bancel,Moderna,9,21,10,40,
2025-09-01,Nate R Jorgensen,Boise Cascade,0,0,0,0,
2025-09-01,Jack Sinclair,Sprouts Farmers Market,16,23,1,40,
2025-09-01,Padraig McDonnell,Agilent Technologies,12,14,0,26,
2025-09-01,Kenneth T Lane,Olin,0,0,0,0,
2025-09-01,Randall C Stuewe,Darling Ingredients,27,1,0,28,
2025-09-01,R Howard Coker,Sonoco Products,2,7,1,10,
2025-09-01,John Mengucci,CACI International,22,16,2,40,
2025-09-01,Mark Witkowski,Core & Main,0,7,1,8,
2025-09-01,Lee M Tillman,Marathon Oil,5,4,0,9,
2025-09-01,Mark Hoplamazian,Hyatt Hotels,14,21,5,40,
2025-09-01,David S Chernow,Select Medical,0,8,1,9,
2025-09-01,Brendan M Foley,McCormick & Company,0,8,0,8,
2025-09-01,Joanne Crevoiserat,Tapestry,14,23,3,40,
2025-09-01,John Plant,Howmet Aerospace,7,13,2,22,
2025-09-01,Shankh Mitra,Welltower,19,19,2,40,
2025-09-01,W Anthony Will,CF Industries,5,4,0,9,
2025-09-01,David A Zapico,Ametek,2,16,0,18,
2025-09-01,Kevin Stein,TransDigm,11,8,3,22,
2025-09-01,Craig Billings,Wynn Resorts,13,24,3,40,
2025-09-01,William J Way,Southwestern Energy,1,1,0,2,
2025-09-01,Giel Rutten,Amkor Technology,2,9,1,12,
2025-09-01,Paul Sarvadi,Insperity,4,5,1,10,
2025-09-01,Donald Zurbay,Patterson Companies Inc,0,2,0,2,
2025-09-01,Rob Sharps,T Rowe Price,11,20,8,39,
2025-09-01,Patrice Louvet,Ralph Lauren,13,17,10,40,
2025-09-01,Jeffrey Mezger,KB Home,1,29,10,40,
2025-09-01,David M Foulkes,Brunswick,0,8,0,8,
2025-09-01,M Keith Waddell,Robert Half,2,9,1,12,
2025-09-01,Jay Snowden,PENN Entertainment,18,19,3,40,
2025-09-01,George Kurian,NetApp,15,22,3,40,
2025-09-01,Kevin Ali,Organon,9,20,0,29,
2025-09-01,Joel D Anderson,Petco Health and Wellness,3,10,0,13,
2025-09-01,Louis V Pinkham,Regal Rexnord,0,0,0,0,
2025-09-01,Jay Geldmacher,Resideo Technologies,10,5,1,16,
2025-09-01,Marcus Lemonis,Camping World,6,24,10,40,
2025-09-01,Peter R Huntsman,Huntsman,5,12,4,21,
2025-09-01,Hillary Super,Victorias Secret,11,5,8,24,
2025-09-01,Michelle Gass,Levi Strauss,12,24,3,39,
2025-09-01,Neil Hunn,Roper Technologies,2,21,0,23,
2025-09-01,Steven P Lawrence,Academy Sports and Outdoors,1,1,0,2,
2025-09-01,Phillippe Lord,Meritage Homes,9,14,0,23,
2025-09-01,David C Dauch,American Axle & Manufacturing,5,7,2,14,
2025-09-01,Olumide Soroye,Fortive,1,9,0,10,
2025-09-01,Adena Friedman,Nasdaq,15,22,3,40,
2025-09-01,Tim Gokey,Broadridge Financial Solutions,3,11,1,15,
2025-09-01,Patrick M Shanahan,Spirit AeroSystems,1,9,0,10,
2025-09-01,Robert Kyncl,Warner Music Group,10,29,1,40,
2025-09-01,Denise Dignam,Chemours,2,20,2,24,
2025-09-01,Jim DeVries,ADT,8,8,1,17,
2025-09-01,Bernard Zovighian,Edwards Lifesciences,7,5,2,14,
2025-09-01,Mark E Seaton,First American Financial,1,9,0,10,
2025-09-01,John C Roche,Hanover Insurance Group,6,20,1,27,
2025-09-01,Adam J Greenlee,Silgan,0,4,0,4,
2025-09-01,Jayne Hrdlicka,Endeavor Group,0,1,0,1,
2025-09-01,Robert Fauber,Moodys Corporation,0,6,0,6,
2025-09-01,Thomas E Jorden,Coterra Energy,9,0,0,9,
2025-09-01,Eugene A Hall,Gartner,0,10,0,10,
2025-09-01,Kevin Plank,Under Armour,8,29,3,40,
2025-09-01,James W Lanning,Ingles Markets,3,4,0,7,
2025-09-01,Matthew T Farrell,Church & Dwight,7,7,0,14,
2025-09-01,Kevin M Freeman,Old Dominion Freight Line,0,0,0,0,
2025-09-01,Joe Shoen,U-Haul,15,20,4,39,
2025-09-01,Mark Bertolini,Oscar Health,12,19,9,40,
2025-09-01,Jayshree Ullal,Arista Networks,21,18,1,40,
2025-09-01,Sassine Ghazi,Synopsys,12,25,3,40,
2025-09-01,Jochen Zeitz,Harley-Davidson,6,24,10,40,
2025-09-01,Nick Jeffery,Frontier Communications,10,24,2,36,
2025-09-01,Thomas Edward McCormick,Primoris Services,0,4,0,4,
2025-09-01,D Christian Koch,Carlisle Companies,1,4,1,6,
2025-09-01,David E Simon,Simon Property Group,3,5,2,10,
2025-09-01,Stephen Bratspies,Hanesbrands,4,11,1,16,
2025-09-01,Ryan M. Schneider,Anywhere Real Estate Inc,0,2,0,2,
2025-09-01,George Bobb III,Teledyne Technologies,1,4,1,6,
2025-09-01,Terrence A Duffy,CME Group,6,9,1,16,
2025-09-01,Rami Rahim,Juniper Networks,11,27,2,40,
2025-09-01,Sue Nabi,Coty,17,16,7,40,
2025-09-01,Peter D Arvan,Pool Corporation,2,6,0,8,
2025-09-01,David Campbell,Evergy,13,8,0,21,
2025-09-01,Matthew J Murphy,Marvell Technology,4,5,1,10,
2025-09-01,Lloyd Yates,NiSource,5,4,0,9,
2025-09-01,William C Stone,SS&C Technologies,2,6,0,8,
2025-09-01,Mark Rourke,Schneider National,8,17,1,26,
2025-09-01,Andrew Anagnost,Autodesk,8,24,8,40,
2025-09-01,Dustin Semach,Sealed Air Corporation,1,9,0,10,
2025-09-01,William L Meaney,Iron Mountain,3,19,0,22,
2025-09-01,Andy P Power,Digital Realty Trust,0,0,0,0,
2025-09-01,Satish Dhanasekaran,Keysight Technologies,4,11,1,16,
2025-09-01,Frank M Svoboda,Globe Life,2,4,3,9,
2025-09-01,Carey A Smith,Parsons Corporation,1,3,0,4,
2025-09-01,Ynon Kreiz,Mattel,11,22,7,40,
2025-09-01,Karen S Haller,Southwest Gas,3,6,0,9,
2025-09-01,Terrance Williams,TruStage,4,7,1,12,
2025-09-01,Eric W Gerstenberg,Clean Harbors,4,2,1,7,
2025-09-01,Gunner Smith,Cornerstone Building Brands,1,8,0,9,
2025-09-01,Gerben W Bakker,Hubbell,1,6,0,7,
2025-09-01,Dave Davis,Spirit Airlines,1,15,1,17,
2025-09-01,Michael J Smith,Lamb Weston,0,6,3,9,
2025-09-01,Strauss Zelnick,Take-Two Interactive Software,15,17,8,40,
2025-09-01,John C Turner Jr,GMS,3,6,0,9,
2025-09-01,David M O'Malley,Penn Mutual Life Insurance,1,2,0,3,
2025-09-01,Frank A Lonegro,Landstar System,3,4,0,7,
2025-09-01,James F Risoleo,Host Hotels & Resorts,6,17,1,24,
2025-09-01,Ken Xie,Fortinet,14,20,6,40,
2025-09-01,Doug Shulman,OneMain,2,7,0,9,
2025-09-01,Ryan Cohen,GameStop,10,22,8,40,
2025-09-01,Mark W Begor,Equifax,2,10,0,12,
2025-09-01,Jay L Schottenstein,American Eagle Outfitters,9,16,1,26,
2025-09-01,Curtis C Farmer,Comerica,3,9,0,12,
2025-09-01,Ole Rosgaard,Greif,3,17,1,21,
2025-09-01,Brian E Lane,Comfort Systems USA,9,1,0,10,
2025-09-01,Robert M Buck,TopBuild,0,5,1,6,
2025-09-01,Ralph Andretta,Bread Financial,3,8,0,11,
2025-09-01,Jim Anderson,Coherent,6,33,1,40,
2025-09-01,Walter C. D. Carlson,Telephone & Data Systems,0,2,0,2,
2025-09-01,Ronald Kruszewski,Stifel Financial,7,4,0,11,
2025-09-01,Richard Hayne,Urban Outfitters,10,20,8,38,
2025-09-01,Simon Meester,Terex,4,8,0,12,
2025-09-01,Edward J Lehner,Ryerson Holding,0,2,0,2,
2025-09-01,Nicholas T Pinchuk,Snap-on,4,5,0,9,
2025-09-01,Ryals McMullian,Flowers Foods,6,29,2,37,
2025-09-01,D Bryan Jordan,First Horizon,4,8,1,13,
2025-09-01,John B Gibson,Paychex,3,6,0,9,
2025-09-01,Chris Cocks,Hasbro,12,19,9,40,
2025-09-01,Pete McPartland,Sentry Insurance Group,0,2,0,2,
2025-09-01,Michael Arougheti,Ares Management,15,24,1,40,
2025-09-01,Alok Maskara,Lennox International,5,4,1,10,
2025-09-01,James C Grech,Peabody Energy,3,0,0,3,
2025-09-01,Joseph P Lacher Jr,Kemper,4,17,4,25,
2025-09-01,Perry A Sook,Nexstar Media Group,8,29,1,38,
2025-09-01,Wade Davis,TelevisaUnivision,14,24,2,40,
2025-09-01,Scott L Thompson,Tempur Sealy International,0,7,0,7,
2025-09-01,Mike Simonds,TriNet Group,0,9,0,9,
2025-09-01,B Andrew Rose,Worthington Enterprises,1,2,0,3,
2025-09-01,Bruce L Caswell,Maximus,5,5,0,10,
2025-09-01,Robert L Reffkin,Compass,1,7,0,8,
2025-09-01,Mark Eubanks,Brinks Company,1,2,1,4,
2025-09-01,Peter Quigley,Kelly Services inc,2,8,0,10,
2025-09-01,David L Yowan,Navient,2,3,0,5,
2025-09-01,Mary E Kipp,Puget Sound Energy,4,0,2,6,
2025-09-01,Adam Aron,AMC Entertainment,19,14,7,40,
2025-09-01,Mark J Tarr,Encompass Health,2,6,1,9,
2025-09-01,Liam K Griffin,Skyworks Solutions,1,6,1,8,
2025-09-01,Richard G Kyle,Timken,8,19,2,29,
2025-09-01,Ron Gusek,Liberty Energy,23,1,0,24,
2025-09-01,John E Geller Jr,Marriott Vacations Worldwide,6,6,1,13,
2025-09-01,Karl G. Glassman,Leggett & Platt,0,5,0,5,
2025-09-01,Bruce K Thorn,Big Lots,2,6,2,10,
2025-09-01,Jonathan H Weis,Weis Markets,12,27,0,39,
2025-09-01,Jeffrey B Guldner,Pinnacle West Capital,1,4,0,5,
2025-09-01,Arkadiy Dobkin,EPAM Systems,9,15,2,26,
2025-09-01,Paul M Rady,Antero Resources,4,9,0,13,
2025-09-01,Michael Spanos,Bloomin Brands,1,8,1,10,
2025-09-01,Nicole A Kivisto,MDU Resources Group,2,5,0,7,
2025-09-01,Gerald L Morgan,Texas Roadhouse,3,3,4,10,
2025-09-01,Gabriel Tirador,Mercury General,4,4,2,10,
2025-09-01,Nicholas I Fink,Fortune Brands Innovations,5,1,0,6,
2025-09-01,Paul E Burdiss,Zions Bancorp,1,1,0,2,
2025-09-01,William J Christensen,JELD-WEN Holding,4,4,0,8,
2025-09-01,Evan Spiegel,Snap Inc,21,16,3,40,
2025-09-01,Bill Burns,Zebra Technologies,7,24,1,32,
2025-09-01,Steven Sell,Agilon Health,1,6,3,10,
2025-09-01,Richard M Olson,Toro Company,1,14,1,16,
2025-09-01,Eric S Yuan,Zoom Video Communications,4,8,0,12,
2025-09-01,Dan L Batrack,Tetra Tech,2,6,1,9,
2025-09-01,Joseph D Russell Jr,Public Storage,0,8,0,8,
2025-09-01,Jacob Thaysen,Illumina inc,5,7,0,12,
2025-09-01,Debra A Cafaro,Ventas inc,7,4,0,11,
2025-09-01,Pierre R Brondeau,FMC Corporation,0,4,0,4,
2025-09-01,Judy R McReynolds,ArcBest,6,13,1,20,
2025-09-01,Russell J Weiner,Dominos Pizza inc,0,0,0,0,
2025-09-01,Theodore S Hanson,ASGN,0,3,0,3,
2025-09-01,RJ Scaringe,Rivian Automotive,11,26,3,40,
2025-09-01,Jeffrey N Simmons,Elanco Animal Health,3,6,1,10,
2025-09-01,Tim O Shaughnessy,Graham Holdings Company,3,6,0,9,
2025-09-01,Thomas V Taylor,Floor & Decor,1,1,2,4,
2025-09-01,Neil A Schrimsher,Applied Industrial Technologies,5,21,1,27,
2025-09-01,Robert E Price,PriceSmart,5,5,0,10,
2025-09-01,John David Risher,Lyft,3,3,2,8,
2025-09-01,Gary B Smith,Ciena,4,8,0,12,
2025-09-01,Joey Levin,IAC,7,30,1,38,
2025-09-01,Jim Jacobs,Country Financial,7,3,1,11,
2025-09-01,Devin B McGranahan,Western Union,1,5,0,6,
2025-09-01,R Scott Rowe,Flowserve,5,5,0,10,
2025-09-01,Kenneth A Vecchione,Western Alliance Bancorp,0,0,1,1,
2025-09-01,John C Rademacher,Option Care Health,9,1,0,10,
2025-09-01,Doug Black,SiteOne Landscape Supply,3,23,1,27,
2025-09-01,Oliver G Brewer III,Topgolf Callaway Brands,1,0,0,1,
2025-09-01,Glenn Sanford,eXp World,14,22,4,40,
2025-09-01,Fran Horowitz,Abercrombie & Fitch,13,22,5,40,
2025-09-01,Kevin Akers,Atmos Energy,7,2,1,10,
2025-09-01,Alessandro Maselli,Catalent,4,11,2,17,
2025-09-01,J Powell Brown,Brown & Brown,12,21,7,40,
2025-09-01,Aman Bhutani,GoDaddy,17,21,2,40,
2025-09-01,John C. Griffith,American Water Works,1,3,0,4,
2025-09-01,John J Marchioni,Selective Insurance Group,4,12,3,19,
2025-09-01,Lawson E Whiting,Brown-Forman,1,7,2,10,
2025-09-01,Dave Peacock,Advantage Solutions,32,7,1,40,
2025-09-01,Mick Farrell,ResMed,15,23,1,39,
2025-09-01,Kamal Hathi,Splunk,2,4,0,6,
2025-09-01,Todd Kelsey,Plexus,2,8,0,10,
2025-09-01,Phillip D Yeager,Hub Group,3,4,0,7,
2025-09-01,Steven B Hedlund,Lincoln Electric,5,10,0,15,
2025-09-01,Timothy C Oliver,NCR Atleos,0,1,0,1,
2025-09-01,Bruce Fleming,Calumet,2,8,0,10,
2025-09-01,Daniel S. Peyovich,Dycom Industries,1,5,0,6,
2025-09-01,Avner M Applbaum,Valmont Industries,0,8,2,10,
2025-09-01,Kimberly A Fields,ATI inc,5,11,0,16,
2025-09-01,Khozema Z Shipchandler,Twilio,0,2,0,2,
2025-09-01,Gary C Bhojwani,CNO Financial Group,1,6,1,8,
2025-09-01,William Andrew Hendricks Jr,Patterson-UTI Energy,0,0,0,0,
2025-09-01,Kevin D Hochman,Brinker International,1,4,1,6,
2025-09-01,James C Foster,Charles River Laboratories International,2,9,1,12,
2025-09-01,Rajiv K Prasad,Hyster-Yale,2,5,0,7,
2025-09-01,Eric T Steigerwalt,Brighthouse Financial,1,2,0,3,
2025-09-01,Thomas L Ryan,Service Corp International,6,4,0,10,
2025-09-01,Charles M Nifong Jr,CrossAmerica Partners,0,0,0,0,
2025-09-01,Anirudh Devgan,Cadence,9,24,3,36,
2025-09-01,Andi Owen,MillerKnoll,16,15,9,40,
2025-09-01,Sumit Roy,Realty Income,13,18,2,33,
2025-09-01,Timothy John Fitzgerald,Middleby,0,0,0,0,
2025-09-01,Robert H Schottenstein,M/I Homes,3,9,0,12,
2025-09-01,Stephen P MacMillan,Hologic,1,7,0,8,
2025-09-01,Lisa M Barton,Alliant Energy,6,0,0,6,
2025-09-01,Aaron P Jagdfeld,Generac,1,5,1,7,
2025-09-01,Erik Gershwind,MSC Industrial Direct,2,6,2,10,
2025-09-01,Varun Krishna,Rocket Companies,7,31,2,40,
2025-09-01,Fahmi Karam,Upbound Group,4,4,0,8,
2025-09-01,NADominic Ng,East West Bancorp,0,0,0,0,
2025-09-01,Mark Wang,Hilton Grand Vacations,38,2,0,40,
2025-09-01,Robert J Sheedy Jr,Grocery Outlet Holding,0,0,0,0,
2025-09-01,Simon D Campion,Dentsply Sirona,0,3,0,3,
2025-09-01,Jeremy Wensinger,V2X,7,9,0,16,
2025-09-01,Andrew Rees,Crocs,15,15,10,40,
2025-09-01,David M Maura,Spectrum Brands,6,0,1,7,
2025-09-01,Sachin S Lawande,Visteon,0,1,0,1,
2025-09-01,Neil M Ashe,Acuity Inc,0,1,0,1,
2025-09-01,Lorie L Tekorius,Greenbrier,1,9,0,10,
2025-09-01,John R Ciulla,Webster Financial,5,4,0,9,
2025-09-01,Sean D Keohane,Cabot Corporation,3,5,0,8,
2025-09-01,Drew M Wilkerson,RXO inc,0,0,0,0,
2025-09-01,Daniel E Brown,Chord Energy,1,1,0,2,
2025-09-01,Javier D Ferrer Fernandez,Popular inc,0,0,0,0,
2025-09-01,Olivier Rabiller,Garrett Motion inc,4,9,0,13,
2025-09-01,Ronald N Tutor,Tutor Perini Corporation,1,7,1,9,
2025-09-01,Jeff Liaw,Copart,4,5,0,9,
2025-09-01,Aman Narang,Toast inc,5,5,1,11,
2025-09-01,Joseph M Hogan,Align Technology,2,5,0,7,
2025-09-01,Kevin J Wheeler,A O Smith,0,16,1,17,
2025-09-01,Christopher A Cartwright,TransUnion,2,0,1,3,
2025-09-01,James Kelly,NCR Voyix,2,12,1,15,
2025-09-01,Tom Leighton,Akamai Technologies,12,16,6,34,
2025-09-01,Robert G Painter,Trimble,8,2,0,10,
2025-09-01,Tony Helton,Medical Mutual of Ohio,1,4,1,6,
2025-09-01,Caroline S Grace,AMN Healthcare Services,0,0,0,0,
2025-09-01,Patrick Kaltenbach,Mettler-Toledo International,2,7,0,9,
2025-09-01,Michael L Baur,ScanSource,0,3,0,3,
2025-09-01,Jason Lippert,LCI Industries,4,11,0,15,
2025-09-01,Fredric J Tomczyk,Cboe Global Markets,1,6,0,7,
2025-09-01,Octavio Marquez,Diebold Nixdorf,5,11,1,17,
2025-09-01,Sivasankaran Somasundaram,ChampionX,8,1,0,9,
2025-09-01,Ronald F Clarke,Corpay,0,1,0,1,
2025-09-01,Robert W Pittman,iHeartMedia,5,3,0,8,
2025-09-01,Patrick Zalupski,Dream Finders Homes,23,15,2,40,
2025-09-01,Keith E Smith,Boyd Gaming,2,7,1,10,
2025-09-01,Mehran Assadi,NLV Financial,1,1,0,2,
2025-09-01,Barry R Port,Ensign Group,3,5,1,9,
2025-09-01,Denise A Paulonis,Sally Beauty,1,3,0,4,
2025-09-01,Clifford A Skelton,Conduent,0,0,0,0,
2025-09-01,Jean-Michel Ribieras,Sylvamo,2,6,0,8,
2025-09-01,Douglas F Bauer,Tri Pointe Homes,0,4,0,4,
2025-09-01,Shawn O'Connell,EnerSys,3,5,0,8,
2025-09-01,Bill Meury,Incyte,9,16,0,25,
2025-09-01,Dale Francescon,Century Communities,2,8,3,13,
2025-09-01,Michael Nierenberg,Rithm Capital,7,26,1,34,
2025-09-01,Michael J Brown,Euronet Worldwide,2,8,0,10,
2025-09-01,Scott Seu,Hawaiian Electric Industries,4,16,2,22,
2025-09-01,Jason D Robins,DraftKings,5,3,0,8,
2025-09-01,Jonathan J Mazelsky,IDEXX Laboratories,1,2,1,4,
2025-09-01,Richard S Swartz,MYR Group,0,2,0,2,
2025-09-01,Stefano Caroti,Deckers Outdoor,2,6,1,9,
2025-09-01,Kevin R Sayer,DexCom,1,5,0,6,
2025-09-01,John T C Lee,MKS Instruments,4,9,1,14,
2025-09-01,Edward B Pitoniak,VICI Properties,1,6,0,7,
2025-09-01,Albert White III,Cooper Cos,0,0,0,0,
2025-09-01,Barry L Biffle,Frontier Airlines,1,6,6,13,
2025-09-01,Robert A Bruggeworth,Qorvo,5,4,0,9,
2025-09-01,Winnie Park,Five Below,10,27,3,40,
2025-09-01,Steven Oakland,TreeHouse Foods,2,12,0,14,
2025-09-01,James S Hagedorn,Scotts Miracle-Gro,1,1,0,2,
2025-09-01,Michael Cannon-Brookes,Atlassian,18,21,1,40,
2025-09-01,Bertrand Loy,Entegris,3,11,1,15,
2025-09-01,William E Waltz,Atkore,2,7,0,9,
2025-09-01,Celeste B Mastin,H B Fuller,1,4,0,5,
2025-09-01,Kyle T Larkin,Granite Construction,1,6,0,7,
2025-09-01,Michael J Happe,Winnebago Industries,1,4,0,5,
2025-09-01,Steven H Gunby,FTI Consulting,5,11,0,16,
2025-09-01,Stephan B Tanda,AptarGroup,1,3,3,7,
2025-09-01,Timothy P Boyle,Columbia Sportswear,3,3,2,8,
2025-09-01,Anthony J Wood,Roku,5,3,1,9,
2025-09-01,M Christopher Doyle,Civitas Resources,1,2,0,3,
2025-09-01,Andy Eidson,Alpha Metallurgical Resources,1,7,2,10,
2025-09-01,Andy L Nemeth,Patrick Industries,4,1,0,5,
2025-09-01,Roger W Jenkins,Murphy Oil,4,16,0,20,
2025-09-01,Kevin S Blair,Synovus Financial,8,2,0,10,
2025-09-01,Julie Felss Masino,Cracker Barrel Old Country Store,6,16,18,40,
2025-09-01,David M Overton,Cheesecake Factory,1,9,0,10,
2025-09-01,Nick DeIuliis,CNX Resources,9,3,2,14,
2025-09-01,Christopher Pappas,Chefs Warehouse,3,8,1,12,
2025-09-01,Tod Carpenter,Donaldson Company,2,8,0,10,
2025-09-01,Gregory L Christopher,Mueller Industries,2,6,0,8,
2025-09-01,Rob Saltiel,MRC Global,7,12,2,21,
2025-09-01,Jillian C Evanko,Chart Industries,3,6,0,9,
2025-09-01,Dave Guilmette,Alight Solutions,3,7,0,10,
2025-09-01,Joel Smejkal,Vishay Intertechnology,6,3,1,10,
2025-09-01,Dennis Degner,Range Resources,4,6,0,10,
2025-09-01,Ira D Robbins,Valley National Bancorp,1,2,0,3,
2025-09-01,Bernard Kim,Match Group,15,19,6,40,
2025-09-01,Vincent Pilette,Gen Digital,1,13,0,14,
2025-09-01,Timothy S Crane,Wintrust Financial,2,7,0,9,
2025-09-01,Pat Roche,Moog inc,3,9,2,14,
2025-09-01,Mark R Widmar,First Solar,3,5,2,10,
2025-09-01,Niko Lahanas,Central Garden & Pet,2,12,0,14,
2025-09-01,Chris Osowski,Green Plains inc,8,15,1,24,
2025-09-01,Derek J Leathers,Werner Enterprises,1,9,0,10,
2025-09-01,Adam Foroughi,AppLovin,10,26,4,40,
2025-09-01,Luca Savi,ITT,3,5,1,9,
2025-09-01,Lawrence H Silber,Herc Rentals,0,0,0,0,
2025-09-01,Hilton H Howell Jr,Gray Television,7,21,1,29,
2025-09-01,Eric D Ashleman,IDEX,0,8,1,9,
2025-09-01,Owen D Thomas,Boston Properties,3,7,0,10,
2025-09-01,Kurt Wolf,Pitney Bowes,5,19,2,26,
2025-09-01,Sara E Armbruster,Steelcase,2,0,0,2,
2025-09-01,Charles D. Young,Sun Communities,2,5,0,7,
2025-09-01,Suzanne Foster,AdaptHealth,5,7,1,13,
2025-09-01,Grant E Sims,Genesis Energy,4,2,0,6,
2025-09-01,Laura Prieskorn,Jackson Financial,3,4,2,9,
2025-09-01,Rick L Wessel,FirstCash,3,6,1,10,
2025-09-01,Sherman Miller,Cal-Maine Foods,12,27,1,40,
2025-09-01,Paul A Lang,Arch Resources,4,3,1,8,
2025-09-01,Ashish K Khandpur,Avient,2,7,0,9,
2025-09-01,Shyam K Reddy,BlueLinx,1,7,0,8,
2025-09-01,Christopher S Ripley,Sinclair,1,7,0,8,
2025-09-01,Stacy Kymes,BOK Financial,8,7,0,15,
2025-09-01,James H Walter,Permian Resources,0,1,0,1,
2025-09-01,Jason Murray,PACS Group,4,13,2,19,
2025-09-01,Brian Armstrong,Coinbase Global,12,22,6,40,
2025-09-01,Oscar K Brown,Western Midstream Partners,1,3,0,4,
2025-09-01,Nicholas R Lower,Federated Mutual Insurance,0,0,0,0,
2025-09-01,Morris Goldfarb,G-III Apparel Group,11,24,5,40,
2025-09-01,Mark D Morelli,Vontier,0,4,0,4,
2025-09-01,Matthew J Cox,Matson inc,0,6,0,6,
2025-09-01,David W Grzebinski,Kirby Corporation,1,3,0,4,
2025-09-01,Keith A Harvey,Kaiser Aluminum,2,4,2,8,
2025-09-01,Eric Nyman,Vista Outdoor,4,10,1,15,
2025-09-01,Doug Howe,Designer Brands,5,17,0,22,
2025-09-01,Jerry E Gahlhoff Jr,Rollins inc,0,2,0,2,
2025-09-01,D Scott Barbour,Advanced Drainage Systems,3,2,0,5,
2025-09-01,Sean Gamble,Cinemark,17,22,1,40,
2025-09-01,George Kurtz,CrowdStrike,17,21,2,40,
2025-09-01,Bill Ready,Pinterest,25,15,0,40,
2025-09-01,Fidji Simo,Instacart,10,29,1,40,
2025-09-01,Kimberly K Ryan,Hillenbrand,3,5,0,8,
2025-09-01,David S Graziosi,Allison Transmission,2,17,2,21,
2025-09-01,Gary G Friedman,Restoration Hardware,1,4,0,5,
2025-09-01,Lucinda M Baier,Brookdale Senior Living,4,3,0,7,
2025-09-01,Brian J Blaser,QuidelOrtho,1,9,0,10,
2025-09-01,E Jean Savage,Trinity Industries,1,7,1,9,
2025-09-01,Liam J Kelly,Teleflex,1,5,1,7,
2025-09-01,Laurans A Mendelson,HEICO,8,22,2,32,
2025-09-01,Frank H Laukien,Bruker,1,9,0,10,
2025-09-01,Harvey M Schwartz,Carlyle Group,6,13,0,19,
2025-09-01,Mark S LaVigne,Energizer,2,0,0,2,
2025-09-01,Joel Quadracci,Quad/Graphics,9,23,5,37,
2025-09-01,Amar Maletira,Rackspace Technology,4,11,2,17,
2025-09-01,Udit Batra,Waters Corporation,11,23,0,34,
2025-09-01,Eric M Green,West Pharmaceutical Services,1,9,0,10,
2025-09-01,Doug Palladini,Carters inc,2,2,2,6,
2025-09-01,G Mike Mikan,NeueHealth,3,2,0,5,
2025-09-01,Russell ChipChilds,SkyWest,0,0,0,0,
2025-09-01,Christopher H Hunter,Acadia Healthcare,0,1,0,1,
2025-09-01,Prahlad Singh,Revvity,2,7,0,9,
2025-09-01,Maria M Pope,Portland General Electric,1,1,0,2,
2025-09-01,Charles Chip Blankenship,Woodward inc,0,2,0,2,
2025-09-01,Mike Steib,TEGNA,15,19,1,35,
2025-09-01,Kurt J Ekert,Sabre Corporation,0,1,0,1,
2025-09-01,Matt Wilson,Light & Wonder,15,20,5,40,
2025-09-01,Rob Katz,Vail Resorts,3,13,24,40,
2025-09-01,Schnitzer Steel Industries,Radius Recycling,8,23,5,36,
2025-09-01,David A Spector,PennyMac Financial Services,3,0,0,3,
2025-09-01,Frederick J Holzgrefe III,Saia inc,1,1,0,2,
2025-09-01,Mark J Parrell,Equity Residential,4,5,0,9,
2025-09-01,John W Lindsay,Helmerich & Payne,1,5,0,6,
2025-09-01,Gary D Burnison,Korn Ferry,3,14,0,17,
2025-09-01,Timothy J McGrath,PC Connection Inc,3,2,0,5,
2025-09-01,Lynn M Bamford,Curtiss-Wright,13,6,0,19,
2025-09-01,Jonathan W Witter,Sallie Mae,0,1,0,1,
2025-09-01,Jeff Benck,Benchmark Electronics,1,7,0,8,
2025-09-01,Charles H Giancarlo,Pure Storage,0,3,0,3,
2025-09-01,Brian R Gray,Knife River Corporation,0,1,0,1,
2025-09-01,Jay Schmidt,Caleres inc,3,4,2,9,
2025-09-01,Dale Asplund,BrightView Holdings,1,5,0,6,
2025-09-01,Jeffrey S Edwards,Cooper-Standard,0,5,0,5,
2025-09-01,Glenn J Williams,Primerica,6,2,2,10,
2025-09-01,Francois Locoh-Donou,F5,5,19,3,27,
2025-09-01,Joseph Wm Foran,Matador Resources,7,10,0,17,
2025-09-01,Sridhar Ramaswamy,Snowflake inc,12,24,3,39,
2025-09-01,Mark D Dankberg,Viasat,2,5,2,9,
2025-09-01,Francisco J Leon,California Resources,1,3,1,5,
2025-09-01,Peter Stern,Peloton,18,18,4,40,
2025-09-01,David Baszucki,Roblox,10,21,9,40,
2025-09-01,Jeffrey W Edwards,Installed Building Products,1,3,0,4,
2025-09-01,Clark Lauritzen,First National of Nebraska,1,7,0,8,
2025-09-01,Carlos Alberini,Guess inc,13,26,1,40,
2025-09-01,Shyam P Kambeyanda,ESAB,3,4,0,7,
2025-09-01,Edmund Shallcross III,Amica Mutual Insurance,1,5,0,6,
2025-09-01,Benjamin W Schall,AvalonBay Communities,1,7,1,9,
2025-09-01,Allan C Thygesen,DocuSign,4,6,0,10,
2025-09-01,Bryan J Knutson,Titan Machinery,2,1,1,4,
2025-09-01,Heath Sampson,ModivCare,6,2,1,9,
2025-09-01,Ara K Hovnanian,Hovnanian Enterprises,1,18,2,21,
2025-09-01,Joshua G Silverman,Etsy,2,4,0,6,
2025-09-01,Kevin Roycraft,Adams Resources & Energy,7,2,1,10,
2025-09-01,J Eric Evans,Surgery Partners,1,3,0,4,
2025-09-01,Clint E Stein,Columbia Banking System,1,6,0,7,
2025-09-01,Lee M Shavel,Verisk Analytics,3,7,0,10,
2025-09-01,Dave Banyard Jr,MasterBrand,0,0,0,0,
2025-09-01,Peter R Ingram,Hawaiian Airlines inc,1,0,0,1,
2025-09-01,Kristin A Dolan,AMC Networks,3,2,0,5,
2025-09-01,Brendan T Cavanagh,SBA Communications,1,2,0,3,
2025-09-01,George F Chappelle Jr,Americold Realty Trust,1,3,0,4,
2025-09-01,Thomas E Gottwald,NewMarket Corporation,3,7,0,10,
2025-09-01,Thomas J Baltimore Jr,Park Hotels & Resorts,3,30,0,33,
2025-09-01,Peter M Moglia,Alexandria Real Estate Equities,4,6,0,10,
2025-09-01,Ronald J Kramer,Griffon Corporation,1,6,0,7,
2025-09-01,John L Plueger,Air Lease,2,13,0,15,
2025-09-01,Jennifer F Scanlon,UL Solutions,1,5,0,6,
2025-09-01,Greg Smith,Teradyne,2,9,2,13,
2025-09-01,Sean Trauschke,OGE Energy,16,5,0,21,
2025-09-01,Norman D Schwartz,Bio-Rad Laboratories,1,1,1,3,
2025-09-01,Scott Doyle,Spire inc,5,4,1,10,
2025-09-01,Michael E Reed,Gannett,0,4,2,6,
2025-09-01,Cindy J Miller,Stericycle,2,5,2,9,
2025-09-01,Phillip D Green,Cullen Frost Bankers,1,4,2,7,
2025-09-01,Joseph D Margolis,Extra Space Storage,0,8,1,9,
2025-09-01,Mark A Skonieczny,REV Group,7,3,0,10,
2025-09-01,Ladd Wilks,ProFrac Holding,4,3,1,8,
2025-09-01,Sundaram Nagarajan,Nordson,1,10,1,12,
2025-09-01,Anne P Noonan,Summit Materials,0,1,0,1,
2025-09-01,Lori Flees,Valvoline inc,4,4,2,10,
2025-09-01,Scott H Baxter,Kontoor Brands,2,2,0,4,
2025-09-01,Tim Larson,Skyline Champion,6,0,0,6,
2025-09-01,Chuck Divita,Teladoc Health,8,18,5,31,
2025-09-01,W Bradley Southern,Louisiana-Pacific Corporation,0,0,0,0,
2025-09-01,George C Freeman III,Universal Corporation,4,6,0,10,
2025-09-01,James A Brock,Consol Energy,2,0,0,2,
2025-09-01,Robert Antokol,Playtika Holding,1,7,1,9,
2025-09-01,Joe Craft,Alliance Resource Partners,6,10,2,18,
2025-09-01,Paul Keel,Envista,1,7,1,9,
2025-09-01,Jared Isaacman,Shift4 Payments,8,27,5,40,
2025-09-01,Mark Mac McFarland,Talen Energy,4,1,1,6,
2025-09-01,Tony R Thene,Carpenter Technology,3,10,0,13,
2025-09-01,Melissa D Smith,WEX,3,6,0,9,
2025-09-01,James Jim C Ryan III,Old National Bancorp,1,0,0,1,
2025-09-01,Peter J Federico,AGNC Investment,2,0,0,2,
2025-09-01,Brent L Yeagy,Wabash National,0,0,0,0,
2025-09-01,Henry A Fernandez,MSCI,3,15,0,18,
2025-09-01,Mark Penn,Stagwell,13,24,2,39,
2025-09-01,Julie Schertell,Mativ,3,8,0,11,
2025-09-01,Ashish Chand,Belden,3,6,1,10,
2025-09-01,Greg Anderson,Allegiant Travel Company,4,7,0,11,
2025-09-01,Drew Houston,Dropbox,15,19,6,40,
2025-09-01,Kevin T Conroy,Exact Sciences,2,5,2,9,
2025-09-01,Rex D Geveden,BWX Technologies,4,7,0,11,
2025-09-01,Scott R Wells,Clear Channel Outdoor Hldgs,0,0,0,0,
2025-09-01,Paul Bay,Ingram Micro,11,24,5,40,
2025-09-02,Doug McMillon,Walmart,16,19,5,40,
2025-09-02,Andrew Jassy,Amazon,4,31,5,40,
2025-09-02,Tim Cook,Apple,13,22,5,40,
2025-09-02,Stephen Hemsley,UnitedHealth,9,25,6,40,
2025-09-02,Warren Buffett,Berkshire Hathaway,11,23,6,40,
2025-09-02,David Joyner,CVS Health,7,28,5,40,
2025-09-02,Darren Woods,Exxon Mobil,12,21,6,39,
2025-09-02,Sundar Pichai,Alphabet,15,18,7,40,
2025-09-02,Brian Tyler,McKesson,4,16,5,25,
2025-09-02,Robert Mauch,Cencora,3,7,0,10,
2025-09-02,Ron Vachris,Costco,5,33,2,40,
2025-09-02,Jamie Dimon,JPMorgan Chase,10,16,14,40,
2025-09-02,Satya Nadella,Microsoft,13,18,9,40,
2025-09-02,Jason Hollar,Cardinal Health,14,21,5,40,
2025-09-02,Mike Wirth,Chevron,17,17,6,40,
2025-09-02,David Cordani,Cigna,21,15,4,40,
2025-09-02,Jim Farley,Ford Motor,15,20,5,40,
2025-09-02,Brian Moynihan,Bank of America,4,30,6,40,
2025-09-02,Mary Barra,General Motors,14,22,4,40,
2025-09-02,Gail Boudreaux,Elevance Health,15,18,7,40,
2025-09-02,Jane Fraser,Citigroup,14,21,5,40,
2025-09-02,Sarah London,Centene,14,17,9,40,
2025-09-02,Ted Decker,Home Depot,11,24,5,40,
2025-09-02,Maryann Mannen,Marathon Petroleum,5,13,1,19,
2025-09-02,Ron Sargent,Kroger,5,22,13,40,
2025-09-02,Mark Lashier,Phillips 66,11,20,7,38,
2025-09-02,Priscilla Almodovar,Fannie Mae,11,17,12,40,
2025-09-02,Tim Wentworth,Walgreens,7,24,9,40,
2025-09-02,Lane Riggs,Valero Energy,13,8,0,21,
2025-09-02,Mark Zuckerberg,Meta,9,18,13,40,
2025-09-02,Hans Vestberg,Verizon,15,21,4,40,
2025-09-02,John Stankey,AT&T,11,24,5,40,
2025-09-02,Brian Roberts,Comcast,10,28,2,40,
2025-09-02,Charles Scharf,Wells Fargo,29,6,5,40,
2025-09-02,David Solomon,Goldman Sachs,8,22,10,40,
2025-09-02,Michael Hutchins,Freddie Mac,3,10,3,16,
2025-09-02,Michael Fiddelke,Target,11,21,8,40,
2025-09-02,Jim Rechtin,Humana,17,18,5,40,
2025-09-02,Jon Farney,State Farm Insurance,1,13,3,17,
2025-09-02,Elon Musk,Tesla,9,13,18,40,
2025-09-02,Ted Pick,Morgan Stanley,14,23,3,40,
2025-09-02,Joaquin Duato,Johnson & Johnson,9,26,5,40,
2025-09-02,Juan Luciano,Archer Daniels Midland,3,20,15,38,
2025-09-02,Ramon Laguarta,PepsiCo,7,28,5,40,
2025-09-02,Carol Tom√©,UPS,10,19,11,40,
2025-09-02,Rajesh Subramaniam,FedEx,9,29,0,38,
2025-09-02,Bob Iger,Walt Disney,9,29,2,40,
2025-09-02,Michael Dell,Dell Technologies,12,23,5,40,
2025-09-02,Marvin Ellison,Lowes,13,24,2,39,
2025-09-02,Jon Moeller,Procter & Gamble,5,29,6,40,
2025-09-02,Thomas Long,Energy Transfer,8,0,2,10,
2025-09-02,Kelly Ortberg,Boeing,11,26,3,40,
2025-09-02,Susan Morris,Albertsons,14,24,2,40,
2025-09-02,Kevin Hourican,Sysco,9,27,4,40,
2025-09-02,Christopher Calio,RTX,7,12,0,19,
2025-09-02,Larry Culp,General Electric,11,26,3,40,
2025-09-02,James Taiclet,Lockheed Martin,13,18,9,40,
2025-09-02,Stephen Squeri,American Express,15,23,2,40,
2025-09-02,Joe Creed,Caterpillar,11,27,2,40,
2025-09-02,Michel Khalaf,MetLife,12,18,1,31,
2025-09-02,Samuel Hazen,HCA Healthcare,8,7,0,15,
2025-09-02,Tricia Griffith,Progressive Insurance,9,26,5,40,
2025-09-02,Arvind Krishna,IBM,14,22,4,40,
2025-09-02,John May,Deere,8,27,5,40,
2025-09-02,Jensen Huang,Nvidia,8,28,4,40,
2025-09-02,Philip Smith,StoneX,0,8,1,9,
2025-09-02,Robert M Davis,Merck,4,19,0,23,
2025-09-02,Ryan Lance,ConocoPhillips,17,20,3,40,
2025-09-02,Albert Bourla,Pfizer,18,13,9,40,
2025-09-02,Ed Bastian,Delta Air Lines,10,21,9,40,
2025-09-02,Patrick Zammit,TD Synnex,10,14,0,24,
2025-09-02,Kevin Murphy,Publix Super Markets,10,22,1,33,
2025-09-02,Thomas J Wilson,Allstate,0,9,1,10,
2025-09-02,Chuck Robbins,Cisco Systems,14,23,3,40,
2025-09-02,Kirt Walker,Nationwide,15,18,2,35,
2025-09-02,Christopher Winfrey,Charter Communications,5,16,5,26,
2025-09-02,Bob Michael,AbbVie,0,0,0,0,
2025-09-02,Craig DeSanto,New York Life Insurance,3,16,0,19,
2025-09-02,Lip-Bu Tan,Intel,8,14,18,40,
2025-09-02,Ernie Herrman,TJX,14,24,2,40,
2025-09-02,Andrew Sullivan,Prudential Financial,11,20,0,31,
2025-09-02,Enrique Lores,Hewlett Packard,11,15,8,34,
2025-09-02,Scott Kirby,United Airlines,35,3,2,40,
2025-09-02,George Holm,Performance Food,11,21,2,34,
2025-09-02,Donnie King,Tyson Foods,9,26,5,40,
2025-09-02,Robert Isom,American Airlines,7,25,8,40,
2025-09-02,Timothy M Sweeney,Liberty Mutual Insurance,12,0,0,12,
2025-09-02,Elliott Hill,Nike,7,31,2,40,
2025-09-02,Safra Catz,Oracle,10,23,7,40,
2025-09-02,AJ Jim Teague,Enterprise Products Partners,6,10,0,16,
2025-09-02,Richard Fairbank,Capital One,14,23,3,40,
2025-09-02,Wilfred Chiang,Plains GP,1,1,0,2,
2025-09-02,Michael Kasbar,World Kinect,2,9,0,11,
2025-09-02,Peter Zaffino,American International Group,9,27,4,40,
2025-09-02,James Quincey,The Coca-Cola Company,10,28,2,40,
2025-09-02,Thasunda Brown Duckett,TIAA,19,21,0,40,
2025-09-02,Jay Debertin,CHS,4,11,3,18,
2025-09-02,Chris Boerner,Bristol-Myers Squibb,10,24,6,40,
2025-09-02,Corie Barry,Best Buy,39,1,0,40,
2025-09-02,Marc Casper,Thermo Fisher Scientific,11,26,3,40,
2025-09-02,Roger Crandall,Mass Mutual,3,7,0,10,
2025-09-02,Juan Andrade,USAA,5,16,0,21,
2025-09-02,Phebe Novakovic,General Dynamics,29,7,4,40,
2025-09-02,Alan Schnitzer,Travelers Insurance,3,5,2,10,
2025-09-02,David Zaslav,Warner Bros Discovery,4,24,12,40,
2025-09-02,Gunjan Kedia,US Bancorp,13,25,2,40,
2025-09-02,Robert Ford,Abbott Laboratories,11,23,6,40,
2025-09-02,Kathy Warden,Northrop Grumman,13,22,5,40,
2025-09-02,Tim Gerend,Northwestern Mutual,13,26,1,40,
2025-09-02,Todd Vasos,Dollar General,7,23,10,40,
2025-09-02,Matthew Lucey,PBF Energy,6,3,0,9,
2025-09-02,Dara Khosrowshahi,Uber,13,20,7,40,
2025-09-02,Vimal Kapur,Honeywell,11,29,0,40,
2025-09-02,Dirk Van de Put,Mondelez,11,26,3,40,
2025-09-02,Brian Niccol,Starbucks,12,28,0,40,
2025-09-02,Cristiano Amon,Qualcomm,13,26,1,40,
2025-09-02,Hock Tan,Broadcom,10,26,4,40,
2025-09-02,David Flitman,US Foods,2,7,0,9,
2025-09-02,Paul Romanowski,DR Horton,5,14,5,24,
2025-09-02,Jacek Olczak,Philip Morris,14,23,3,40,
2025-09-02,Preston Feight,Paccar,5,25,1,31,
2025-09-02,Marc Benioff,Salesforce,6,20,14,40,
2025-09-02,Leon Topalian,Nucor,15,22,3,40,
2025-09-02,Michael Dastoor,Jabil,1,9,0,10,
2025-09-02,Jonathan Jaffe,Lennar,1,8,1,10,
2025-09-02,David Ricks,Eli Lilly,9,20,11,40,
2025-09-02,Joe Zubretsky,Molina Healthcare,6,7,4,17,
2025-09-02,Jennifer Rumsey,Cummins,8,26,6,40,
2025-09-02,Robin Vince,Bank of New York Mellon,20,18,2,40,
2025-09-02,Ted Sarandos,Netflix,14,24,2,40,
2025-09-02,William H Rogers Jr,Truist Financial,2,6,1,9,
2025-09-02,Sean Kerins,Arrow Electronics,2,12,0,14,
2025-09-02,William M Brown,3M,2,8,0,10,
2025-09-02,Ryan McInerney,Visa,15,19,6,40,
2025-09-02,Marc Rowan,Apollo Global Management,17,19,4,40,
2025-09-02,Tim Go,HF Sinclair,6,2,0,8,
2025-09-02,Robert Sulentic,CBRE Group,1,8,1,10,
2025-09-02,William Demchak,PNC Financial Services,15,20,5,40,
2025-09-02,Bryan DeBoer,Lithia Motors,12,26,1,39,
2025-09-02,William Nash,CarMax,4,3,2,9,
2025-09-02,Brian Robbins,Paramount Global,3,32,2,37,
2025-09-02,Michael Creedon,Dollar Tree,3,34,3,40,
2025-09-02,Sandy Douglas,United Natural Foods,33,5,2,40,
2025-09-02,Alex Chriss,PayPal,14,23,3,40,
2025-09-02,Roger Penske,Penske Automotive,18,21,1,40,
2025-09-02,Antonio Neri,Hewlett Packard Enterprise,8,24,8,40,
2025-09-02,Harry Sideris,Duke Energy,35,5,0,40,
2025-09-02,Vicki Hollub,Occidental Petroleum,20,15,4,39,
2025-09-02,Lawrence Coben,NRG Energy,5,2,0,7,
2025-09-02,Robert Bradway,Amgen,9,29,2,40,
2025-09-02,John Ketchum,NextEra Energy,23,17,0,40,
2025-09-02,Rainer Blair,Danaher,7,16,2,25,
2025-09-02,Daniel O'Day,Gilead Sciences,19,17,4,40,
2025-09-02,Michael Manley,AutoNation,3,5,2,10,
2025-09-02,Carlos Abrams-Rivera,Kraft Heinz,16,18,6,40,
2025-09-02,Philip Gallagher,Avnet,1,7,1,9,
2025-09-02,Gary Dickerson,Applied Materials,7,22,11,40,
2025-09-02,Bob Jordan,Southwest Airlines,10,23,7,40,
2025-09-02,Rick Wurster,Charles Schwab,14,21,4,39,
2025-09-02,Lorenzo Simonelli,Baker Hughes,15,21,4,40,
2025-09-02,Chris Kempczinski,McDonalds,9,24,7,40,
2025-09-02,Christopher Womack,Southern Company,3,7,0,10,
2025-09-02,Michael Miebach,Mastercard,12,24,4,40,
2025-09-02,Joseph Dominguez,Constellation Energy,12,10,1,23,
2025-09-02,Christopher Swift,The Hartford,15,22,3,40,
2025-09-02,Patricia Poppe,PG&E,10,18,2,30,
2025-09-02,Bom Kim,Coupang,12,27,1,40,
2025-09-02,Ezra Yacob,EOG Resources,21,12,3,36,
2025-09-02,Jim Vena,Union Pacific,19,21,0,40,
2025-09-02,Matt Schroeder,Rite Aid,4,33,3,40,
2025-09-02,Tony Spring,Macys,10,27,3,40,
2025-09-02,Anthony Capuano,Marriott International,14,24,2,40,
2025-09-02,Raymond E Scott,Lear Corporation,6,4,0,10,
2025-09-02,William Stengel II,Genuine Parts,0,2,0,2,
2025-09-02,Heidi Petz,Sherwin-Williams,9,27,3,39,
2025-09-02,Jeff Miller,Halliburton,13,22,5,40,
2025-09-02,Kathleen Quirk,Freeport-McMoRan,14,17,2,33,
2025-09-02,Michael Rapino,Live Nation Entertainment,14,23,3,40,
2025-09-02,John Doyle,Marsh & McLennan,10,8,0,18,
2025-09-02,Lisa Su,Advanced Micro Devices,16,20,4,40,
2025-09-02,Frank Holding,First Citizens BancShares,9,14,2,25,
2025-09-02,John Engel,WESCO International,5,11,1,17,
2025-09-02,David Gitlin,Carrier Global,14,24,2,40,
2025-09-02,Lourenco Goncalves,Cleveland-Cliffs,8,21,11,40,
2025-09-02,Calvin G Butler Jr,Exelon,5,4,0,9,
2025-09-02,Joseph Bae,KKR,20,18,2,40,
2025-09-02,Christine Leahy,CDW,0,11,2,13,
2025-09-02,Glenn Fogel,Booking Holdings,9,25,6,40,
2025-09-02,Brian Doubles,Synchrony Financial,5,7,2,14,
2025-09-02,Earl Austin,Quanta Services,2,7,1,10,
2025-09-02,Christian Ulbrich,Jones Lang LaSalle,8,21,0,29,
2025-09-02,Saumya Sutaria,Tenet Healthcare,5,3,1,9,
2025-09-02,William Gifford,Altria,3,4,2,9,
2025-09-02,Kevin Lobo,Stryker,11,26,3,40,
2025-09-02,Michael Hsu,Kimberly-Clark,6,6,1,13,
2025-09-02,Jack Fusco,Cheniere Energy,18,19,3,40,
2025-09-02,James Conroy,Ross Stores,4,11,0,15,
2025-09-02,Anthony Smurfit,Smurfit Westrock,2,7,0,9,
2025-09-02,Jeffrey Harmening,General Mills,4,18,4,26,
2025-09-02,Mark Stewart,Goodyear Tire & Rubber,5,33,2,40,
2025-09-02,Bob Eddy,BJs Wholesale Club,4,20,3,27,
2025-09-02,Peter Arduini,GE HealthCare Technologies,5,12,0,17,
2025-09-02,Noel Wallace,Colgate-Palmolive,10,25,2,37,
2025-09-02,Marc Bitzer,Whirlpool,11,13,16,40,
2025-09-02,Chris Kubasik,L3Harris Technologies,8,13,1,22,
2025-09-02,Shantanu Narayen,Adobe,20,19,1,40,
2025-09-02,Thomas Polen,Becton Dickinson,6,4,0,10,
2025-09-02,Richard P Dealy,Pioneer Natural Resources,5,1,0,6,
2025-09-02,Ravi Kumar S,Cognizant Technology Solutions,11,23,3,37,
2025-09-02,Andrew Clyde,Murphy USA,13,25,2,40,
2025-09-02,Mike Lyons,Fiserv,4,11,1,16,
2025-09-02,Jennifer Parmentier,Parker-Hannifin,2,10,0,12,
2025-09-02,William Fehrman,American Electric Power,4,5,0,9,
2025-09-02,Andrew Silvernail,International Paper,5,21,0,26,
2025-09-02,Jonas Prising,ManpowerGroup,7,22,1,30,
2025-09-02,John Zillmer,Aramark,6,14,2,22,
2025-09-02,Mark Millett,Steel Dynamics,19,2,0,21,
2025-09-02,Dan Amos,Aflac,14,19,7,40,
2025-09-02,Tony Cheng,Reinsurance Group of America,2,11,2,15,
2025-09-02,Karsanbhai,Emerson Electric,10,14,3,27,
2025-09-02,Ronald P O'Hanley,State Street,6,15,0,21,
2025-09-02,Timothy Knavish,PPG Industries,1,3,1,5,
2025-09-02,David Burritt,United States Steel,8,18,13,39,
2025-09-02,Maria Black,Automatic Data Processing,4,5,0,9,
2025-09-02,Daryl Kenningham,Group 1 Automotive,10,27,3,40,
2025-09-02,Robert Blue,Dominion Energy,29,10,1,40,
2025-09-02,Larry Fink,BlackRock,9,23,8,40,
2025-09-02,Pierce Norton II,Oneok,4,4,1,9,
2025-09-02,David Bozeman,CH Robinson Worldwide,2,7,0,9,
2025-09-02,Haviv Ilan,Texas Instruments,12,25,3,40,
2025-09-02,Michael Bender,Kohls,1,27,12,40,
2025-09-02,Philip Daniele III,AutoZone,0,2,0,2,
2025-09-02,Timothy Archer,Lam Research,2,8,0,10,
2025-09-02,Charles Magro,Corteva,5,2,1,8,
2025-09-02,Rick Lanoha,Peter Kiewit Sons',0,2,0,2,
2025-09-02,Peter Jackson,Builders FirstSource,5,11,1,17,
2025-09-02,Martin Schroeter,Kyndryl,11,27,1,39,
2025-09-02,Hamid Akhavan,EchoStar,4,27,9,40,
2025-09-02,Bill Westrate,American Family Insurance,9,16,2,27,
2025-09-02,Avigal Soreq,Delek US,3,8,5,16,
2025-09-02,Beth Ford,Land O'Lakes,18,21,1,40,
2025-09-02,Walker Martin,Sempra,0,3,0,3,
2025-09-02,Eric Slifka,Global Partners,12,23,5,40,
2025-09-02,DG Macpherson,WW Grainger,2,7,1,10,
2025-09-02,Bob Pragada,Jacobs Solutions,6,8,0,14,
2025-09-02,Pedro Pizarro,Edison International,15,8,17,40,
2025-09-02,William Hornbuckle,MGM Resorts International,6,23,1,30,
2025-09-02,Andrew McMahon,Guardian Life insurance,6,12,0,18,
2025-09-02,Christopher O'Herlihy,Illinois Tool Works,2,6,2,10,
2025-09-02,James Cracchiolo,Ameriprise Financial,2,22,2,26,
2025-09-02,Ryan Marshall,PulteGroup,11,13,11,35,
2025-09-02,Matthew Meloy,Targa Resources,5,5,0,10,
2025-09-02,Michael Rhodes,Ally Financial,11,23,5,39,
2025-09-02,Joseph Fadool,BorgWarner,4,10,0,14,
2025-09-02,St√©phane de La Faverie,Est√©e Lauder,9,26,5,40,
2025-09-02,Benjamin Tisch,Loews,2,7,0,9,
2025-09-02,Brad Beckham,O'Reilly Automotive,4,16,1,21,
2025-09-02,Thomas Gayner,Markel Group,2,8,0,10,
2025-09-02,Donald Allan,Stanley Black & Decker,7,32,1,40,
2025-09-02,Sanjay Mehrotra,Micron Technology,17,21,2,40,
2025-09-02,James Breuer,Fluor,1,2,1,4,
2025-09-02,Thomas Bell,Leidos,9,19,2,30,
2025-09-02,Scott Smith,Viatris,5,4,0,9,
2025-09-02,Kimberly Dang,Kinder Morgan,11,1,0,12,
2025-09-02,Christophe Beck,Ecolab,19,21,0,40,
2025-09-02,Brent Shafer,Baxter International,1,10,0,11,
2025-09-02,Clay Gaspar,Devon Energy,20,4,0,24,
2025-09-02,Steven Cahillane,Kellanova,2,7,0,9,
2025-09-02,Raul Nicholas Vargas Ochoa,Farmers Insurance Exchange,0,0,0,0,
2025-09-02,Darren Rebelez,Caseys General Stores,3,6,0,9,
2025-09-02,Ari Bousbib,IQVIA,6,15,2,23,
2025-09-02,Jon Vander Ark,Republic Services,11,18,11,40,
2025-09-02,Timothy Cofer,Keurig Dr Pepper,2,4,1,7,
2025-09-02,Karla Lewis,Reliance Inc,2,7,0,9,
2025-09-02,David Hult,Asbury Automotive Group,8,31,1,40,
2025-09-02,Darryl Button,Pacific Life,1,7,0,8,
2025-09-02,James Burke,Vistra,6,3,1,10,
2025-09-02,John Barrett,Western & Southern Financial,11,27,2,40,
2025-09-02,William Krueger,The Andersons Inc,0,2,0,2,
2025-09-02,Erik Nordstrom,Nordstrom,6,28,5,39,
2025-09-02,John Wren,Omnicom Group,15,19,6,40,
2025-09-02,Stephanie Ferris,Fidelity National Information Services,15,22,3,40,
2025-09-02,Timothy Cawley,Consolidated Edison,4,6,0,10,
2025-09-02,Joseph Hinrichs,CSX,7,11,1,19,
2025-09-02,Troy Rudd,AECOM,8,23,4,35,
2025-09-02,Kathleen Johnson,Lumen Technologies,3,5,1,9,
2025-09-02,Harry Lawton III,Tractor Supply,1,1,0,2,
2025-09-02,Raul Fernandez,DXC Technology,4,34,1,39,
2025-09-02,Eric Hansotia,AGCO,16,18,1,35,
2025-09-02,David Bruton Smith,Sonic Automotive,5,8,9,22,
2025-09-02,Sasan Goodarzi,Intuit,11,25,4,40,
2025-09-02,Matthew Flannery,United Rentals,32,2,0,34,
2025-09-02,Marc Miller,Universal Health Services,4,21,3,28,
2025-09-02,Michael Mahoney,Boston Scientific,13,27,0,40,
2025-09-02,Judith Marks,Otis Worldwide,3,3,0,6,
2025-09-02,Robert Frenzel,Xcel Energy,4,2,2,8,
2025-09-02,Penny Pennington,Edward Jones,8,26,6,40,
2025-09-02,Daniel Fisher,Ball,1,20,5,26,
2025-09-02,Justin Jude,LKQ,4,6,1,11,
2025-09-02,James Blackledge,Mutual of Omaha,3,32,2,37,
2025-09-02,Bruce Bodine,Mosaic,3,7,0,10,
2025-09-02,Scott Donnelly,Textron,7,23,2,32,
2025-09-02,Adam Schechter,Labcorp Holdings,3,6,0,9,
2025-09-02,Deanna Strable-Soethout,Principal Financial,1,6,0,7,
2025-09-02,Leonard Schleifer,Regeneron Pharmaceuticals,6,27,7,40,
2025-09-02,Paul Shoukry,Raymond James Financial,15,24,1,40,
2025-09-02,Lauren Hobart,Dicks Sporting Goods,12,23,4,39,
2025-09-02,Jamie Whisnant,Auto-Owners Insurance,0,2,0,2,
2025-09-02,Ariane Gorin,Expedia,9,30,1,40,
2025-09-02,Shelley Simpson,JB Hunt Transport Services,9,28,3,40,
2025-09-02,Ren√© Jones,M&T Bank,13,24,3,40,
2025-09-02,Gerardo Norcia,DTE Energy,5,4,0,9,
2025-09-02,Andr√©s Gluski,AES,17,20,0,37,
2025-09-02,Timothy Spence,Fifth Third Bancorp,5,4,1,10,
2025-09-02,Eduardo Menezes,Air Products & Chemicals,4,4,2,10,
2025-09-02,Wendell Weeks,Corning,15,23,2,40,
2025-09-02,Anthony Guzzi,EMCOR Group,4,3,1,8,
2025-09-02,Adam Norwitt,Amphenol,3,18,0,21,
2025-09-02,Jean-Marc Gilson,Westlake Corporation,2,5,0,7,
2025-09-02,Lori Koch,DuPont,7,18,0,25,
2025-09-02,Derek Chang,Liberty Media,37,3,0,40,
2025-09-02,Martina Cheung,S&P Global,11,26,0,37,
2025-09-02,Tim Hingtgen,Community Health Systems,11,27,2,40,
2025-09-02,Brian Tierney,FirstEnergy,6,22,3,31,
2025-09-02,Rick McKenney,Unum Group,5,4,0,9,
2025-09-02,Stanley Bergman,Henry Schein,11,28,1,40,
2025-09-02,Tiang Yew Tan,Western Digital,0,0,0,0,
2025-09-02,Vincent Roche,Analog Devices,13,20,3,36,
2025-09-02,Sean Connolly,Conagra Brands,6,32,2,40,
2025-09-02,Bruce Van Saun,Citizens Financial Group,13,27,0,40,
2025-09-02,Mark George,Norfolk Southern,18,19,3,40,
2025-09-02,Andrew Marsh,Entergy,4,4,0,8,
2025-09-02,Robert Berkley,WR Berkley,9,28,3,40,
2025-09-02,Javier Rodriguez,DaVita,14,14,1,29,
2025-09-02,Michael O'Grady,Northern Trust,26,5,0,31,
2025-09-02,James Snee,Hormel Foods,3,27,1,31,
2025-09-02,Timothy J Donahue,Crown Holdings,1,9,0,10,
2025-09-02,Joseph Ferraro,Avis Budget,3,6,1,10,
2025-09-02,Niraj Shah,Wayfair,8,24,8,40,
2025-09-02,Jos√© Mas,MasTec,7,14,0,21,
2025-09-02,Joseph Nolan,Eversource Energy,5,3,1,9,
2025-09-02,Thomas Palmer,Newmont,5,5,0,10,
2025-09-02,Robert Sanchez,Ryder System,11,9,1,21,
2025-09-02,Michael Nolan,Fidelity National Financial,3,0,0,3,
2025-09-02,Gavin Hattersley,Molson Coors Beverage,5,30,5,40,
2025-09-02,Thomas Reeg,Caesars Entertainment,6,5,0,11,
2025-09-02,Ellen Cooper,Lincoln National,3,7,0,10,
2025-09-02,Bracken Darrell,VF Corporation,8,29,3,40,
2025-09-02,Erik Fyrwald,International Flavors & Fragrances,7,7,2,16,
2025-09-02,Christopher Kastner,Huntington Ingalls Industries,3,5,0,8,
2025-09-02,Shane O'Kelly,Advance Auto Parts,13,23,4,40,
2025-09-02,Ralph LaRossa,Public Service Enterprise Group,10,18,0,28,
2025-09-02,Kecia Steelman,Ulta Beauty,33,4,3,40,
2025-09-02,Michele Buck,Hershey,7,31,2,40,
2025-09-02,Sumit Singh,Chewy,12,22,6,40,
2025-09-02,Steven Vondran,American Tower,4,6,0,10,
2025-09-02,Jeffrey Lorberbaum,Mohawk Industries,11,6,1,18,
2025-09-02,Keith Demmings,Assurant,3,7,0,10,
2025-09-02,Robert Martin,Thor Industries,3,6,1,10,
2025-09-02,Kathleen Mazzarella,Graybar Electric,1,7,2,10,
2025-09-02,Joey Wat,Yum China,13,25,2,40,
2025-09-02,Scott Richardson,Celanese,9,27,4,40,
2025-09-02,David Rawlinson II,QVC,7,16,2,25,
2025-09-02,Alan Armstrong,Williams,22,15,3,40,
2025-09-02,Philippe Krakowsky,Interpublic Group,13,25,2,40,
2025-09-02,Brendan McCracken,Ovintiv,6,5,0,11,
2025-09-02,Andrew Teno,Icahn Enterprises,5,6,0,11,
2025-09-02,Stephen Steinour,Huntington Bancshares,1,9,0,10,
2025-09-02,Timothy NeCastro,Erie Insurance,3,6,1,10,
2025-09-02,Ernest Garcia III,Carvana,21,15,4,40,
2025-09-02,R Bruce McDonald,Dana Incorporated,3,7,1,11,
2025-09-02,William Oplinger,Alcoa Corporation,2,6,1,9,
2025-09-02,Mark Pearson,Equitable,7,8,0,15,
2025-09-02,Richard Wallace,KLA,4,6,0,10,
2025-09-02,Ricardo Cardenas,Darden Restaurants,4,3,1,8,
2025-09-02,Mikael Bratt,Autoliv,6,7,2,15,
2025-09-02,Benito Minicucci,Alaska Air,3,4,1,8,
2025-09-02,Christopher Gorman,KeyCorp,5,5,0,10,
2025-09-02,Robert Goldstein,Las Vegas Sands,5,30,5,40,
2025-09-02,Edward Pesicka,Owens & Minor,3,33,2,38,
2025-09-02,Christopher Nassetta,Hilton Worldwide,8,16,2,26,
2025-09-02,Jamie Iannone,Ebay,20,16,4,40,
2025-09-02,Patrick Gallagher,Arthur J Gallagher,8,30,2,40,
2025-09-02,Rich Steinmeier,LPL Financial,24,14,2,40,
2025-09-02,Stephen Spray,Cincinnati Financial,2,6,2,10,
2025-09-02,Douglas Yearley,Toll Brothers,10,24,6,40,
2025-09-02,Gregory Brown,Motorola Solutions,2,8,0,10,
2025-09-02,Brian Chesky,Airbnb,3,30,7,40,
2025-09-02,Jeffrey Sprecher,Intercontinental Exchange,14,24,2,40,
2025-09-02,Robert Thomson,News Corp,7,29,4,40,
2025-09-02,Scott Boatwright,Chipotle Mexican Grill,8,28,4,40,
2025-09-02,Reshma Kewalramani,Vertex Pharmaceuticals,22,13,5,40,
2025-09-02,Christopher Viehbacher,Biogen,0,27,2,29,
2025-09-02,Malcolm Wilson,GXO Logistics,7,20,0,27,
2025-09-02,Tony Sarsam,SpartanNash,16,22,2,40,
2025-09-02,Michael O‚ÄôSullivan,Burlington Stores,8,28,4,40,
2025-09-02,Teresa Rasmussen,Thrivent Financial for Lutherans,4,0,0,4,
2025-09-02,Eugene Bredow,NVR,0,4,0,4,
2025-09-02,Brian Chambers,Owens Corning,3,11,0,14,
2025-09-02,Rafael Santana,Westinghouse Air Brake Technologies,3,7,1,11,
2025-09-02,John Pfeifer,Oshkosh,5,24,4,33,
2025-09-02,Cameron Bready,Global Payments,8,30,2,40,
2025-09-02,Calvin McDonald,Lululemon athletica,8,31,1,40,
2025-09-02,J Kent Masters,Albemarle Corporation,3,6,0,9,
2025-09-02,Joanna Geraghty,JetBlue Airways,15,20,5,40,
2025-09-02,Robert Steer,Seaboard,1,4,0,5,
2025-09-02,William Newlands,Constellation Brands,0,2,2,4,
2025-09-02,Michael Doss,Graphic Packaging,3,9,1,13,
2025-09-02,Gil West,Hertz,7,23,10,40,
2025-09-02,Malcolm C Roberts,FM Global,2,9,2,13,
2025-09-02,Mick Beekhuizen,Campbell Soup,8,23,1,32,
2025-09-02,Daniel Wall,Expeditors International of Washington,3,4,0,7,
2025-09-02,Gregory Roberts,A-Mark Precious Metals,1,4,1,6,
2025-09-02,Horacio Rozanski,Booz Allen Hamilton,15,20,5,40,
2025-09-02,James Davis,Quest Diagnostics,5,5,0,10,
2025-09-02,Dennis Mathew,Altice,5,28,7,40,
2025-09-02,Stefan Larsson,PVH,11,24,5,40,
2025-09-02,Mark Costa,Eastman Chemical,5,16,4,25,
2025-09-02,Joyce Mullen,Insight Enterprises,6,9,1,16,
2025-09-02,John Turner,Regions Financial,19,19,2,40,
2025-09-02,Julian G Francis,Beacon Roofing Supply,0,1,0,1,
2025-09-02,Blake Moret,Rockwell Automation,10,28,2,40,
2025-09-02,Mike Speetzen,Polaris Inc,2,16,2,20,
2025-09-02,William McDermott,ServiceNow,3,6,0,9,
2025-09-02,Jure Sola,Sanmina,3,11,0,14,
2025-09-02,Bob Flexon,UGI Utilities Inc,0,1,0,1,
2025-09-02,Scott Lauber,WEC Energy,14,6,0,20,
2025-09-02,Jon Rousseau,BrightSpring Health Services,20,20,0,40,
2025-09-02,Todd Schneider,Cintas,13,17,2,32,
2025-09-02,Peter Matt,Commercial Metals,5,4,0,9,
2025-09-02,Robert D Lawler,Continental Resources,1,0,0,1,
2025-09-02,Domenic Dell‚ÄôOsso Jr,Expand Energy,4,0,0,4,
2025-09-02,Jason P Wells,CenterPoint Energy,9,3,1,13,
2025-09-02,H Michael Krimbill,NGL Energy Partners,5,3,0,8,
2025-09-02,Tony Xu,DoorDash,14,18,8,40,
2025-09-02,Clay Williams,NOV,8,19,5,32,
2025-09-02,Kristin Peck,Zoetis,12,20,1,33,
2025-09-02,Mark Smucker,JM Smucker,11,23,6,40,
2025-09-02,Steve Sanghi,Microchip Technology,7,28,5,40,
2025-09-02,Richard Tobin,Dover Corporation,5,3,0,8,
2025-09-02,Kaes Van‚Äôt Hof,Diamondback Energy,23,14,2,39,
2025-09-02,Deon Stander,Avery Dennison,0,13,0,13,
2025-09-02,Vincent Sorgi,PPL,8,10,1,19,
2025-09-02,Hassane El-Khoury,ON Semiconductor,2,18,4,24,
2025-09-02,Arie Kotler,ARKO,5,22,1,28,
2025-09-02,William Monteleone,Par Pacific,1,7,2,10,
2025-09-02,John Christmann IV,APA,6,4,0,10,
2025-09-02,Adaire Fox-Martin,Equinix,17,19,4,40,
2025-09-02,Joseph M Otting,Flagstar Financial,2,6,2,10,
2025-09-02,Mary Dillon,Foot Locker,10,24,6,40,
2025-09-02,James Zallie,Ingredion,3,6,1,10,
2025-09-02,Christopher Peterson,Newell Brands,0,9,1,10,
2025-09-02,Scott Salmirs,ABM Industries,7,8,1,16,
2025-09-02,Christopher Hilger,Securian Financial,0,8,1,9,
2025-09-02,Hamid Moghadam,Prologis,8,26,6,40,
2025-09-02,Stephen Schwarzman,Blackstone,14,21,5,40,
2025-09-02,Robert Greenberg,Skechers USA,6,23,3,32,
2025-09-02,Keith Allman,Masco,4,9,1,14,
2025-09-02,Rusty Rush,Rush Enterprises,14,23,3,40,
2025-09-02,Jennifer Johnson,Franklin Resources,1,7,2,10,
2025-09-02,Gerry P Smith,ODP Business Solutions,0,0,0,0,
2025-09-02,Carl Lindner lll,American Financial,0,0,0,0,
2025-09-02,Mark Kowlzan,Packaging Corp of America,0,9,1,10,
2025-09-02,Thomas Hill,Vulcan Materials,4,6,2,12,
2025-09-02,Milan Galik,Interactive Brokers,7,19,1,27,
2025-09-02,Laura Alber,Williams-Sonoma,14,22,4,40,
2025-09-02,Mario Harik,XPO,8,31,1,40,
2025-09-02,Devin Stockfish,Weyerhaeuser,5,5,0,10,
2025-09-02,Thomas J McInerney,Genworth Financial,0,6,0,6,
2025-09-02,Garrick Rochow,CMS Energy,10,3,1,14,
2025-09-02,Toni Townes-Whitley,Science Applications International,12,22,1,35,
2025-09-02,Rich Handler,Jefferies Financial,11,10,2,23,
2025-09-02,Daniel Heaf,Bath & Body Works,11,27,2,40,
2025-09-02,Andrew Wilson,Electronic Arts,14,17,9,40,
2025-09-02,Sheryl Palmer,Taylor Morrison Home,7,12,1,20,
2025-09-02,Ivan Tornos,Zimmer Biomet,8,29,3,40,
2025-09-02,Linda Rendle,Clorox,2,34,2,38,
2025-09-02,Matthew Pine,Xylem Inc,1,8,1,10,
2025-09-02,Heather Lavallee,Voya Financial,7,10,2,19,
2025-09-02,Daniel Florness,Fastenal,3,5,1,9,
2025-09-02,Albert Nahmad,Watsco,2,7,0,9,
2025-09-02,Carl Eschenbach,Workday,11,20,9,40,
2025-09-02,Craig Smiddy,Old Republic International,4,5,1,10,
2025-09-02,Frank C Sullivan,RPM International,4,8,0,12,
2025-09-02,Matthew Missad,UFP Industries,8,2,0,10,
2025-09-02,Martin J Lyons,Ameren,2,3,1,6,
2025-09-02,Adam W Miller,Knight Swift Transportation,1,2,1,4,
2025-09-02,Rodney Sacks,Monster Beverage,13,25,1,39,
2025-09-02,Gary Guthart,Intuitive Surgical,12,25,3,40,
2025-09-02,Charles Liang,Super Micro Computer,33,6,1,40,
2025-09-02,Christopher Caldwell,Concentrix,2,5,0,7,
2025-09-02,Gordon J Hardie,O-I Glass,0,4,0,4,
2025-09-02,David Gibbs,Yum Brands,3,36,1,40,
2025-09-02,Steve Henry,Domtar,5,5,0,10,
2025-09-02,Chuck Treadway,CommScope,8,19,3,30,
2025-09-02,Rob Vitale,Post Holdings,1,11,5,17,
2025-09-02,Steven J Moskowitz,Crown Castle,2,5,3,10,
2025-09-02,Emmanuel Ligner,Avantor,3,11,1,15,
2025-09-02,Stuart Bradie,KBR,16,15,4,35,
2025-09-02,Carrie Wheeler,Opendoor Technologies,11,27,2,40,
2025-09-02,Russell Becker,APi Group,4,5,0,9,
2025-09-02,Toby Rice,EQT,24,14,2,40,
2025-09-02,Jesse Arenivas,EnLink Midstream,7,10,0,17,
2025-09-02,Nikesh Arora,Palo Alto Networks,7,25,8,40,
2025-09-02,Steven Bandrowczak,Xerox,1,8,1,10,
2025-09-02,Vicente Reynal,Ingersoll Rand,9,26,0,35,
2025-09-02,William T Dillard II,Dillards,3,4,2,9,
2025-09-02,C Howard Nye,Martin Marietta Materials,1,5,4,10,
2025-09-02,Giordano Albertazzi,Vertiv,17,19,4,40,
2025-09-02,Stephane Bancel,Moderna,9,19,11,39,
2025-09-02,Nate R Jorgensen,Boise Cascade,0,0,0,0,
2025-09-02,Jack Sinclair,Sprouts Farmers Market,15,24,1,40,
2025-09-02,Padraig McDonnell,Agilent Technologies,11,16,0,27,
2025-09-02,Kenneth T Lane,Olin,0,0,0,0,
2025-09-02,Randall C Stuewe,Darling Ingredients,28,1,0,29,
2025-09-02,R Howard Coker,Sonoco Products,3,6,1,10,
2025-09-02,John Mengucci,CACI International,22,16,2,40,
2025-09-02,Mark Witkowski,Core & Main,0,7,1,8,
2025-09-02,Lee M Tillman,Marathon Oil,5,4,0,9,
2025-09-02,Mark Hoplamazian,Hyatt Hotels,13,22,5,40,
2025-09-02,David S Chernow,Select Medical,0,8,1,9,
2025-09-02,Brendan M Foley,McCormick & Company,0,8,0,8,
2025-09-02,Joanne Crevoiserat,Tapestry,14,23,3,40,
2025-09-02,John Plant,Howmet Aerospace,6,14,2,22,
2025-09-02,Shankh Mitra,Welltower,19,19,2,40,
2025-09-02,W Anthony Will,CF Industries,5,4,0,9,
2025-09-02,David A Zapico,Ametek,2,17,0,19,
2025-09-02,Kevin Stein,TransDigm,10,8,3,21,
2025-09-02,Craig Billings,Wynn Resorts,13,25,2,40,
2025-09-02,William J Way,Southwestern Energy,1,1,0,2,
2025-09-02,Giel Rutten,Amkor Technology,2,9,1,12,
2025-09-02,Paul Sarvadi,Insperity,4,4,1,9,
2025-09-02,Donald Zurbay,Patterson Companies Inc,0,2,0,2,
2025-09-02,Rob Sharps,T Rowe Price,12,20,7,39,
2025-09-02,Patrice Louvet,Ralph Lauren,12,19,9,40,
2025-09-02,Jeffrey Mezger,KB Home,1,29,10,40,
2025-09-02,David M Foulkes,Brunswick,0,8,0,8,
2025-09-02,M Keith Waddell,Robert Half,2,9,1,12,
2025-09-02,Jay Snowden,PENN Entertainment,18,19,3,40,
2025-09-02,George Kurian,NetApp,14,23,3,40,
2025-09-02,Kevin Ali,Organon,9,20,0,29,
2025-09-02,Joel D Anderson,Petco Health and Wellness,3,10,0,13,
2025-09-02,Louis V Pinkham,Regal Rexnord,0,0,0,0,
2025-09-02,Jay Geldmacher,Resideo Technologies,10,5,1,16,
2025-09-02,Marcus Lemonis,Camping World,7,23,10,40,
2025-09-02,Peter R Huntsman,Huntsman,5,12,4,21,
2025-09-02,Hillary Super,Victorias Secret,11,5,8,24,
2025-09-02,Michelle Gass,Levi Strauss,11,25,3,39,
2025-09-02,Neil Hunn,Roper Technologies,2,20,0,22,
2025-09-02,Steven P Lawrence,Academy Sports and Outdoors,1,1,0,2,
2025-09-02,Phillippe Lord,Meritage Homes,9,14,0,23,
2025-09-02,David C Dauch,American Axle & Manufacturing,5,6,2,13,
2025-09-02,Olumide Soroye,Fortive,1,8,0,9,
2025-09-02,Adena Friedman,Nasdaq,15,22,3,40,
2025-09-02,Tim Gokey,Broadridge Financial Solutions,3,12,1,16,
2025-09-02,Patrick M Shanahan,Spirit AeroSystems,1,8,0,9,
2025-09-02,Robert Kyncl,Warner Music Group,10,29,1,40,
2025-09-02,Denise Dignam,Chemours,2,19,3,24,
2025-09-02,Jim DeVries,ADT,8,8,1,17,
2025-09-02,Bernard Zovighian,Edwards Lifesciences,8,5,2,15,
2025-09-02,Mark E Seaton,First American Financial,1,9,0,10,
2025-09-02,John C Roche,Hanover Insurance Group,6,21,1,28,
2025-09-02,Adam J Greenlee,Silgan,0,5,0,5,
2025-09-02,Jayne Hrdlicka,Endeavor Group,0,1,0,1,
2025-09-02,Robert Fauber,Moodys Corporation,0,6,0,6,
2025-09-02,Thomas E Jorden,Coterra Energy,9,0,0,9,
2025-09-02,Eugene A Hall,Gartner,0,10,0,10,
2025-09-02,Kevin Plank,Under Armour,8,27,5,40,
2025-09-02,James W Lanning,Ingles Markets,3,4,0,7,
2025-09-02,Matthew T Farrell,Church & Dwight,7,7,0,14,
2025-09-02,Kevin M Freeman,Old Dominion Freight Line,0,0,0,0,
2025-09-02,Joe Shoen,U-Haul,14,21,4,39,
2025-09-02,Mark Bertolini,Oscar Health,11,20,9,40,
2025-09-02,Jayshree Ullal,Arista Networks,22,17,1,40,
2025-09-02,Sassine Ghazi,Synopsys,12,25,3,40,
2025-09-02,Jochen Zeitz,Harley-Davidson,6,24,10,40,
2025-09-02,Nick Jeffery,Frontier Communications,10,24,2,36,
2025-09-02,Thomas Edward McCormick,Primoris Services,0,3,0,3,
2025-09-02,D Christian Koch,Carlisle Companies,1,4,1,6,
2025-09-02,David E Simon,Simon Property Group,3,5,2,10,
2025-09-02,Stephen Bratspies,Hanesbrands,4,11,1,16,
2025-09-02,Ryan M. Schneider,Anywhere Real Estate Inc,0,2,0,2,
2025-09-02,George Bobb III,Teledyne Technologies,1,4,1,6,
2025-09-02,Terrence A Duffy,CME Group,6,8,1,15,
2025-09-02,Rami Rahim,Juniper Networks,10,28,2,40,
2025-09-02,Sue Nabi,Coty,17,17,6,40,
2025-09-02,Peter D Arvan,Pool Corporation,2,7,0,9,
2025-09-02,David Campbell,Evergy,13,8,0,21,
2025-09-02,Matthew J Murphy,Marvell Technology,4,5,1,10,
2025-09-02,Lloyd Yates,NiSource,5,4,0,9,
2025-09-02,William C Stone,SS&C Technologies,2,6,0,8,
2025-09-02,Mark Rourke,Schneider National,9,17,1,27,
2025-09-02,Andrew Anagnost,Autodesk,8,24,8,40,
2025-09-02,Dustin Semach,Sealed Air Corporation,1,9,0,10,
2025-09-02,William L Meaney,Iron Mountain,2,20,0,22,
2025-09-02,Andy P Power,Digital Realty Trust,0,0,0,0,
2025-09-02,Satish Dhanasekaran,Keysight Technologies,4,11,0,15,
2025-09-02,Frank M Svoboda,Globe Life,3,4,3,10,
2025-09-02,Carey A Smith,Parsons Corporation,1,3,0,4,
2025-09-02,Ynon Kreiz,Mattel,11,22,7,40,
2025-09-02,Karen S Haller,Southwest Gas,3,6,0,9,
2025-09-02,Terrance Williams,TruStage,4,6,1,11,
2025-09-02,Eric W Gerstenberg,Clean Harbors,3,2,2,7,
2025-09-02,Gunner Smith,Cornerstone Building Brands,1,8,0,9,
2025-09-02,Gerben W Bakker,Hubbell,1,5,0,6,
2025-09-02,Dave Davis,Spirit Airlines,5,19,5,29,
2025-09-02,Michael J Smith,Lamb Weston,0,7,3,10,
2025-09-02,Strauss Zelnick,Take-Two Interactive Software,14,17,9,40,
2025-09-02,John C Turner Jr,GMS,3,6,0,9,
2025-09-02,David M O'Malley,Penn Mutual Life Insurance,1,2,0,3,
2025-09-02,Frank A Lonegro,Landstar System,3,3,0,6,
2025-09-02,James F Risoleo,Host Hotels & Resorts,6,18,0,24,
2025-09-02,Ken Xie,Fortinet,14,20,6,40,
2025-09-02,Doug Shulman,OneMain,2,7,0,9,
2025-09-02,Ryan Cohen,GameStop,11,21,8,40,
2025-09-02,Mark W Begor,Equifax,2,10,0,12,
2025-09-02,Jay L Schottenstein,American Eagle Outfitters,9,15,1,25,
2025-09-02,Curtis C Farmer,Comerica,3,9,0,12,
2025-09-02,Ole Rosgaard,Greif,3,16,1,20,
2025-09-02,Brian E Lane,Comfort Systems USA,9,1,0,10,
2025-09-02,Robert M Buck,TopBuild,0,5,1,6,
2025-09-02,Ralph Andretta,Bread Financial,3,9,0,12,
2025-09-02,Jim Anderson,Coherent,6,34,0,40,
2025-09-02,Walter C. D. Carlson,Telephone & Data Systems,0,2,0,2,
2025-09-02,Ronald Kruszewski,Stifel Financial,7,4,0,11,
2025-09-02,Richard Hayne,Urban Outfitters,11,21,8,40,
2025-09-02,Simon Meester,Terex,4,8,0,12,
2025-09-02,Edward J Lehner,Ryerson Holding,0,2,0,2,
2025-09-02,Nicholas T Pinchuk,Snap-on,4,5,0,9,
2025-09-02,Ryals McMullian,Flowers Foods,6,30,2,38,
2025-09-02,D Bryan Jordan,First Horizon,4,8,1,13,
2025-09-02,John B Gibson,Paychex,3,5,0,8,
2025-09-02,Chris Cocks,Hasbro,12,18,10,40,
2025-09-02,Pete McPartland,Sentry Insurance Group,0,2,0,2,
2025-09-02,Michael Arougheti,Ares Management,15,24,1,40,
2025-09-02,Alok Maskara,Lennox International,6,3,1,10,
2025-09-02,James C Grech,Peabody Energy,3,0,0,3,
2025-09-02,Joseph P Lacher Jr,Kemper,4,18,4,26,
2025-09-02,Perry A Sook,Nexstar Media Group,8,29,1,38,
2025-09-02,Wade Davis,TelevisaUnivision,14,25,1,40,
2025-09-02,Scott L Thompson,Tempur Sealy International,0,7,0,7,
2025-09-02,Mike Simonds,TriNet Group,0,9,0,9,
2025-09-02,B Andrew Rose,Worthington Enterprises,1,2,0,3,
2025-09-02,Bruce L Caswell,Maximus,5,5,0,10,
2025-09-02,Robert L Reffkin,Compass,1,6,0,7,
2025-09-02,Mark Eubanks,Brinks Company,1,2,1,4,
2025-09-02,Peter Quigley,Kelly Services inc,2,8,0,10,
2025-09-02,David L Yowan,Navient,2,3,0,5,
2025-09-02,Mary E Kipp,Puget Sound Energy,4,0,2,6,
2025-09-02,Adam Aron,AMC Entertainment,17,16,7,40,
2025-09-02,Mark J Tarr,Encompass Health,2,6,1,9,
2025-09-02,Liam K Griffin,Skyworks Solutions,1,6,1,8,
2025-09-02,Richard G Kyle,Timken,8,20,2,30,
2025-09-02,Ron Gusek,Liberty Energy,22,1,0,23,
2025-09-02,John E Geller Jr,Marriott Vacations Worldwide,6,6,0,12,
2025-09-02,Karl G. Glassman,Leggett & Platt,0,5,0,5,
2025-09-02,Bruce K Thorn,Big Lots,2,6,2,10,
2025-09-02,Jonathan H Weis,Weis Markets,12,27,0,39,
2025-09-02,Jeffrey B Guldner,Pinnacle West Capital,1,4,0,5,
2025-09-02,Arkadiy Dobkin,EPAM Systems,10,16,2,28,
2025-09-02,Paul M Rady,Antero Resources,4,9,0,13,
2025-09-02,Michael Spanos,Bloomin Brands,1,8,1,10,
2025-09-02,Nicole A Kivisto,MDU Resources Group,1,5,0,6,
2025-09-02,Gerald L Morgan,Texas Roadhouse,3,3,4,10,
2025-09-02,Gabriel Tirador,Mercury General,4,4,2,10,
2025-09-02,Nicholas I Fink,Fortune Brands Innovations,5,1,0,6,
2025-09-02,Paul E Burdiss,Zions Bancorp,1,1,0,2,
2025-09-02,William J Christensen,JELD-WEN Holding,4,5,0,9,
2025-09-02,Evan Spiegel,Snap Inc,18,19,3,40,
2025-09-02,Bill Burns,Zebra Technologies,7,24,1,32,
2025-09-02,Steven Sell,Agilon Health,1,5,3,9,
2025-09-02,Richard M Olson,Toro Company,1,14,1,16,
2025-09-02,Eric S Yuan,Zoom Video Communications,5,8,0,13,
2025-09-02,Dan L Batrack,Tetra Tech,2,6,1,9,
2025-09-02,Joseph D Russell Jr,Public Storage,0,8,0,8,
2025-09-02,Jacob Thaysen,Illumina inc,5,7,0,12,
2025-09-02,Debra A Cafaro,Ventas inc,7,5,0,12,
2025-09-02,Pierre R Brondeau,FMC Corporation,0,4,0,4,
2025-09-02,Judy R McReynolds,ArcBest,6,14,1,21,
2025-09-02,Russell J Weiner,Dominos Pizza inc,0,0,0,0,
2025-09-02,Theodore S Hanson,ASGN,0,3,0,3,
2025-09-02,RJ Scaringe,Rivian Automotive,10,28,2,40,
2025-09-02,Jeffrey N Simmons,Elanco Animal Health,2,6,1,9,
2025-09-02,Tim O Shaughnessy,Graham Holdings Company,3,6,0,9,
2025-09-02,Thomas V Taylor,Floor & Decor,1,1,2,4,
2025-09-02,Neil A Schrimsher,Applied Industrial Technologies,5,21,1,27,
2025-09-02,Robert E Price,PriceSmart,5,5,0,10,
2025-09-02,John David Risher,Lyft,2,4,2,8,
2025-09-02,Gary B Smith,Ciena,4,8,0,12,
2025-09-02,Joey Levin,IAC,7,31,1,39,
2025-09-02,Jim Jacobs,Country Financial,7,3,1,11,
2025-09-02,Devin B McGranahan,Western Union,1,6,0,7,
2025-09-02,R Scott Rowe,Flowserve,5,5,0,10,
2025-09-02,Kenneth A Vecchione,Western Alliance Bancorp,0,0,1,1,
2025-09-02,John C Rademacher,Option Care Health,10,1,0,11,
2025-09-02,Doug Black,SiteOne Landscape Supply,3,24,2,29,
2025-09-02,Oliver G Brewer III,Topgolf Callaway Brands,1,0,0,1,
2025-09-02,Glenn Sanford,eXp World,14,22,4,40,
2025-09-02,Fran Horowitz,Abercrombie & Fitch,15,21,4,40,
2025-09-02,Kevin Akers,Atmos Energy,7,2,1,10,
2025-09-02,Alessandro Maselli,Catalent,4,11,2,17,
2025-09-02,J Powell Brown,Brown & Brown,11,21,8,40,
2025-09-02,Aman Bhutani,GoDaddy,16,22,2,40,
2025-09-02,John C. Griffith,American Water Works,1,3,0,4,
2025-09-02,John J Marchioni,Selective Insurance Group,4,12,3,19,
2025-09-02,Lawson E Whiting,Brown-Forman,1,7,2,10,
2025-09-02,Dave Peacock,Advantage Solutions,30,7,1,38,
2025-09-02,Mick Farrell,ResMed,16,22,1,39,
2025-09-02,Kamal Hathi,Splunk,1,4,0,5,
2025-09-02,Todd Kelsey,Plexus,2,6,0,8,
2025-09-02,Phillip D Yeager,Hub Group,3,6,0,9,
2025-09-02,Steven B Hedlund,Lincoln Electric,5,10,0,15,
2025-09-02,Timothy C Oliver,NCR Atleos,0,1,0,1,
2025-09-02,Bruce Fleming,Calumet,2,7,0,9,
2025-09-02,Daniel S. Peyovich,Dycom Industries,1,5,0,6,
2025-09-02,Avner M Applbaum,Valmont Industries,0,8,2,10,
2025-09-02,Kimberly A Fields,ATI inc,5,9,0,14,
2025-09-02,Khozema Z Shipchandler,Twilio,0,1,0,1,
2025-09-02,Gary C Bhojwani,CNO Financial Group,1,7,1,9,
2025-09-02,William Andrew Hendricks Jr,Patterson-UTI Energy,0,0,0,0,
2025-09-02,Kevin D Hochman,Brinker International,1,4,1,6,
2025-09-02,James C Foster,Charles River Laboratories International,2,9,1,12,
2025-09-02,Rajiv K Prasad,Hyster-Yale,2,5,0,7,
2025-09-02,Eric T Steigerwalt,Brighthouse Financial,1,2,0,3,
2025-09-02,Thomas L Ryan,Service Corp International,6,4,0,10,
2025-09-02,Charles M Nifong Jr,CrossAmerica Partners,0,0,0,0,
2025-09-02,Anirudh Devgan,Cadence,8,24,3,35,
2025-09-02,Andi Owen,MillerKnoll,16,15,9,40,
2025-09-02,Sumit Roy,Realty Income,11,18,2,31,
2025-09-02,Timothy John Fitzgerald,Middleby,0,0,0,0,
2025-09-02,Robert H Schottenstein,M/I Homes,3,8,0,11,
2025-09-02,Stephen P MacMillan,Hologic,0,8,0,8,
2025-09-02,Lisa M Barton,Alliant Energy,6,0,0,6,
2025-09-02,Aaron P Jagdfeld,Generac,1,5,0,6,
2025-09-02,Erik Gershwind,MSC Industrial Direct,3,5,2,10,
2025-09-02,Varun Krishna,Rocket Companies,9,30,1,40,
2025-09-02,Fahmi Karam,Upbound Group,4,5,0,9,
2025-09-02,NADominic Ng,East West Bancorp,0,0,0,0,
2025-09-02,Mark Wang,Hilton Grand Vacations,38,2,0,40,
2025-09-02,Robert J Sheedy Jr,Grocery Outlet Holding,0,0,0,0,
2025-09-02,Simon D Campion,Dentsply Sirona,0,3,0,3,
2025-09-02,Jeremy Wensinger,V2X,7,9,0,16,
2025-09-02,Andrew Rees,Crocs,15,15,10,40,
2025-09-02,David M Maura,Spectrum Brands,6,0,1,7,
2025-09-02,Sachin S Lawande,Visteon,0,1,0,1,
2025-09-02,Neil M Ashe,Acuity Inc,0,1,0,1,
2025-09-02,Lorie L Tekorius,Greenbrier,1,9,0,10,
2025-09-02,John R Ciulla,Webster Financial,4,5,0,9,
2025-09-02,Sean D Keohane,Cabot Corporation,3,5,0,8,
2025-09-02,Drew M Wilkerson,RXO inc,0,0,0,0,
2025-09-02,Daniel E Brown,Chord Energy,1,1,0,2,
2025-09-02,Javier D Ferrer Fernandez,Popular inc,0,0,0,0,
2025-09-02,Olivier Rabiller,Garrett Motion inc,4,9,0,13,
2025-09-02,Ronald N Tutor,Tutor Perini Corporation,1,7,1,9,
2025-09-02,Jeff Liaw,Copart,4,5,0,9,
2025-09-02,Aman Narang,Toast inc,5,5,1,11,
2025-09-02,Joseph M Hogan,Align Technology,2,5,0,7,
2025-09-02,Kevin J Wheeler,A O Smith,0,15,1,16,
2025-09-02,Christopher A Cartwright,TransUnion,1,0,1,2,
2025-09-02,James Kelly,NCR Voyix,2,12,1,15,
2025-09-02,Tom Leighton,Akamai Technologies,12,16,6,34,
2025-09-02,Robert G Painter,Trimble,8,2,0,10,
2025-09-02,Tony Helton,Medical Mutual of Ohio,1,4,1,6,
2025-09-02,Caroline S Grace,AMN Healthcare Services,0,0,0,0,
2025-09-02,Patrick Kaltenbach,Mettler-Toledo International,2,7,0,9,
2025-09-02,Michael L Baur,ScanSource,0,3,0,3,
2025-09-02,Jason Lippert,LCI Industries,4,11,0,15,
2025-09-02,Fredric J Tomczyk,Cboe Global Markets,1,6,0,7,
2025-09-02,Octavio Marquez,Diebold Nixdorf,6,11,1,18,
2025-09-02,Sivasankaran Somasundaram,ChampionX,8,2,0,10,
2025-09-02,Ronald F Clarke,Corpay,0,1,0,1,
2025-09-02,Robert W Pittman,iHeartMedia,6,3,0,9,
2025-09-02,Patrick Zalupski,Dream Finders Homes,23,15,2,40,
2025-09-02,Keith E Smith,Boyd Gaming,1,6,1,8,
2025-09-02,Mehran Assadi,NLV Financial,1,1,0,2,
2025-09-02,Barry R Port,Ensign Group,3,5,1,9,
2025-09-02,Denise A Paulonis,Sally Beauty,1,2,0,3,
2025-09-02,Clifford A Skelton,Conduent,0,0,0,0,
2025-09-02,Jean-Michel Ribieras,Sylvamo,2,6,0,8,
2025-09-02,Douglas F Bauer,Tri Pointe Homes,0,5,0,5,
2025-09-02,Shawn O'Connell,EnerSys,3,5,0,8,
2025-09-02,Bill Meury,Incyte,8,16,0,24,
2025-09-02,Dale Francescon,Century Communities,2,9,3,14,
2025-09-02,Michael Nierenberg,Rithm Capital,7,26,1,34,
2025-09-02,Michael J Brown,Euronet Worldwide,2,8,0,10,
2025-09-02,Scott Seu,Hawaiian Electric Industries,4,16,2,22,
2025-09-02,Jason D Robins,DraftKings,5,3,0,8,
2025-09-02,Jonathan J Mazelsky,IDEXX Laboratories,1,2,1,4,
2025-09-02,Richard S Swartz,MYR Group,0,2,0,2,
2025-09-02,Stefano Caroti,Deckers Outdoor,2,6,1,9,
2025-09-02,Kevin R Sayer,DexCom,1,5,0,6,
2025-09-02,John T C Lee,MKS Instruments,4,9,1,14,
2025-09-02,Edward B Pitoniak,VICI Properties,1,7,0,8,
2025-09-02,Albert White III,Cooper Cos,0,0,0,0,
2025-09-02,Barry L Biffle,Frontier Airlines,1,6,6,13,
2025-09-02,Robert A Bruggeworth,Qorvo,5,4,0,9,
2025-09-02,Winnie Park,Five Below,11,26,3,40,
2025-09-02,Steven Oakland,TreeHouse Foods,2,12,0,14,
2025-09-02,James S Hagedorn,Scotts Miracle-Gro,1,0,0,1,
2025-09-02,Michael Cannon-Brookes,Atlassian,20,18,2,40,
2025-09-02,Bertrand Loy,Entegris,3,11,1,15,
2025-09-02,William E Waltz,Atkore,2,7,0,9,
2025-09-02,Celeste B Mastin,H B Fuller,1,4,0,5,
2025-09-02,Kyle T Larkin,Granite Construction,1,6,0,7,
2025-09-02,Michael J Happe,Winnebago Industries,1,3,0,4,
2025-09-02,Steven H Gunby,FTI Consulting,5,10,0,15,
2025-09-02,Stephan B Tanda,AptarGroup,0,4,3,7,
2025-09-02,Timothy P Boyle,Columbia Sportswear,3,3,2,8,
2025-09-02,Anthony J Wood,Roku,5,4,1,10,
2025-09-02,M Christopher Doyle,Civitas Resources,1,2,0,3,
2025-09-02,Andy Eidson,Alpha Metallurgical Resources,1,7,2,10,
2025-09-02,Andy L Nemeth,Patrick Industries,4,1,0,5,
2025-09-02,Roger W Jenkins,Murphy Oil,3,17,0,20,
2025-09-02,Kevin S Blair,Synovus Financial,8,2,0,10,
2025-09-02,Julie Felss Masino,Cracker Barrel Old Country Store,6,18,16,40,
2025-09-02,David M Overton,Cheesecake Factory,1,9,0,10,
2025-09-02,Nick DeIuliis,CNX Resources,8,3,1,12,
2025-09-02,Christopher Pappas,Chefs Warehouse,3,8,1,12,
2025-09-02,Tod Carpenter,Donaldson Company,2,7,0,9,
2025-09-02,Gregory L Christopher,Mueller Industries,2,6,0,8,
2025-09-02,Rob Saltiel,MRC Global,7,13,2,22,
2025-09-02,Jillian C Evanko,Chart Industries,3,5,0,8,
2025-09-02,Dave Guilmette,Alight Solutions,3,6,0,9,
2025-09-02,Joel Smejkal,Vishay Intertechnology,6,3,1,10,
2025-09-02,Dennis Degner,Range Resources,4,7,0,11,
2025-09-02,Ira D Robbins,Valley National Bancorp,1,2,0,3,
2025-09-02,Bernard Kim,Match Group,15,19,6,40,
2025-09-02,Vincent Pilette,Gen Digital,2,14,0,16,
2025-09-02,Timothy S Crane,Wintrust Financial,2,8,0,10,
2025-09-02,Pat Roche,Moog inc,4,9,2,15,
2025-09-02,Mark R Widmar,First Solar,3,5,1,9,
2025-09-02,Niko Lahanas,Central Garden & Pet,2,11,0,13,
2025-09-02,Chris Osowski,Green Plains inc,8,15,1,24,
2025-09-02,Derek J Leathers,Werner Enterprises,1,9,0,10,
2025-09-02,Adam Foroughi,AppLovin,10,26,4,40,
2025-09-02,Luca Savi,ITT,3,6,0,9,
2025-09-02,Lawrence H Silber,Herc Rentals,0,0,0,0,
2025-09-02,Hilton H Howell Jr,Gray Television,7,20,1,28,
2025-09-02,Eric D Ashleman,IDEX,0,9,1,10,
2025-09-02,Owen D Thomas,Boston Properties,3,7,0,10,
2025-09-02,Kurt Wolf,Pitney Bowes,6,20,2,28,
2025-09-02,Sara E Armbruster,Steelcase,2,0,0,2,
2025-09-02,Charles D. Young,Sun Communities,2,6,0,8,
2025-09-02,Suzanne Foster,AdaptHealth,5,7,1,13,
2025-09-02,Grant E Sims,Genesis Energy,4,2,0,6,
2025-09-02,Laura Prieskorn,Jackson Financial,3,6,1,10,
2025-09-02,Rick L Wessel,FirstCash,0,0,0,0,
2025-09-02,Sherman Miller,Cal-Maine Foods,11,28,1,40,
2025-09-02,Paul A Lang,Arch Resources,4,3,1,8,
2025-09-02,Ashish K Khandpur,Avient,2,7,0,9,
2025-09-02,Shyam K Reddy,BlueLinx,1,7,0,8,
2025-09-02,Christopher S Ripley,Sinclair,1,7,0,8,
2025-09-02,Stacy Kymes,BOK Financial,8,7,0,15,
2025-09-02,James H Walter,Permian Resources,0,1,0,1,
2025-09-02,Jason Murray,PACS Group,5,14,2,21,
2025-09-02,Brian Armstrong,Coinbase Global,12,23,5,40,
2025-09-02,Oscar K Brown,Western Midstream Partners,1,3,0,4,
2025-09-02,Nicholas R Lower,Federated Mutual Insurance,0,0,0,0,
2025-09-02,Morris Goldfarb,G-III Apparel Group,11,23,6,40,
2025-09-02,Mark D Morelli,Vontier,0,4,0,4,
2025-09-02,Matthew J Cox,Matson inc,0,6,0,6,
2025-09-02,David W Grzebinski,Kirby Corporation,1,3,0,4,
2025-09-02,Keith A Harvey,Kaiser Aluminum,2,4,2,8,
2025-09-02,Eric Nyman,Vista Outdoor,4,11,1,16,
2025-09-02,Doug Howe,Designer Brands,5,17,0,22,
2025-09-02,Jerry E Gahlhoff Jr,Rollins inc,0,2,0,2,
2025-09-02,D Scott Barbour,Advanced Drainage Systems,3,2,0,5,
2025-09-02,Sean Gamble,Cinemark,17,22,1,40,
2025-09-02,George Kurtz,CrowdStrike,14,24,2,40,
2025-09-02,Bill Ready,Pinterest,26,14,0,40,
2025-09-02,Fidji Simo,Instacart,11,28,1,40,
2025-09-02,Kimberly K Ryan,Hillenbrand,3,5,0,8,
2025-09-02,David S Graziosi,Allison Transmission,2,17,2,21,
2025-09-02,Gary G Friedman,Restoration Hardware,1,4,0,5,
2025-09-02,Lucinda M Baier,Brookdale Senior Living,4,3,0,7,
2025-09-02,Brian J Blaser,QuidelOrtho,1,8,0,9,
2025-09-02,E Jean Savage,Trinity Industries,1,7,1,9,
2025-09-02,Liam J Kelly,Teleflex,1,5,1,7,
2025-09-02,Laurans A Mendelson,HEICO,8,21,1,30,
2025-09-02,Frank H Laukien,Bruker,1,9,0,10,
2025-09-02,Harvey M Schwartz,Carlyle Group,6,13,0,19,
2025-09-02,Mark S LaVigne,Energizer,2,0,0,2,
2025-09-02,Joel Quadracci,Quad/Graphics,11,22,5,38,
2025-09-02,Amar Maletira,Rackspace Technology,4,11,2,17,
2025-09-02,Udit Batra,Waters Corporation,11,26,0,37,
2025-09-02,Eric M Green,West Pharmaceutical Services,1,9,0,10,
2025-09-02,Doug Palladini,Carters inc,2,2,2,6,
2025-09-02,G Mike Mikan,NeueHealth,3,2,0,5,
2025-09-02,Russell ChipChilds,SkyWest,0,0,0,0,
2025-09-02,Christopher H Hunter,Acadia Healthcare,0,1,0,1,
2025-09-02,Prahlad Singh,Revvity,2,7,0,9,
2025-09-02,Maria M Pope,Portland General Electric,1,1,0,2,
2025-09-02,Charles Chip Blankenship,Woodward inc,0,1,0,1,
2025-09-02,Mike Steib,TEGNA,14,19,1,34,
2025-09-02,Kurt J Ekert,Sabre Corporation,0,1,0,1,
2025-09-02,Matt Wilson,Light & Wonder,15,20,5,40,
2025-09-02,Rob Katz,Vail Resorts,3,14,23,40,
2025-09-02,Schnitzer Steel Industries,Radius Recycling,9,23,5,37,
2025-09-02,David A Spector,PennyMac Financial Services,3,1,0,4,
2025-09-02,Frederick J Holzgrefe III,Saia inc,1,1,0,2,
2025-09-02,Mark J Parrell,Equity Residential,4,5,0,9,
2025-09-02,John W Lindsay,Helmerich & Payne,0,5,0,5,
2025-09-02,Gary D Burnison,Korn Ferry,3,14,0,17,
2025-09-02,Timothy J McGrath,PC Connection Inc,2,3,0,5,
2025-09-02,Lynn M Bamford,Curtiss-Wright,13,6,0,19,
2025-09-02,Jonathan W Witter,Sallie Mae,0,1,0,1,
2025-09-02,Jeff Benck,Benchmark Electronics,1,7,0,8,
2025-09-02,Charles H Giancarlo,Pure Storage,0,3,0,3,
2025-09-02,Brian R Gray,Knife River Corporation,0,1,0,1,
2025-09-02,Jay Schmidt,Caleres inc,4,4,2,10,
2025-09-02,Dale Asplund,BrightView Holdings,1,5,0,6,
2025-09-02,Jeffrey S Edwards,Cooper-Standard,0,6,0,6,
2025-09-02,Glenn J Williams,Primerica,6,2,2,10,
2025-09-02,Francois Locoh-Donou,F5,5,20,3,28,
2025-09-02,Joseph Wm Foran,Matador Resources,7,10,0,17,
2025-09-02,Sridhar Ramaswamy,Snowflake inc,11,25,4,40,
2025-09-02,Mark D Dankberg,Viasat,2,4,2,8,
2025-09-02,Francisco J Leon,California Resources,1,3,1,5,
2025-09-02,Peter Stern,Peloton,18,18,4,40,
2025-09-02,David Baszucki,Roblox,11,20,9,40,
2025-09-02,Jeffrey W Edwards,Installed Building Products,1,3,0,4,
2025-09-02,Clark Lauritzen,First National of Nebraska,1,7,0,8,
2025-09-02,Carlos Alberini,Guess inc,12,27,1,40,
2025-09-02,Shyam P Kambeyanda,ESAB,3,4,0,7,
2025-09-02,Edmund Shallcross III,Amica Mutual Insurance,1,5,0,6,
2025-09-02,Benjamin W Schall,AvalonBay Communities,1,8,1,10,
2025-09-02,Allan C Thygesen,DocuSign,2,7,0,9,
2025-09-02,Bryan J Knutson,Titan Machinery,1,1,1,3,
2025-09-02,Heath Sampson,ModivCare,6,2,1,9,
2025-09-02,Ara K Hovnanian,Hovnanian Enterprises,2,18,2,22,
2025-09-02,Joshua G Silverman,Etsy,2,3,0,5,
2025-09-02,Kevin Roycraft,Adams Resources & Energy,5,4,1,10,
2025-09-02,J Eric Evans,Surgery Partners,0,3,0,3,
2025-09-02,Clint E Stein,Columbia Banking System,1,6,0,7,
2025-09-02,Lee M Shavel,Verisk Analytics,2,7,0,9,
2025-09-02,Dave Banyard Jr,MasterBrand,0,0,0,0,
2025-09-02,Peter R Ingram,Hawaiian Airlines inc,1,0,0,1,
2025-09-02,Kristin A Dolan,AMC Networks,3,2,0,5,
2025-09-02,Brendan T Cavanagh,SBA Communications,1,2,0,3,
2025-09-02,George F Chappelle Jr,Americold Realty Trust,1,3,0,4,
2025-09-02,Thomas E Gottwald,NewMarket Corporation,3,7,0,10,
2025-09-02,Thomas J Baltimore Jr,Park Hotels & Resorts,3,30,0,33,
2025-09-02,Peter M Moglia,Alexandria Real Estate Equities,4,6,0,10,
2025-09-02,Ronald J Kramer,Griffon Corporation,1,6,0,7,
2025-09-02,John L Plueger,Air Lease,2,13,0,15,
2025-09-02,Jennifer F Scanlon,UL Solutions,1,5,0,6,
2025-09-02,Greg Smith,Teradyne,2,8,2,12,
2025-09-02,Sean Trauschke,OGE Energy,17,5,0,22,
2025-09-02,Norman D Schwartz,Bio-Rad Laboratories,1,1,1,3,
2025-09-02,Scott Doyle,Spire inc,4,4,1,9,
2025-09-02,Michael E Reed,Gannett,0,4,2,6,
2025-09-02,Cindy J Miller,Stericycle,2,5,2,9,
2025-09-02,Phillip D Green,Cullen Frost Bankers,1,4,2,7,
2025-09-02,Joseph D Margolis,Extra Space Storage,0,8,1,9,
2025-09-02,Mark A Skonieczny,REV Group,7,3,0,10,
2025-09-02,Ladd Wilks,ProFrac Holding,4,3,1,8,
2025-09-02,Sundaram Nagarajan,Nordson,0,10,1,11,
2025-09-02,Anne P Noonan,Summit Materials,0,0,0,0,
2025-09-02,Lori Flees,Valvoline inc,4,4,2,10,
2025-09-02,Scott H Baxter,Kontoor Brands,2,2,0,4,
2025-09-02,Tim Larson,Skyline Champion,6,0,0,6,
2025-09-02,Chuck Divita,Teladoc Health,9,19,5,33,
2025-09-02,W Bradley Southern,Louisiana-Pacific Corporation,0,0,0,0,
2025-09-02,George C Freeman III,Universal Corporation,3,7,0,10,
2025-09-02,James A Brock,Consol Energy,2,0,0,2,
2025-09-02,Robert Antokol,Playtika Holding,1,7,1,9,
2025-09-02,Joe Craft,Alliance Resource Partners,7,9,2,18,
2025-09-02,Paul Keel,Envista,1,7,1,9,
2025-09-02,Jared Isaacman,Shift4 Payments,7,28,5,40,
2025-09-02,Mark Mac McFarland,Talen Energy,3,1,1,5,
2025-09-02,Tony R Thene,Carpenter Technology,3,10,0,13,
2025-09-02,Melissa D Smith,WEX,2,7,0,9,
2025-09-02,James Jim C Ryan III,Old National Bancorp,1,0,0,1,
2025-09-02,Peter J Federico,AGNC Investment,1,0,0,1,
2025-09-02,Brent L Yeagy,Wabash National,0,0,0,0,
2025-09-02,Henry A Fernandez,MSCI,3,13,0,16,
2025-09-02,Mark Penn,Stagwell,13,24,2,39,
2025-09-02,Julie Schertell,Mativ,3,8,0,11,
2025-09-02,Ashish Chand,Belden,3,6,1,10,
2025-09-02,Greg Anderson,Allegiant Travel Company,4,7,0,11,
2025-09-02,Drew Houston,Dropbox,14,20,6,40,
2025-09-02,Kevin T Conroy,Exact Sciences,2,5,2,9,
2025-09-02,Rex D Geveden,BWX Technologies,4,7,0,11,
2025-09-02,Scott R Wells,Clear Channel Outdoor Hldgs,0,0,0,0,
2025-09-02,Paul Bay,Ingram Micro,9,26,5,40,
2025-09-03,Doug McMillon,Walmart,15,20,5,40,
2025-09-03,Andrew Jassy,Amazon,4,31,5,40,
2025-09-03,Tim Cook,Apple,14,21,5,40,
2025-09-03,Stephen Hemsley,UnitedHealth,8,25,7,40,
2025-09-03,Warren Buffett,Berkshire Hathaway,10,23,7,40,
2025-09-03,David Joyner,CVS Health,7,28,5,40,
2025-09-03,Darren Woods,Exxon Mobil,10,22,7,39,
2025-09-03,Sundar Pichai,Alphabet,15,18,7,40,
2025-09-03,Brian Tyler,McKesson,4,16,5,25,
2025-09-03,Robert Mauch,Cencora,3,7,0,10,
2025-09-03,Ron Vachris,Costco,7,31,2,40,
2025-09-03,Jamie Dimon,JPMorgan Chase,8,16,16,40,
2025-09-03,Satya Nadella,Microsoft,17,20,3,40,
2025-09-03,Jason Hollar,Cardinal Health,14,22,4,40,
2025-09-03,Mike Wirth,Chevron,16,18,6,40,
2025-09-03,David Cordani,Cigna,20,16,4,40,
2025-09-03,Jim Farley,Ford Motor,15,20,5,40,
2025-09-03,Brian Moynihan,Bank of America,8,27,5,40,
2025-09-03,Mary Barra,General Motors,11,23,6,40,
2025-09-03,Gail Boudreaux,Elevance Health,15,17,8,40,
2025-09-03,Jane Fraser,Citigroup,15,20,5,40,
2025-09-03,Sarah London,Centene,13,18,9,40,
2025-09-03,Ted Decker,Home Depot,12,23,5,40,
2025-09-03,Maryann Mannen,Marathon Petroleum,6,13,1,20,
2025-09-03,Ron Sargent,Kroger,5,22,13,40,
2025-09-03,Mark Lashier,Phillips 66,12,18,8,38,
2025-09-03,Priscilla Almodovar,Fannie Mae,11,16,13,40,
2025-09-03,Tim Wentworth,Walgreens,7,24,9,40,
2025-09-03,Lane Riggs,Valero Energy,13,8,0,21,
2025-09-03,Mark Zuckerberg,Meta,10,16,14,40,
2025-09-03,Hans Vestberg,Verizon,15,21,4,40,
2025-09-03,John Stankey,AT&T,12,23,5,40,
2025-09-03,Brian Roberts,Comcast,10,27,3,40,
2025-09-03,Charles Scharf,Wells Fargo,28,6,6,40,
2025-09-03,David Solomon,Goldman Sachs,9,23,8,40,
2025-09-03,Michael Hutchins,Freddie Mac,3,10,3,16,
2025-09-03,Michael Fiddelke,Target,9,23,8,40,
2025-09-03,Jim Rechtin,Humana,18,17,5,40,
2025-09-03,Jon Farney,State Farm Insurance,1,13,3,17,
2025-09-03,Elon Musk,Tesla,13,14,13,40,
2025-09-03,Ted Pick,Morgan Stanley,15,22,3,40,
2025-09-03,Joaquin Duato,Johnson & Johnson,12,24,4,40,
2025-09-03,Juan Luciano,Archer Daniels Midland,3,20,16,39,
2025-09-03,Ramon Laguarta,PepsiCo,7,28,5,40,
2025-09-03,Carol Tom√©,UPS,8,23,9,40,
2025-09-03,Rajesh Subramaniam,FedEx,9,30,0,39,
2025-09-03,Bob Iger,Walt Disney,8,30,2,40,
2025-09-03,Michael Dell,Dell Technologies,11,24,5,40,
2025-09-03,Marvin Ellison,Lowes,13,25,1,39,
2025-09-03,Jon Moeller,Procter & Gamble,6,27,7,40,
2025-09-03,Thomas Long,Energy Transfer,7,0,2,9,
2025-09-03,Kelly Ortberg,Boeing,11,26,3,40,
2025-09-03,Susan Morris,Albertsons,13,24,3,40,
2025-09-03,Kevin Hourican,Sysco,9,27,4,40,
2025-09-03,Christopher Calio,RTX,6,12,0,18,
2025-09-03,Larry Culp,General Electric,12,25,3,40,
2025-09-03,James Taiclet,Lockheed Martin,12,19,9,40,
2025-09-03,Stephen Squeri,American Express,16,22,2,40,
2025-09-03,Joe Creed,Caterpillar,11,27,2,40,
2025-09-03,Michel Khalaf,MetLife,12,18,1,31,
2025-09-03,Samuel Hazen,HCA Healthcare,8,7,0,15,
2025-09-03,Tricia Griffith,Progressive Insurance,9,26,5,40,
2025-09-03,Arvind Krishna,IBM,14,21,5,40,
2025-09-03,John May,Deere,8,27,5,40,
2025-09-03,Jensen Huang,Nvidia,11,25,4,40,
2025-09-03,Philip Smith,StoneX,0,8,1,9,
2025-09-03,Robert M Davis,Merck,4,19,0,23,
2025-09-03,Ryan Lance,ConocoPhillips,18,19,3,40,
2025-09-03,Albert Bourla,Pfizer,18,12,10,40,
2025-09-03,Ed Bastian,Delta Air Lines,11,19,10,40,
2025-09-03,Patrick Zammit,TD Synnex,10,15,0,25,
2025-09-03,Kevin Murphy,Publix Super Markets,10,22,1,33,
2025-09-03,Thomas J Wilson,Allstate,0,9,1,10,
2025-09-03,Chuck Robbins,Cisco Systems,15,22,3,40,
2025-09-03,Kirt Walker,Nationwide,15,18,2,35,
2025-09-03,Christopher Winfrey,Charter Communications,6,17,5,28,
2025-09-03,Bob Michael,AbbVie,0,0,0,0,
2025-09-03,Craig DeSanto,New York Life Insurance,3,17,0,20,
2025-09-03,Lip-Bu Tan,Intel,8,15,17,40,
2025-09-03,Ernie Herrman,TJX,16,22,2,40,
2025-09-03,Andrew Sullivan,Prudential Financial,12,20,0,32,
2025-09-03,Enrique Lores,Hewlett Packard,11,16,7,34,
2025-09-03,Scott Kirby,United Airlines,33,4,3,40,
2025-09-03,George Holm,Performance Food,11,21,2,34,
2025-09-03,Donnie King,Tyson Foods,9,26,5,40,
2025-09-03,Robert Isom,American Airlines,7,26,7,40,
2025-09-03,Timothy M Sweeney,Liberty Mutual Insurance,12,0,0,12,
2025-09-03,Elliott Hill,Nike,10,28,2,40,
2025-09-03,Safra Catz,Oracle,12,21,7,40,
2025-09-03,AJ Jim Teague,Enterprise Products Partners,6,11,0,17,
2025-09-03,Richard Fairbank,Capital One,15,22,3,40,
2025-09-03,Wilfred Chiang,Plains GP,1,1,0,2,
2025-09-03,Michael Kasbar,World Kinect,2,9,0,11,
2025-09-03,Peter Zaffino,American International Group,9,27,4,40,
2025-09-03,James Quincey,The Coca-Cola Company,10,28,2,40,
2025-09-03,Thasunda Brown Duckett,TIAA,19,21,0,40,
2025-09-03,Jay Debertin,CHS,5,11,4,20,
2025-09-03,Chris Boerner,Bristol-Myers Squibb,10,24,6,40,
2025-09-03,Corie Barry,Best Buy,39,1,0,40,
2025-09-03,Marc Casper,Thermo Fisher Scientific,11,25,4,40,
2025-09-03,Roger Crandall,Mass Mutual,3,7,0,10,
2025-09-03,Juan Andrade,USAA,5,15,0,20,
2025-09-03,Phebe Novakovic,General Dynamics,27,10,3,40,
2025-09-03,Alan Schnitzer,Travelers Insurance,3,5,1,9,
2025-09-03,David Zaslav,Warner Bros Discovery,5,23,11,39,
2025-09-03,Gunjan Kedia,US Bancorp,12,26,2,40,
2025-09-03,Robert Ford,Abbott Laboratories,11,23,6,40,
2025-09-03,Kathy Warden,Northrop Grumman,14,22,4,40,
2025-09-03,Tim Gerend,Northwestern Mutual,13,26,1,40,
2025-09-03,Todd Vasos,Dollar General,8,25,7,40,
2025-09-03,Matthew Lucey,PBF Energy,6,3,0,9,
2025-09-03,Dara Khosrowshahi,Uber,13,21,6,40,
2025-09-03,Vimal Kapur,Honeywell,11,29,0,40,
2025-09-03,Dirk Van de Put,Mondelez,10,28,2,40,
2025-09-03,Brian Niccol,Starbucks,13,27,0,40,
2025-09-03,Cristiano Amon,Qualcomm,13,26,1,40,
2025-09-03,Hock Tan,Broadcom,10,26,4,40,
2025-09-03,David Flitman,US Foods,2,7,0,9,
2025-09-03,Paul Romanowski,DR Horton,5,14,5,24,
2025-09-03,Jacek Olczak,Philip Morris,13,24,3,40,
2025-09-03,Preston Feight,Paccar,9,29,2,40,
2025-09-03,Marc Benioff,Salesforce,8,20,12,40,
2025-09-03,Leon Topalian,Nucor,15,22,3,40,
2025-09-03,Michael Dastoor,Jabil,1,9,0,10,
2025-09-03,Jonathan Jaffe,Lennar,1,8,1,10,
2025-09-03,David Ricks,Eli Lilly,9,20,11,40,
2025-09-03,Joe Zubretsky,Molina Healthcare,6,7,4,17,
2025-09-03,Jennifer Rumsey,Cummins,7,27,6,40,
2025-09-03,Robin Vince,Bank of New York Mellon,20,19,1,40,
2025-09-03,Ted Sarandos,Netflix,13,25,2,40,
2025-09-03,William H Rogers Jr,Truist Financial,2,6,1,9,
2025-09-03,Sean Kerins,Arrow Electronics,2,12,0,14,
2025-09-03,William M Brown,3M,2,8,0,10,
2025-09-03,Ryan McInerney,Visa,14,22,4,40,
2025-09-03,Marc Rowan,Apollo Global Management,17,19,4,40,
2025-09-03,Tim Go,HF Sinclair,6,3,0,9,
2025-09-03,Robert Sulentic,CBRE Group,1,7,1,9,
2025-09-03,William Demchak,PNC Financial Services,15,20,5,40,
2025-09-03,Bryan DeBoer,Lithia Motors,13,25,1,39,
2025-09-03,William Nash,CarMax,4,4,2,10,
2025-09-03,Brian Robbins,Paramount Global,3,34,1,38,
2025-09-03,Michael Creedon,Dollar Tree,3,34,3,40,
2025-09-03,Sandy Douglas,United Natural Foods,33,5,2,40,
2025-09-03,Alex Chriss,PayPal,14,23,3,40,
2025-09-03,Roger Penske,Penske Automotive,18,21,1,40,
2025-09-03,Antonio Neri,Hewlett Packard Enterprise,8,24,8,40,
2025-09-03,Harry Sideris,Duke Energy,35,5,0,40,
2025-09-03,Vicki Hollub,Occidental Petroleum,21,14,4,39,
2025-09-03,Lawrence Coben,NRG Energy,5,2,0,7,
2025-09-03,Robert Bradway,Amgen,9,29,2,40,
2025-09-03,John Ketchum,NextEra Energy,22,18,0,40,
2025-09-03,Rainer Blair,Danaher,7,16,2,25,
2025-09-03,Daniel O'Day,Gilead Sciences,19,17,4,40,
2025-09-03,Michael Manley,AutoNation,3,5,1,9,
2025-09-03,Carlos Abrams-Rivera,Kraft Heinz,7,31,2,40,
2025-09-03,Philip Gallagher,Avnet,1,6,1,8,
2025-09-03,Gary Dickerson,Applied Materials,8,21,11,40,
2025-09-03,Bob Jordan,Southwest Airlines,10,23,7,40,
2025-09-03,Rick Wurster,Charles Schwab,14,20,5,39,
2025-09-03,Lorenzo Simonelli,Baker Hughes,17,19,4,40,
2025-09-03,Chris Kempczinski,McDonalds,11,21,8,40,
2025-09-03,Christopher Womack,Southern Company,3,7,0,10,
2025-09-03,Michael Miebach,Mastercard,10,26,4,40,
2025-09-03,Joseph Dominguez,Constellation Energy,13,10,1,24,
2025-09-03,Christopher Swift,The Hartford,16,21,3,40,
2025-09-03,Patricia Poppe,PG&E,8,16,2,26,
2025-09-03,Bom Kim,Coupang,12,27,1,40,
2025-09-03,Ezra Yacob,EOG Resources,24,13,3,40,
2025-09-03,Jim Vena,Union Pacific,17,23,0,40,
2025-09-03,Matt Schroeder,Rite Aid,4,33,3,40,
2025-09-03,Tony Spring,Macys,10,27,3,40,
2025-09-03,Anthony Capuano,Marriott International,14,23,3,40,
2025-09-03,Raymond E Scott,Lear Corporation,6,4,0,10,
2025-09-03,William Stengel II,Genuine Parts,0,2,0,2,
2025-09-03,Heidi Petz,Sherwin-Williams,8,28,3,39,
2025-09-03,Jeff Miller,Halliburton,12,22,6,40,
2025-09-03,Kathleen Quirk,Freeport-McMoRan,13,18,2,33,
2025-09-03,Michael Rapino,Live Nation Entertainment,13,24,3,40,
2025-09-03,John Doyle,Marsh & McLennan,10,7,0,17,
2025-09-03,Lisa Su,Advanced Micro Devices,16,20,4,40,
2025-09-03,Frank Holding,First Citizens BancShares,9,14,2,25,
2025-09-03,John Engel,WESCO International,5,11,1,17,
2025-09-03,David Gitlin,Carrier Global,14,23,3,40,
2025-09-03,Lourenco Goncalves,Cleveland-Cliffs,8,21,11,40,
2025-09-03,Calvin G Butler Jr,Exelon,6,4,0,10,
2025-09-03,Joseph Bae,KKR,20,18,2,40,
2025-09-03,Christine Leahy,CDW,0,10,2,12,
2025-09-03,Glenn Fogel,Booking Holdings,9,24,7,40,
2025-09-03,Brian Doubles,Synchrony Financial,5,7,2,14,
2025-09-03,Earl Austin,Quanta Services,2,7,1,10,
2025-09-03,Christian Ulbrich,Jones Lang LaSalle,8,18,0,26,
2025-09-03,Saumya Sutaria,Tenet Healthcare,5,3,1,9,
2025-09-03,William Gifford,Altria,3,3,2,8,
2025-09-03,Kevin Lobo,Stryker,12,25,3,40,
2025-09-03,Michael Hsu,Kimberly-Clark,6,6,1,13,
2025-09-03,Jack Fusco,Cheniere Energy,18,19,3,40,
2025-09-03,James Conroy,Ross Stores,4,11,0,15,
2025-09-03,Anthony Smurfit,Smurfit Westrock,4,6,0,10,
2025-09-03,Jeffrey Harmening,General Mills,4,18,5,27,
2025-09-03,Mark Stewart,Goodyear Tire & Rubber,5,34,1,40,
2025-09-03,Bob Eddy,BJs Wholesale Club,4,22,3,29,
2025-09-03,Peter Arduini,GE HealthCare Technologies,6,12,0,18,
2025-09-03,Noel Wallace,Colgate-Palmolive,10,25,2,37,
2025-09-03,Marc Bitzer,Whirlpool,12,13,15,40,
2025-09-03,Chris Kubasik,L3Harris Technologies,7,13,1,21,
2025-09-03,Shantanu Narayen,Adobe,19,19,1,39,
2025-09-03,Thomas Polen,Becton Dickinson,6,4,0,10,
2025-09-03,Richard P Dealy,Pioneer Natural Resources,5,1,0,6,
2025-09-03,Ravi Kumar S,Cognizant Technology Solutions,12,23,3,38,
2025-09-03,Andrew Clyde,Murphy USA,13,25,2,40,
2025-09-03,Mike Lyons,Fiserv,5,10,1,16,
2025-09-03,Jennifer Parmentier,Parker-Hannifin,2,12,0,14,
2025-09-03,William Fehrman,American Electric Power,4,6,0,10,
2025-09-03,Andrew Silvernail,International Paper,5,22,0,27,
2025-09-03,Jonas Prising,ManpowerGroup,7,22,2,31,
2025-09-03,John Zillmer,Aramark,6,14,2,22,
2025-09-03,Mark Millett,Steel Dynamics,19,2,0,21,
2025-09-03,Dan Amos,Aflac,13,19,8,40,
2025-09-03,Tony Cheng,Reinsurance Group of America,2,11,2,15,
2025-09-03,Karsanbhai,Emerson Electric,7,16,3,26,
2025-09-03,Ronald P O'Hanley,State Street,7,15,0,22,
2025-09-03,Timothy Knavish,PPG Industries,1,2,1,4,
2025-09-03,David Burritt,United States Steel,8,19,12,39,
2025-09-03,Maria Black,Automatic Data Processing,4,5,0,9,
2025-09-03,Daryl Kenningham,Group 1 Automotive,10,28,2,40,
2025-09-03,Robert Blue,Dominion Energy,28,11,1,40,
2025-09-03,Larry Fink,BlackRock,7,24,9,40,
2025-09-03,Pierce Norton II,Oneok,4,3,1,8,
2025-09-03,David Bozeman,CH Robinson Worldwide,2,7,0,9,
2025-09-03,Haviv Ilan,Texas Instruments,13,24,3,40,
2025-09-03,Michael Bender,Kohls,1,26,13,40,
2025-09-03,Philip Daniele III,AutoZone,0,2,0,2,
2025-09-03,Timothy Archer,Lam Research,2,8,0,10,
2025-09-03,Charles Magro,Corteva,5,3,1,9,
2025-09-03,Rick Lanoha,Peter Kiewit Sons',0,1,0,1,
2025-09-03,Peter Jackson,Builders FirstSource,5,12,1,18,
2025-09-03,Martin Schroeter,Kyndryl,11,27,1,39,
2025-09-03,Hamid Akhavan,EchoStar,5,25,8,38,
2025-09-03,Bill Westrate,American Family Insurance,10,16,2,28,
2025-09-03,Avigal Soreq,Delek US,3,9,5,17,
2025-09-03,Beth Ford,Land O'Lakes,19,20,1,40,
2025-09-03,Walker Martin,Sempra,0,1,0,1,
2025-09-03,Eric Slifka,Global Partners,12,22,6,40,
2025-09-03,DG Macpherson,WW Grainger,2,7,1,10,
2025-09-03,Bob Pragada,Jacobs Solutions,6,7,0,13,
2025-09-03,Pedro Pizarro,Edison International,16,8,16,40,
2025-09-03,William Hornbuckle,MGM Resorts International,6,22,1,29,
2025-09-03,Andrew McMahon,Guardian Life insurance,6,12,0,18,
2025-09-03,Christopher O'Herlihy,Illinois Tool Works,3,5,2,10,
2025-09-03,James Cracchiolo,Ameriprise Financial,2,22,2,26,
2025-09-03,Ryan Marshall,PulteGroup,9,14,11,34,
2025-09-03,Matthew Meloy,Targa Resources,5,5,0,10,
2025-09-03,Michael Rhodes,Ally Financial,11,22,4,37,
2025-09-03,Joseph Fadool,BorgWarner,4,10,0,14,
2025-09-03,St√©phane de La Faverie,Est√©e Lauder,9,27,4,40,
2025-09-03,Benjamin Tisch,Loews,2,7,0,9,
2025-09-03,Brad Beckham,O'Reilly Automotive,4,16,1,21,
2025-09-03,Thomas Gayner,Markel Group,2,8,0,10,
2025-09-03,Donald Allan,Stanley Black & Decker,9,30,1,40,
2025-09-03,Sanjay Mehrotra,Micron Technology,17,21,2,40,
2025-09-03,James Breuer,Fluor,0,2,1,3,
2025-09-03,Thomas Bell,Leidos,9,19,2,30,
2025-09-03,Scott Smith,Viatris,6,4,0,10,
2025-09-03,Kimberly Dang,Kinder Morgan,11,1,0,12,
2025-09-03,Christophe Beck,Ecolab,19,21,0,40,
2025-09-03,Brent Shafer,Baxter International,1,10,0,11,
2025-09-03,Clay Gaspar,Devon Energy,20,4,0,24,
2025-09-03,Steven Cahillane,Kellanova,2,7,0,9,
2025-09-03,Raul Nicholas Vargas Ochoa,Farmers Insurance Exchange,0,0,0,0,
2025-09-03,Darren Rebelez,Caseys General Stores,3,6,0,9,
2025-09-03,Ari Bousbib,IQVIA,6,15,1,22,
2025-09-03,Jon Vander Ark,Republic Services,10,18,12,40,
2025-09-03,Timothy Cofer,Keurig Dr Pepper,0,4,0,4,
2025-09-03,Karla Lewis,Reliance Inc,3,6,0,9,
2025-09-03,David Hult,Asbury Automotive Group,5,33,2,40,
2025-09-03,Darryl Button,Pacific Life,1,8,0,9,
2025-09-03,James Burke,Vistra,6,3,1,10,
2025-09-03,John Barrett,Western & Southern Financial,10,28,2,40,
2025-09-03,William Krueger,The Andersons Inc,0,2,0,2,
2025-09-03,Erik Nordstrom,Nordstrom,5,29,5,39,
2025-09-03,John Wren,Omnicom Group,15,19,6,40,
2025-09-03,Stephanie Ferris,Fidelity National Information Services,16,22,2,40,
2025-09-03,Timothy Cawley,Consolidated Edison,5,5,0,10,
2025-09-03,Joseph Hinrichs,CSX,7,11,1,19,
2025-09-03,Troy Rudd,AECOM,7,24,4,35,
2025-09-03,Kathleen Johnson,Lumen Technologies,3,4,1,8,
2025-09-03,Harry Lawton III,Tractor Supply,1,1,0,2,
2025-09-03,Raul Fernandez,DXC Technology,4,27,1,32,
2025-09-03,Eric Hansotia,AGCO,16,17,1,34,
2025-09-03,David Bruton Smith,Sonic Automotive,5,8,9,22,
2025-09-03,Sasan Goodarzi,Intuit,10,26,4,40,
2025-09-03,Matthew Flannery,United Rentals,33,2,0,35,
2025-09-03,Marc Miller,Universal Health Services,4,21,3,28,
2025-09-03,Michael Mahoney,Boston Scientific,11,29,0,40,
2025-09-03,Judith Marks,Otis Worldwide,2,3,0,5,
2025-09-03,Robert Frenzel,Xcel Energy,3,2,2,7,
2025-09-03,Penny Pennington,Edward Jones,8,26,6,40,
2025-09-03,Daniel Fisher,Ball,1,20,6,27,
2025-09-03,Justin Jude,LKQ,4,6,1,11,
2025-09-03,James Blackledge,Mutual of Omaha,2,33,2,37,
2025-09-03,Bruce Bodine,Mosaic,3,7,0,10,
2025-09-03,Scott Donnelly,Textron,8,29,3,40,
2025-09-03,Adam Schechter,Labcorp Holdings,3,6,1,10,
2025-09-03,Deanna Strable-Soethout,Principal Financial,1,6,0,7,
2025-09-03,Leonard Schleifer,Regeneron Pharmaceuticals,6,27,7,40,
2025-09-03,Paul Shoukry,Raymond James Financial,15,24,1,40,
2025-09-03,Lauren Hobart,Dicks Sporting Goods,13,24,3,40,
2025-09-03,Jamie Whisnant,Auto-Owners Insurance,0,2,0,2,
2025-09-03,Ariane Gorin,Expedia,11,28,1,40,
2025-09-03,Shelley Simpson,JB Hunt Transport Services,9,28,3,40,
2025-09-03,Ren√© Jones,M&T Bank,12,24,4,40,
2025-09-03,Gerardo Norcia,DTE Energy,5,4,0,9,
2025-09-03,Andr√©s Gluski,AES,19,19,0,38,
2025-09-03,Timothy Spence,Fifth Third Bancorp,5,3,2,10,
2025-09-03,Eduardo Menezes,Air Products & Chemicals,4,4,2,10,
2025-09-03,Wendell Weeks,Corning,14,24,2,40,
2025-09-03,Anthony Guzzi,EMCOR Group,4,3,1,8,
2025-09-03,Adam Norwitt,Amphenol,3,17,0,20,
2025-09-03,Jean-Marc Gilson,Westlake Corporation,2,3,2,7,
2025-09-03,Lori Koch,DuPont,7,18,0,25,
2025-09-03,Derek Chang,Liberty Media,36,3,1,40,
2025-09-03,Martina Cheung,S&P Global,11,27,0,38,
2025-09-03,Tim Hingtgen,Community Health Systems,11,27,2,40,
2025-09-03,Brian Tierney,FirstEnergy,6,22,3,31,
2025-09-03,Rick McKenney,Unum Group,5,4,0,9,
2025-09-03,Stanley Bergman,Henry Schein,11,28,1,40,
2025-09-03,Tiang Yew Tan,Western Digital,0,2,0,2,
2025-09-03,Vincent Roche,Analog Devices,13,24,3,40,
2025-09-03,Sean Connolly,Conagra Brands,6,32,2,40,
2025-09-03,Bruce Van Saun,Citizens Financial Group,14,26,0,40,
2025-09-03,Mark George,Norfolk Southern,19,19,2,40,
2025-09-03,Andrew Marsh,Entergy,4,4,0,8,
2025-09-03,Robert Berkley,WR Berkley,8,29,3,40,
2025-09-03,Javier Rodriguez,DaVita,14,14,1,29,
2025-09-03,Michael O'Grady,Northern Trust,25,6,0,31,
2025-09-03,James Snee,Hormel Foods,2,26,1,29,
2025-09-03,Timothy J Donahue,Crown Holdings,1,10,0,11,
2025-09-03,Joseph Ferraro,Avis Budget,3,6,1,10,
2025-09-03,Niraj Shah,Wayfair,7,25,8,40,
2025-09-03,Jos√© Mas,MasTec,7,15,0,22,
2025-09-03,Joseph Nolan,Eversource Energy,5,4,1,10,
2025-09-03,Thomas Palmer,Newmont,5,5,0,10,
2025-09-03,Robert Sanchez,Ryder System,11,9,1,21,
2025-09-03,Michael Nolan,Fidelity National Financial,2,0,0,2,
2025-09-03,Gavin Hattersley,Molson Coors Beverage,5,30,5,40,
2025-09-03,Thomas Reeg,Caesars Entertainment,6,5,0,11,
2025-09-03,Ellen Cooper,Lincoln National,3,7,0,10,
2025-09-03,Bracken Darrell,VF Corporation,9,28,3,40,
2025-09-03,Erik Fyrwald,International Flavors & Fragrances,7,9,2,18,
2025-09-03,Christopher Kastner,Huntington Ingalls Industries,3,5,0,8,
2025-09-03,Shane O'Kelly,Advance Auto Parts,13,23,4,40,
2025-09-03,Ralph LaRossa,Public Service Enterprise Group,10,19,0,29,
2025-09-03,Kecia Steelman,Ulta Beauty,34,4,2,40,
2025-09-03,Michele Buck,Hershey,7,31,2,40,
2025-09-03,Sumit Singh,Chewy,12,23,5,40,
2025-09-03,Steven Vondran,American Tower,4,6,0,10,
2025-09-03,Jeffrey Lorberbaum,Mohawk Industries,11,6,1,18,
2025-09-03,Keith Demmings,Assurant,3,8,0,11,
2025-09-03,Robert Martin,Thor Industries,3,6,1,10,
2025-09-03,Kathleen Mazzarella,Graybar Electric,1,7,2,10,
2025-09-03,Joey Wat,Yum China,12,26,2,40,
2025-09-03,Scott Richardson,Celanese,9,27,4,40,
2025-09-03,David Rawlinson II,QVC,7,15,2,24,
2025-09-03,Alan Armstrong,Williams,22,15,3,40,
2025-09-03,Philippe Krakowsky,Interpublic Group,13,25,2,40,
2025-09-03,Brendan McCracken,Ovintiv,6,5,0,11,
2025-09-03,Andrew Teno,Icahn Enterprises,5,6,0,11,
2025-09-03,Stephen Steinour,Huntington Bancshares,1,9,0,10,
2025-09-03,Timothy NeCastro,Erie Insurance,3,6,1,10,
2025-09-03,Ernest Garcia III,Carvana,21,15,4,40,
2025-09-03,R Bruce McDonald,Dana Incorporated,3,7,1,11,
2025-09-03,William Oplinger,Alcoa Corporation,2,6,1,9,
2025-09-03,Mark Pearson,Equitable,7,8,0,15,
2025-09-03,Richard Wallace,KLA,5,5,0,10,
2025-09-03,Ricardo Cardenas,Darden Restaurants,4,3,1,8,
2025-09-03,Mikael Bratt,Autoliv,6,7,2,15,
2025-09-03,Benito Minicucci,Alaska Air,3,4,1,8,
2025-09-03,Christopher Gorman,KeyCorp,5,5,0,10,
2025-09-03,Robert Goldstein,Las Vegas Sands,5,30,5,40,
2025-09-03,Edward Pesicka,Owens & Minor,3,33,2,38,
2025-09-03,Christopher Nassetta,Hilton Worldwide,7,16,2,25,
2025-09-03,Jamie Iannone,Ebay,19,16,5,40,
2025-09-03,Patrick Gallagher,Arthur J Gallagher,9,29,2,40,
2025-09-03,Rich Steinmeier,LPL Financial,25,13,2,40,
2025-09-03,Stephen Spray,Cincinnati Financial,1,6,3,10,
2025-09-03,Douglas Yearley,Toll Brothers,10,24,6,40,
2025-09-03,Gregory Brown,Motorola Solutions,2,8,0,10,
2025-09-03,Brian Chesky,Airbnb,4,28,8,40,
2025-09-03,Jeffrey Sprecher,Intercontinental Exchange,14,23,3,40,
2025-09-03,Robert Thomson,News Corp,7,30,3,40,
2025-09-03,Scott Boatwright,Chipotle Mexican Grill,8,27,5,40,
2025-09-03,Reshma Kewalramani,Vertex Pharmaceuticals,20,15,5,40,
2025-09-03,Christopher Viehbacher,Biogen,0,26,2,28,
2025-09-03,Malcolm Wilson,GXO Logistics,6,21,0,27,
2025-09-03,Tony Sarsam,SpartanNash,16,22,2,40,
2025-09-03,Michael O‚ÄôSullivan,Burlington Stores,8,28,4,40,
2025-09-03,Teresa Rasmussen,Thrivent Financial for Lutherans,4,0,0,4,
2025-09-03,Eugene Bredow,NVR,0,4,0,4,
2025-09-03,Brian Chambers,Owens Corning,3,11,0,14,
2025-09-03,Rafael Santana,Westinghouse Air Brake Technologies,3,7,1,11,
2025-09-03,John Pfeifer,Oshkosh,5,24,5,34,
2025-09-03,Cameron Bready,Global Payments,8,30,2,40,
2025-09-03,Calvin McDonald,Lululemon athletica,8,31,1,40,
2025-09-03,J Kent Masters,Albemarle Corporation,3,6,0,9,
2025-09-03,Joanna Geraghty,JetBlue Airways,15,18,7,40,
2025-09-03,Robert Steer,Seaboard,1,4,0,5,
2025-09-03,William Newlands,Constellation Brands,0,2,2,4,
2025-09-03,Michael Doss,Graphic Packaging,3,9,1,13,
2025-09-03,Gil West,Hertz,7,23,10,40,
2025-09-03,Malcolm C Roberts,FM Global,2,9,2,13,
2025-09-03,Mick Beekhuizen,Campbell Soup,9,23,1,33,
2025-09-03,Daniel Wall,Expeditors International of Washington,3,4,0,7,
2025-09-03,Gregory Roberts,A-Mark Precious Metals,1,4,1,6,
2025-09-03,Horacio Rozanski,Booz Allen Hamilton,17,18,5,40,
2025-09-03,James Davis,Quest Diagnostics,5,5,0,10,
2025-09-03,Dennis Mathew,Altice,5,28,7,40,
2025-09-03,Stefan Larsson,PVH,11,24,5,40,
2025-09-03,Mark Costa,Eastman Chemical,5,16,4,25,
2025-09-03,Joyce Mullen,Insight Enterprises,6,9,1,16,
2025-09-03,John Turner,Regions Financial,19,19,2,40,
2025-09-03,Julian G Francis,Beacon Roofing Supply,0,1,0,1,
2025-09-03,Blake Moret,Rockwell Automation,10,28,2,40,
2025-09-03,Mike Speetzen,Polaris Inc,2,16,2,20,
2025-09-03,William McDermott,ServiceNow,2,6,0,8,
2025-09-03,Jure Sola,Sanmina,3,11,0,14,
2025-09-03,Bob Flexon,UGI Utilities Inc,0,1,0,1,
2025-09-03,Scott Lauber,WEC Energy,13,6,0,19,
2025-09-03,Jon Rousseau,BrightSpring Health Services,20,20,0,40,
2025-09-03,Todd Schneider,Cintas,13,17,2,32,
2025-09-03,Peter Matt,Commercial Metals,5,4,0,9,
2025-09-03,Robert D Lawler,Continental Resources,1,0,0,1,
2025-09-03,Domenic Dell‚ÄôOsso Jr,Expand Energy,4,0,0,4,
2025-09-03,Jason P Wells,CenterPoint Energy,9,3,1,13,
2025-09-03,H Michael Krimbill,NGL Energy Partners,4,3,0,7,
2025-09-03,Tony Xu,DoorDash,16,17,7,40,
2025-09-03,Clay Williams,NOV,7,21,5,33,
2025-09-03,Kristin Peck,Zoetis,13,19,1,33,
2025-09-03,Mark Smucker,JM Smucker,12,21,7,40,
2025-09-03,Steve Sanghi,Microchip Technology,8,27,5,40,
2025-09-03,Richard Tobin,Dover Corporation,5,3,0,8,
2025-09-03,Kaes Van‚Äôt Hof,Diamondback Energy,22,14,3,39,
2025-09-03,Deon Stander,Avery Dennison,0,13,0,13,
2025-09-03,Vincent Sorgi,PPL,8,10,1,19,
2025-09-03,Hassane El-Khoury,ON Semiconductor,2,18,4,24,
2025-09-03,Arie Kotler,ARKO,5,22,1,28,
2025-09-03,William Monteleone,Par Pacific,1,7,2,10,
2025-09-03,John Christmann IV,APA,6,4,0,10,
2025-09-03,Adaire Fox-Martin,Equinix,16,20,4,40,
2025-09-03,Joseph M Otting,Flagstar Financial,2,6,1,9,
2025-09-03,Mary Dillon,Foot Locker,9,25,6,40,
2025-09-03,James Zallie,Ingredion,4,5,1,10,
2025-09-03,Christopher Peterson,Newell Brands,0,9,1,10,
2025-09-03,Scott Salmirs,ABM Industries,6,9,1,16,
2025-09-03,Christopher Hilger,Securian Financial,0,7,1,8,
2025-09-03,Hamid Moghadam,Prologis,6,28,6,40,
2025-09-03,Stephen Schwarzman,Blackstone,16,19,5,40,
2025-09-03,Robert Greenberg,Skechers USA,6,23,3,32,
2025-09-03,Keith Allman,Masco,4,9,1,14,
2025-09-03,Rusty Rush,Rush Enterprises,14,23,3,40,
2025-09-03,Jennifer Johnson,Franklin Resources,2,6,2,10,
2025-09-03,Gerry P Smith,ODP Business Solutions,0,0,0,0,
2025-09-03,Carl Lindner lll,American Financial,0,0,0,0,
2025-09-03,Mark Kowlzan,Packaging Corp of America,0,8,1,9,
2025-09-03,Thomas Hill,Vulcan Materials,4,6,2,12,
2025-09-03,Milan Galik,Interactive Brokers,7,20,1,28,
2025-09-03,Laura Alber,Williams-Sonoma,14,22,4,40,
2025-09-03,Mario Harik,XPO,8,31,1,40,
2025-09-03,Devin Stockfish,Weyerhaeuser,5,5,0,10,
2025-09-03,Thomas J McInerney,Genworth Financial,0,5,0,5,
2025-09-03,Garrick Rochow,CMS Energy,11,3,1,15,
2025-09-03,Toni Townes-Whitley,Science Applications International,12,21,1,34,
2025-09-03,Rich Handler,Jefferies Financial,12,10,2,24,
2025-09-03,Daniel Heaf,Bath & Body Works,12,26,2,40,
2025-09-03,Andrew Wilson,Electronic Arts,15,16,9,40,
2025-09-03,Sheryl Palmer,Taylor Morrison Home,7,12,1,20,
2025-09-03,Ivan Tornos,Zimmer Biomet,8,29,3,40,
2025-09-03,Linda Rendle,Clorox,2,34,2,38,
2025-09-03,Matthew Pine,Xylem Inc,1,8,1,10,
2025-09-03,Heather Lavallee,Voya Financial,7,9,2,18,
2025-09-03,Daniel Florness,Fastenal,2,5,1,8,
2025-09-03,Albert Nahmad,Watsco,2,8,0,10,
2025-09-03,Carl Eschenbach,Workday,12,19,9,40,
2025-09-03,Craig Smiddy,Old Republic International,3,6,1,10,
2025-09-03,Frank C Sullivan,RPM International,4,8,0,12,
2025-09-03,Matthew Missad,UFP Industries,7,3,0,10,
2025-09-03,Martin J Lyons,Ameren,1,4,1,6,
2025-09-03,Adam W Miller,Knight Swift Transportation,0,3,1,4,
2025-09-03,Rodney Sacks,Monster Beverage,14,24,1,39,
2025-09-03,Gary Guthart,Intuitive Surgical,14,24,2,40,
2025-09-03,Charles Liang,Super Micro Computer,33,6,1,40,
2025-09-03,Christopher Caldwell,Concentrix,3,5,0,8,
2025-09-03,Gordon J Hardie,O-I Glass,0,3,0,3,
2025-09-03,David Gibbs,Yum Brands,3,37,0,40,
2025-09-03,Steve Henry,Domtar,5,5,0,10,
2025-09-03,Chuck Treadway,CommScope,8,19,3,30,
2025-09-03,Rob Vitale,Post Holdings,1,11,5,17,
2025-09-03,Steven J Moskowitz,Crown Castle,2,5,3,10,
2025-09-03,Emmanuel Ligner,Avantor,2,11,1,14,
2025-09-03,Stuart Bradie,KBR,16,16,4,36,
2025-09-03,Carrie Wheeler,Opendoor Technologies,10,28,2,40,
2025-09-03,Russell Becker,APi Group,4,5,0,9,
2025-09-03,Toby Rice,EQT,24,14,2,40,
2025-09-03,Jesse Arenivas,EnLink Midstream,7,10,0,17,
2025-09-03,Nikesh Arora,Palo Alto Networks,7,24,9,40,
2025-09-03,Steven Bandrowczak,Xerox,1,8,1,10,
2025-09-03,Vicente Reynal,Ingersoll Rand,7,26,0,33,
2025-09-03,William T Dillard II,Dillards,3,5,2,10,
2025-09-03,C Howard Nye,Martin Marietta Materials,1,5,4,10,
2025-09-03,Giordano Albertazzi,Vertiv,16,19,4,39,
2025-09-03,Stephane Bancel,Moderna,9,21,10,40,
2025-09-03,Nate R Jorgensen,Boise Cascade,0,0,0,0,
2025-09-03,Jack Sinclair,Sprouts Farmers Market,15,24,1,40,
2025-09-03,Padraig McDonnell,Agilent Technologies,10,16,0,26,
2025-09-03,Kenneth T Lane,Olin,0,1,0,1,
2025-09-03,Randall C Stuewe,Darling Ingredients,29,1,0,30,
2025-09-03,R Howard Coker,Sonoco Products,4,5,1,10,
2025-09-03,John Mengucci,CACI International,21,17,2,40,
2025-09-03,Mark Witkowski,Core & Main,0,8,1,9,
2025-09-03,Lee M Tillman,Marathon Oil,4,4,0,8,
2025-09-03,Mark Hoplamazian,Hyatt Hotels,15,20,5,40,
2025-09-03,David S Chernow,Select Medical,0,8,1,9,
2025-09-03,Brendan M Foley,McCormick & Company,0,8,0,8,
2025-09-03,Joanne Crevoiserat,Tapestry,14,23,3,40,
2025-09-03,John Plant,Howmet Aerospace,6,14,3,23,
2025-09-03,Shankh Mitra,Welltower,19,19,2,40,
2025-09-03,W Anthony Will,CF Industries,5,4,0,9,
2025-09-03,David A Zapico,Ametek,2,17,0,19,
2025-09-03,Kevin Stein,TransDigm,10,8,3,21,
2025-09-03,Craig Billings,Wynn Resorts,13,25,2,40,
2025-09-03,William J Way,Southwestern Energy,1,1,0,2,
2025-09-03,Giel Rutten,Amkor Technology,2,9,1,12,
2025-09-03,Paul Sarvadi,Insperity,4,4,1,9,
2025-09-03,Donald Zurbay,Patterson Companies Inc,0,1,0,1,
2025-09-03,Rob Sharps,T Rowe Price,12,20,7,39,
2025-09-03,Patrice Louvet,Ralph Lauren,13,17,10,40,
2025-09-03,Jeffrey Mezger,KB Home,1,29,10,40,
2025-09-03,David M Foulkes,Brunswick,0,7,0,7,
2025-09-03,M Keith Waddell,Robert Half,2,9,1,12,
2025-09-03,Jay Snowden,PENN Entertainment,18,19,3,40,
2025-09-03,George Kurian,NetApp,15,22,3,40,
2025-09-03,Kevin Ali,Organon,9,18,0,27,
2025-09-03,Joel D Anderson,Petco Health and Wellness,3,9,0,12,
2025-09-03,Louis V Pinkham,Regal Rexnord,0,0,0,0,
2025-09-03,Jay Geldmacher,Resideo Technologies,9,5,1,15,
2025-09-03,Marcus Lemonis,Camping World,6,24,10,40,
2025-09-03,Peter R Huntsman,Huntsman,5,12,4,21,
2025-09-03,Hillary Super,Victorias Secret,11,5,8,24,
2025-09-03,Michelle Gass,Levi Strauss,11,25,3,39,
2025-09-03,Neil Hunn,Roper Technologies,2,20,0,22,
2025-09-03,Steven P Lawrence,Academy Sports and Outdoors,1,1,0,2,
2025-09-03,Phillippe Lord,Meritage Homes,9,15,0,24,
2025-09-03,David C Dauch,American Axle & Manufacturing,4,6,2,12,
2025-09-03,Olumide Soroye,Fortive,1,8,0,9,
2025-09-03,Adena Friedman,Nasdaq,13,23,4,40,
2025-09-03,Tim Gokey,Broadridge Financial Solutions,3,13,1,17,
2025-09-03,Patrick M Shanahan,Spirit AeroSystems,1,9,0,10,
2025-09-03,Robert Kyncl,Warner Music Group,8,31,1,40,
2025-09-03,Denise Dignam,Chemours,2,19,4,25,
2025-09-03,Jim DeVries,ADT,9,7,1,17,
2025-09-03,Bernard Zovighian,Edwards Lifesciences,7,5,2,14,
2025-09-03,Mark E Seaton,First American Financial,1,9,0,10,
2025-09-03,John C Roche,Hanover Insurance Group,6,21,1,28,
2025-09-03,Adam J Greenlee,Silgan,0,4,0,4,
2025-09-03,Jayne Hrdlicka,Endeavor Group,0,1,0,1,
2025-09-03,Robert Fauber,Moodys Corporation,0,6,0,6,
2025-09-03,Thomas E Jorden,Coterra Energy,9,0,0,9,
2025-09-03,Eugene A Hall,Gartner,0,10,0,10,
2025-09-03,Kevin Plank,Under Armour,8,30,2,40,
2025-09-03,James W Lanning,Ingles Markets,3,4,0,7,
2025-09-03,Matthew T Farrell,Church & Dwight,6,7,0,13,
2025-09-03,Kevin M Freeman,Old Dominion Freight Line,0,0,0,0,
2025-09-03,Joe Shoen,U-Haul,14,21,4,39,
2025-09-03,Mark Bertolini,Oscar Health,12,19,9,40,
2025-09-03,Jayshree Ullal,Arista Networks,20,19,1,40,
2025-09-03,Sassine Ghazi,Synopsys,11,26,3,40,
2025-09-03,Jochen Zeitz,Harley-Davidson,6,24,10,40,
2025-09-03,Nick Jeffery,Frontier Communications,10,24,2,36,
2025-09-03,Thomas Edward McCormick,Primoris Services,0,4,0,4,
2025-09-03,D Christian Koch,Carlisle Companies,1,4,1,6,
2025-09-03,David E Simon,Simon Property Group,3,5,2,10,
2025-09-03,Stephen Bratspies,Hanesbrands,4,11,1,16,
2025-09-03,Ryan M. Schneider,Anywhere Real Estate Inc,0,1,0,1,
2025-09-03,George Bobb III,Teledyne Technologies,1,4,1,6,
2025-09-03,Terrence A Duffy,CME Group,6,8,1,15,
2025-09-03,Rami Rahim,Juniper Networks,11,27,2,40,
2025-09-03,Sue Nabi,Coty,16,18,6,40,
2025-09-03,Peter D Arvan,Pool Corporation,2,7,0,9,
2025-09-03,David Campbell,Evergy,13,9,0,22,
2025-09-03,Matthew J Murphy,Marvell Technology,5,4,1,10,
2025-09-03,Lloyd Yates,NiSource,6,4,0,10,
2025-09-03,William C Stone,SS&C Technologies,2,6,0,8,
2025-09-03,Mark Rourke,Schneider National,10,18,1,29,
2025-09-03,Andrew Anagnost,Autodesk,7,25,8,40,
2025-09-03,Dustin Semach,Sealed Air Corporation,0,10,0,10,
2025-09-03,William L Meaney,Iron Mountain,2,20,0,22,
2025-09-03,Andy P Power,Digital Realty Trust,0,0,0,0,
2025-09-03,Satish Dhanasekaran,Keysight Technologies,3,11,0,14,
2025-09-03,Frank M Svoboda,Globe Life,3,4,3,10,
2025-09-03,Carey A Smith,Parsons Corporation,1,3,0,4,
2025-09-03,Ynon Kreiz,Mattel,10,22,8,40,
2025-09-03,Karen S Haller,Southwest Gas,3,6,0,9,
2025-09-03,Terrance Williams,TruStage,4,6,1,11,
2025-09-03,Eric W Gerstenberg,Clean Harbors,3,2,2,7,
2025-09-03,Gunner Smith,Cornerstone Building Brands,1,8,0,9,
2025-09-03,Gerben W Bakker,Hubbell,1,5,0,6,
2025-09-03,Dave Davis,Spirit Airlines,3,34,3,40,
2025-09-03,Michael J Smith,Lamb Weston,0,7,3,10,
2025-09-03,Strauss Zelnick,Take-Two Interactive Software,13,18,9,40,
2025-09-03,John C Turner Jr,GMS,3,6,0,9,
2025-09-03,David M O'Malley,Penn Mutual Life Insurance,1,1,0,2,
2025-09-03,Frank A Lonegro,Landstar System,3,3,0,6,
2025-09-03,James F Risoleo,Host Hotels & Resorts,6,17,0,23,
2025-09-03,Ken Xie,Fortinet,13,21,6,40,
2025-09-03,Doug Shulman,OneMain,3,6,0,9,
2025-09-03,Ryan Cohen,GameStop,11,21,8,40,
2025-09-03,Mark W Begor,Equifax,2,12,0,14,
2025-09-03,Jay L Schottenstein,American Eagle Outfitters,9,16,1,26,
2025-09-03,Curtis C Farmer,Comerica,4,9,0,13,
2025-09-03,Ole Rosgaard,Greif,3,16,1,20,
2025-09-03,Brian E Lane,Comfort Systems USA,10,0,0,10,
2025-09-03,Robert M Buck,TopBuild,0,5,1,6,
2025-09-03,Ralph Andretta,Bread Financial,3,9,0,12,
2025-09-03,Jim Anderson,Coherent,6,34,0,40,
2025-09-03,Walter C. D. Carlson,Telephone & Data Systems,0,2,0,2,
2025-09-03,Ronald Kruszewski,Stifel Financial,7,6,0,13,
2025-09-03,Richard Hayne,Urban Outfitters,10,21,9,40,
2025-09-03,Simon Meester,Terex,4,7,0,11,
2025-09-03,Edward J Lehner,Ryerson Holding,0,2,1,3,
2025-09-03,Nicholas T Pinchuk,Snap-on,4,5,0,9,
2025-09-03,Ryals McMullian,Flowers Foods,5,28,2,35,
2025-09-03,D Bryan Jordan,First Horizon,4,8,1,13,
2025-09-03,John B Gibson,Paychex,3,6,0,9,
2025-09-03,Chris Cocks,Hasbro,11,19,10,40,
2025-09-03,Pete McPartland,Sentry Insurance Group,0,2,0,2,
2025-09-03,Michael Arougheti,Ares Management,17,21,2,40,
2025-09-03,Alok Maskara,Lennox International,6,3,1,10,
2025-09-03,James C Grech,Peabody Energy,3,0,0,3,
2025-09-03,Joseph P Lacher Jr,Kemper,4,18,4,26,
2025-09-03,Perry A Sook,Nexstar Media Group,7,29,1,37,
2025-09-03,Wade Davis,TelevisaUnivision,14,24,2,40,
2025-09-03,Scott L Thompson,Tempur Sealy International,0,7,0,7,
2025-09-03,Mike Simonds,TriNet Group,0,9,0,9,
2025-09-03,B Andrew Rose,Worthington Enterprises,1,2,0,3,
2025-09-03,Bruce L Caswell,Maximus,4,6,0,10,
2025-09-03,Robert L Reffkin,Compass,1,6,0,7,
2025-09-03,Mark Eubanks,Brinks Company,1,2,1,4,
2025-09-03,Peter Quigley,Kelly Services inc,2,7,0,9,
2025-09-03,David L Yowan,Navient,2,3,0,5,
2025-09-03,Mary E Kipp,Puget Sound Energy,4,0,2,6,
2025-09-03,Adam Aron,AMC Entertainment,17,15,8,40,
2025-09-03,Mark J Tarr,Encompass Health,2,6,1,9,
2025-09-03,Liam K Griffin,Skyworks Solutions,1,6,1,8,
2025-09-03,Richard G Kyle,Timken,8,24,2,34,
2025-09-03,Ron Gusek,Liberty Energy,21,1,0,22,
2025-09-03,John E Geller Jr,Marriott Vacations Worldwide,6,6,0,12,
2025-09-03,Karl G. Glassman,Leggett & Platt,0,5,0,5,
2025-09-03,Bruce K Thorn,Big Lots,3,5,2,10,
2025-09-03,Jonathan H Weis,Weis Markets,11,28,0,39,
2025-09-03,Jeffrey B Guldner,Pinnacle West Capital,1,4,0,5,
2025-09-03,Arkadiy Dobkin,EPAM Systems,11,18,2,31,
2025-09-03,Paul M Rady,Antero Resources,4,9,0,13,
2025-09-03,Michael Spanos,Bloomin Brands,1,8,1,10,
2025-09-03,Nicole A Kivisto,MDU Resources Group,1,5,0,6,
2025-09-03,Gerald L Morgan,Texas Roadhouse,3,3,4,10,
2025-09-03,Gabriel Tirador,Mercury General,4,4,2,10,
2025-09-03,Nicholas I Fink,Fortune Brands Innovations,2,4,0,6,
2025-09-03,Paul E Burdiss,Zions Bancorp,1,1,0,2,
2025-09-03,William J Christensen,JELD-WEN Holding,4,5,0,9,
2025-09-03,Evan Spiegel,Snap Inc,20,17,3,40,
2025-09-03,Bill Burns,Zebra Technologies,8,25,1,34,
2025-09-03,Steven Sell,Agilon Health,1,5,3,9,
2025-09-03,Richard M Olson,Toro Company,1,15,1,17,
2025-09-03,Eric S Yuan,Zoom Video Communications,5,8,0,13,
2025-09-03,Dan L Batrack,Tetra Tech,2,5,1,8,
2025-09-03,Joseph D Russell Jr,Public Storage,0,8,0,8,
2025-09-03,Jacob Thaysen,Illumina inc,5,7,0,12,
2025-09-03,Debra A Cafaro,Ventas inc,7,5,0,12,
2025-09-03,Pierre R Brondeau,FMC Corporation,0,4,0,4,
2025-09-03,Judy R McReynolds,ArcBest,6,14,1,21,
2025-09-03,Russell J Weiner,Dominos Pizza inc,0,0,0,0,
2025-09-03,Theodore S Hanson,ASGN,0,3,0,3,
2025-09-03,RJ Scaringe,Rivian Automotive,10,29,1,40,
2025-09-03,Jeffrey N Simmons,Elanco Animal Health,2,5,1,8,
2025-09-03,Tim O Shaughnessy,Graham Holdings Company,3,6,0,9,
2025-09-03,Thomas V Taylor,Floor & Decor,1,1,2,4,
2025-09-03,Neil A Schrimsher,Applied Industrial Technologies,5,23,1,29,
2025-09-03,Robert E Price,PriceSmart,4,6,0,10,
2025-09-03,John David Risher,Lyft,1,4,2,7,
2025-09-03,Gary B Smith,Ciena,4,8,0,12,
2025-09-03,Joey Levin,IAC,7,31,1,39,
2025-09-03,Jim Jacobs,Country Financial,7,3,1,11,
2025-09-03,Devin B McGranahan,Western Union,1,6,0,7,
2025-09-03,R Scott Rowe,Flowserve,5,4,1,10,
2025-09-03,Kenneth A Vecchione,Western Alliance Bancorp,0,0,1,1,
2025-09-03,John C Rademacher,Option Care Health,10,1,0,11,
2025-09-03,Doug Black,SiteOne Landscape Supply,3,24,2,29,
2025-09-03,Oliver G Brewer III,Topgolf Callaway Brands,1,0,0,1,
2025-09-03,Glenn Sanford,eXp World,14,22,4,40,
2025-09-03,Fran Horowitz,Abercrombie & Fitch,15,18,7,40,
2025-09-03,Kevin Akers,Atmos Energy,7,2,1,10,
2025-09-03,Alessandro Maselli,Catalent,4,11,2,17,
2025-09-03,J Powell Brown,Brown & Brown,11,21,8,40,
2025-09-03,Aman Bhutani,GoDaddy,17,21,2,40,
2025-09-03,John C. Griffith,American Water Works,1,3,0,4,
2025-09-03,John J Marchioni,Selective Insurance Group,4,12,3,19,
2025-09-03,Lawson E Whiting,Brown-Forman,1,7,2,10,
2025-09-03,Dave Peacock,Advantage Solutions,21,7,0,28,
2025-09-03,Mick Farrell,ResMed,16,22,1,39,
2025-09-03,Kamal Hathi,Splunk,1,4,0,5,
2025-09-03,Todd Kelsey,Plexus,2,7,0,9,
2025-09-03,Phillip D Yeager,Hub Group,3,6,0,9,
2025-09-03,Steven B Hedlund,Lincoln Electric,5,10,0,15,
2025-09-03,Timothy C Oliver,NCR Atleos,0,1,0,1,
2025-09-03,Bruce Fleming,Calumet,2,7,0,9,
2025-09-03,Daniel S. Peyovich,Dycom Industries,1,6,0,7,
2025-09-03,Avner M Applbaum,Valmont Industries,0,7,2,9,
2025-09-03,Kimberly A Fields,ATI inc,5,10,0,15,
2025-09-03,Khozema Z Shipchandler,Twilio,0,2,0,2,
2025-09-03,Gary C Bhojwani,CNO Financial Group,1,6,1,8,
2025-09-03,William Andrew Hendricks Jr,Patterson-UTI Energy,1,0,0,1,
2025-09-03,Kevin D Hochman,Brinker International,1,4,1,6,
2025-09-03,James C Foster,Charles River Laboratories International,2,9,1,12,
2025-09-03,Rajiv K Prasad,Hyster-Yale,2,5,0,7,
2025-09-03,Eric T Steigerwalt,Brighthouse Financial,1,2,0,3,
2025-09-03,Thomas L Ryan,Service Corp International,6,4,0,10,
2025-09-03,Charles M Nifong Jr,CrossAmerica Partners,0,0,0,0,
2025-09-03,Anirudh Devgan,Cadence,7,18,1,26,
2025-09-03,Andi Owen,MillerKnoll,16,15,9,40,
2025-09-03,Sumit Roy,Realty Income,12,16,2,30,
2025-09-03,Timothy John Fitzgerald,Middleby,0,0,0,0,
2025-09-03,Robert H Schottenstein,M/I Homes,3,8,0,11,
2025-09-03,Stephen P MacMillan,Hologic,1,8,0,9,
2025-09-03,Lisa M Barton,Alliant Energy,5,0,0,5,
2025-09-03,Aaron P Jagdfeld,Generac,1,5,0,6,
2025-09-03,Erik Gershwind,MSC Industrial Direct,3,5,2,10,
2025-09-03,Varun Krishna,Rocket Companies,9,30,1,40,
2025-09-03,Fahmi Karam,Upbound Group,4,5,0,9,
2025-09-03,NADominic Ng,East West Bancorp,0,0,0,0,
2025-09-03,Mark Wang,Hilton Grand Vacations,38,2,0,40,
2025-09-03,Robert J Sheedy Jr,Grocery Outlet Holding,0,0,0,0,
2025-09-03,Simon D Campion,Dentsply Sirona,0,3,0,3,
2025-09-03,Jeremy Wensinger,V2X,7,9,0,16,
2025-09-03,Andrew Rees,Crocs,14,13,13,40,
2025-09-03,David M Maura,Spectrum Brands,6,1,0,7,
2025-09-03,Sachin S Lawande,Visteon,0,1,0,1,
2025-09-03,Neil M Ashe,Acuity Inc,0,1,0,1,
2025-09-03,Lorie L Tekorius,Greenbrier,2,8,0,10,
2025-09-03,John R Ciulla,Webster Financial,5,5,0,10,
2025-09-03,Sean D Keohane,Cabot Corporation,4,4,0,8,
2025-09-03,Drew M Wilkerson,RXO inc,0,0,0,0,
2025-09-03,Daniel E Brown,Chord Energy,1,1,0,2,
2025-09-03,Javier D Ferrer Fernandez,Popular inc,0,0,0,0,
2025-09-03,Olivier Rabiller,Garrett Motion inc,4,9,0,13,
2025-09-03,Ronald N Tutor,Tutor Perini Corporation,3,6,0,9,
2025-09-03,Jeff Liaw,Copart,4,5,0,9,
2025-09-03,Aman Narang,Toast inc,5,5,1,11,
2025-09-03,Joseph M Hogan,Align Technology,3,5,0,8,
2025-09-03,Kevin J Wheeler,A O Smith,0,15,1,16,
2025-09-03,Christopher A Cartwright,TransUnion,2,0,2,4,
2025-09-03,James Kelly,NCR Voyix,2,12,1,15,
2025-09-03,Tom Leighton,Akamai Technologies,13,15,6,34,
2025-09-03,Robert G Painter,Trimble,7,2,0,9,
2025-09-03,Tony Helton,Medical Mutual of Ohio,1,4,1,6,
2025-09-03,Caroline S Grace,AMN Healthcare Services,0,0,0,0,
2025-09-03,Patrick Kaltenbach,Mettler-Toledo International,2,6,1,9,
2025-09-03,Michael L Baur,ScanSource,0,3,0,3,
2025-09-03,Jason Lippert,LCI Industries,2,11,0,13,
2025-09-03,Fredric J Tomczyk,Cboe Global Markets,1,6,0,7,
2025-09-03,Octavio Marquez,Diebold Nixdorf,6,9,1,16,
2025-09-03,Sivasankaran Somasundaram,ChampionX,7,2,0,9,
2025-09-03,Ronald F Clarke,Corpay,0,1,0,1,
2025-09-03,Robert W Pittman,iHeartMedia,5,3,0,8,
2025-09-03,Patrick Zalupski,Dream Finders Homes,22,16,2,40,
2025-09-03,Keith E Smith,Boyd Gaming,1,6,1,8,
2025-09-03,Mehran Assadi,NLV Financial,1,1,0,2,
2025-09-03,Barry R Port,Ensign Group,3,5,1,9,
2025-09-03,Denise A Paulonis,Sally Beauty,1,2,0,3,
2025-09-03,Clifford A Skelton,Conduent,0,0,0,0,
2025-09-03,Jean-Michel Ribieras,Sylvamo,2,7,0,9,
2025-09-03,Douglas F Bauer,Tri Pointe Homes,0,5,0,5,
2025-09-03,Shawn O'Connell,EnerSys,2,5,0,7,
2025-09-03,Bill Meury,Incyte,8,16,0,24,
2025-09-03,Dale Francescon,Century Communities,2,9,3,14,
2025-09-03,Michael Nierenberg,Rithm Capital,6,27,1,34,
2025-09-03,Michael J Brown,Euronet Worldwide,2,8,0,10,
2025-09-03,Scott Seu,Hawaiian Electric Industries,4,17,2,23,
2025-09-03,Jason D Robins,DraftKings,5,3,0,8,
2025-09-03,Jonathan J Mazelsky,IDEXX Laboratories,1,2,1,4,
2025-09-03,Richard S Swartz,MYR Group,0,2,0,2,
2025-09-03,Stefano Caroti,Deckers Outdoor,2,6,1,9,
2025-09-03,Kevin R Sayer,DexCom,2,4,0,6,
2025-09-03,John T C Lee,MKS Instruments,5,9,1,15,
2025-09-03,Edward B Pitoniak,VICI Properties,1,7,0,8,
2025-09-03,Albert White III,Cooper Cos,0,0,0,0,
2025-09-03,Barry L Biffle,Frontier Airlines,1,6,6,13,
2025-09-03,Robert A Bruggeworth,Qorvo,5,4,0,9,
2025-09-03,Winnie Park,Five Below,9,28,3,40,
2025-09-03,Steven Oakland,TreeHouse Foods,2,12,0,14,
2025-09-03,James S Hagedorn,Scotts Miracle-Gro,1,0,0,1,
2025-09-03,Michael Cannon-Brookes,Atlassian,19,19,1,39,
2025-09-03,Bertrand Loy,Entegris,3,11,1,15,
2025-09-03,William E Waltz,Atkore,2,7,0,9,
2025-09-03,Celeste B Mastin,H B Fuller,1,4,0,5,
2025-09-03,Kyle T Larkin,Granite Construction,1,6,0,7,
2025-09-03,Michael J Happe,Winnebago Industries,1,3,0,4,
2025-09-03,Steven H Gunby,FTI Consulting,5,10,0,15,
2025-09-03,Stephan B Tanda,AptarGroup,0,4,3,7,
2025-09-03,Timothy P Boyle,Columbia Sportswear,3,3,2,8,
2025-09-03,Anthony J Wood,Roku,4,5,1,10,
2025-09-03,M Christopher Doyle,Civitas Resources,1,2,0,3,
2025-09-03,Andy Eidson,Alpha Metallurgical Resources,1,7,2,10,
2025-09-03,Andy L Nemeth,Patrick Industries,4,1,0,5,
2025-09-03,Roger W Jenkins,Murphy Oil,3,16,0,19,
2025-09-03,Kevin S Blair,Synovus Financial,7,2,0,9,
2025-09-03,Julie Felss Masino,Cracker Barrel Old Country Store,7,18,15,40,
2025-09-03,David M Overton,Cheesecake Factory,1,9,0,10,
2025-09-03,Nick DeIuliis,CNX Resources,8,3,1,12,
2025-09-03,Christopher Pappas,Chefs Warehouse,3,7,1,11,
2025-09-03,Tod Carpenter,Donaldson Company,2,8,0,10,
2025-09-03,Gregory L Christopher,Mueller Industries,2,6,0,8,
2025-09-03,Rob Saltiel,MRC Global,7,13,2,22,
2025-09-03,Jillian C Evanko,Chart Industries,3,6,0,9,
2025-09-03,Dave Guilmette,Alight Solutions,3,7,0,10,
2025-09-03,Joel Smejkal,Vishay Intertechnology,4,4,1,9,
2025-09-03,Dennis Degner,Range Resources,3,7,0,10,
2025-09-03,Ira D Robbins,Valley National Bancorp,1,2,0,3,
2025-09-03,Bernard Kim,Match Group,15,19,6,40,
2025-09-03,Vincent Pilette,Gen Digital,2,14,0,16,
2025-09-03,Timothy S Crane,Wintrust Financial,2,7,0,9,
2025-09-03,Pat Roche,Moog inc,4,11,2,17,
2025-09-03,Mark R Widmar,First Solar,3,6,1,10,
2025-09-03,Niko Lahanas,Central Garden & Pet,1,11,0,12,
2025-09-03,Chris Osowski,Green Plains inc,8,15,1,24,
2025-09-03,Derek J Leathers,Werner Enterprises,2,8,0,10,
2025-09-03,Adam Foroughi,AppLovin,11,25,4,40,
2025-09-03,Luca Savi,ITT,3,8,0,11,
2025-09-03,Lawrence H Silber,Herc Rentals,0,0,0,0,
2025-09-03,Hilton H Howell Jr,Gray Television,7,20,1,28,
2025-09-03,Eric D Ashleman,IDEX,0,9,1,10,
2025-09-03,Owen D Thomas,Boston Properties,3,7,0,10,
2025-09-03,Kurt Wolf,Pitney Bowes,6,20,2,28,
2025-09-03,Sara E Armbruster,Steelcase,2,0,0,2,
2025-09-03,Charles D. Young,Sun Communities,2,6,0,8,
2025-09-03,Suzanne Foster,AdaptHealth,5,7,1,13,
2025-09-03,Grant E Sims,Genesis Energy,4,2,0,6,
2025-09-03,Laura Prieskorn,Jackson Financial,3,5,2,10,
2025-09-03,Rick L Wessel,FirstCash,2,5,1,8,
2025-09-03,Sherman Miller,Cal-Maine Foods,12,27,1,40,
2025-09-03,Paul A Lang,Arch Resources,4,4,1,9,
2025-09-03,Ashish K Khandpur,Avient,2,6,0,8,
2025-09-03,Shyam K Reddy,BlueLinx,1,7,0,8,
2025-09-03,Christopher S Ripley,Sinclair,1,7,0,8,
2025-09-03,Stacy Kymes,BOK Financial,8,7,0,15,
2025-09-03,James H Walter,Permian Resources,0,1,0,1,
2025-09-03,Jason Murray,PACS Group,5,14,2,21,
2025-09-03,Brian Armstrong,Coinbase Global,12,23,5,40,
2025-09-03,Oscar K Brown,Western Midstream Partners,1,3,0,4,
2025-09-03,Nicholas R Lower,Federated Mutual Insurance,0,0,0,0,
2025-09-03,Morris Goldfarb,G-III Apparel Group,11,23,6,40,
2025-09-03,Mark D Morelli,Vontier,0,4,0,4,
2025-09-03,Matthew J Cox,Matson inc,0,6,0,6,
2025-09-03,David W Grzebinski,Kirby Corporation,1,3,0,4,
2025-09-03,Keith A Harvey,Kaiser Aluminum,2,4,2,8,
2025-09-03,Eric Nyman,Vista Outdoor,4,11,1,16,
2025-09-03,Doug Howe,Designer Brands,5,18,0,23,
2025-09-03,Jerry E Gahlhoff Jr,Rollins inc,0,2,0,2,
2025-09-03,D Scott Barbour,Advanced Drainage Systems,2,2,0,4,
2025-09-03,Sean Gamble,Cinemark,18,21,1,40,
2025-09-03,George Kurtz,CrowdStrike,14,24,2,40,
2025-09-03,Bill Ready,Pinterest,26,14,0,40,
2025-09-03,Fidji Simo,Instacart,9,30,1,40,
2025-09-03,Kimberly K Ryan,Hillenbrand,3,6,0,9,
2025-09-03,David S Graziosi,Allison Transmission,2,17,2,21,
2025-09-03,Gary G Friedman,Restoration Hardware,1,4,0,5,
2025-09-03,Lucinda M Baier,Brookdale Senior Living,4,3,0,7,
2025-09-03,Brian J Blaser,QuidelOrtho,1,8,0,9,
2025-09-03,E Jean Savage,Trinity Industries,1,7,1,9,
2025-09-03,Liam J Kelly,Teleflex,2,5,1,8,
2025-09-03,Laurans A Mendelson,HEICO,8,22,1,31,
2025-09-03,Frank H Laukien,Bruker,1,9,0,10,
2025-09-03,Harvey M Schwartz,Carlyle Group,6,14,0,20,
2025-09-03,Mark S LaVigne,Energizer,2,0,0,2,
2025-09-03,Joel Quadracci,Quad/Graphics,11,23,5,39,
2025-09-03,Amar Maletira,Rackspace Technology,5,12,2,19,
2025-09-03,Udit Batra,Waters Corporation,12,25,0,37,
2025-09-03,Eric M Green,West Pharmaceutical Services,1,9,0,10,
2025-09-03,Doug Palladini,Carters inc,2,2,2,6,
2025-09-03,G Mike Mikan,NeueHealth,3,2,0,5,
2025-09-03,Russell ChipChilds,SkyWest,0,0,0,0,
2025-09-03,Christopher H Hunter,Acadia Healthcare,0,1,0,1,
2025-09-03,Prahlad Singh,Revvity,2,7,0,9,
2025-09-03,Maria M Pope,Portland General Electric,1,1,0,2,
2025-09-03,Charles Chip Blankenship,Woodward inc,0,1,0,1,
2025-09-03,Mike Steib,TEGNA,14,18,1,33,
2025-09-03,Kurt J Ekert,Sabre Corporation,0,1,0,1,
2025-09-03,Matt Wilson,Light & Wonder,15,21,4,40,
2025-09-03,Rob Katz,Vail Resorts,4,13,23,40,
2025-09-03,Schnitzer Steel Industries,Radius Recycling,10,24,5,39,
2025-09-03,David A Spector,PennyMac Financial Services,3,1,0,4,
2025-09-03,Frederick J Holzgrefe III,Saia inc,1,1,0,2,
2025-09-03,Mark J Parrell,Equity Residential,4,6,0,10,
2025-09-03,John W Lindsay,Helmerich & Payne,0,4,0,4,
2025-09-03,Gary D Burnison,Korn Ferry,3,14,0,17,
2025-09-03,Timothy J McGrath,PC Connection Inc,1,3,0,4,
2025-09-03,Lynn M Bamford,Curtiss-Wright,13,9,0,22,
2025-09-03,Jonathan W Witter,Sallie Mae,0,2,0,2,
2025-09-03,Jeff Benck,Benchmark Electronics,4,6,0,10,
2025-09-03,Charles H Giancarlo,Pure Storage,0,3,0,3,
2025-09-03,Brian R Gray,Knife River Corporation,0,1,0,1,
2025-09-03,Jay Schmidt,Caleres inc,3,4,2,9,
2025-09-03,Dale Asplund,BrightView Holdings,1,5,0,6,
2025-09-03,Jeffrey S Edwards,Cooper-Standard,0,6,0,6,
2025-09-03,Glenn J Williams,Primerica,6,2,2,10,
2025-09-03,Francois Locoh-Donou,F5,6,20,3,29,
2025-09-03,Joseph Wm Foran,Matador Resources,7,10,0,17,
2025-09-03,Sridhar Ramaswamy,Snowflake inc,12,24,4,40,
2025-09-03,Mark D Dankberg,Viasat,2,4,2,8,
2025-09-03,Francisco J Leon,California Resources,1,3,1,5,
2025-09-03,Peter Stern,Peloton,18,18,4,40,
2025-09-03,David Baszucki,Roblox,11,19,10,40,
2025-09-03,Jeffrey W Edwards,Installed Building Products,1,3,0,4,
2025-09-03,Clark Lauritzen,First National of Nebraska,1,7,0,8,
2025-09-03,Carlos Alberini,Guess inc,12,27,1,40,
2025-09-03,Shyam P Kambeyanda,ESAB,3,4,0,7,
2025-09-03,Edmund Shallcross III,Amica Mutual Insurance,1,5,0,6,
2025-09-03,Benjamin W Schall,AvalonBay Communities,1,8,1,10,
2025-09-03,Allan C Thygesen,DocuSign,3,7,0,10,
2025-09-03,Bryan J Knutson,Titan Machinery,1,3,1,5,
2025-09-03,Heath Sampson,ModivCare,7,2,1,10,
2025-09-03,Ara K Hovnanian,Hovnanian Enterprises,2,19,2,23,
2025-09-03,Joshua G Silverman,Etsy,2,3,0,5,
2025-09-03,Kevin Roycraft,Adams Resources & Energy,5,4,1,10,
2025-09-03,J Eric Evans,Surgery Partners,0,3,0,3,
2025-09-03,Clint E Stein,Columbia Banking System,1,7,0,8,
2025-09-03,Lee M Shavel,Verisk Analytics,2,7,0,9,
2025-09-03,Dave Banyard Jr,MasterBrand,0,0,0,0,
2025-09-03,Peter R Ingram,Hawaiian Airlines inc,1,0,0,1,
2025-09-03,Kristin A Dolan,AMC Networks,3,2,0,5,
2025-09-03,Brendan T Cavanagh,SBA Communications,1,2,0,3,
2025-09-03,George F Chappelle Jr,Americold Realty Trust,1,3,0,4,
2025-09-03,Thomas E Gottwald,NewMarket Corporation,2,7,0,9,
2025-09-03,Thomas J Baltimore Jr,Park Hotels & Resorts,3,31,0,34,
2025-09-03,Peter M Moglia,Alexandria Real Estate Equities,4,6,0,10,
2025-09-03,Ronald J Kramer,Griffon Corporation,1,6,0,7,
2025-09-03,John L Plueger,Air Lease,2,13,0,15,
2025-09-03,Jennifer F Scanlon,UL Solutions,1,4,0,5,
2025-09-03,Greg Smith,Teradyne,2,9,2,13,
2025-09-03,Sean Trauschke,OGE Energy,17,5,0,22,
2025-09-03,Norman D Schwartz,Bio-Rad Laboratories,1,1,1,3,
2025-09-03,Scott Doyle,Spire inc,4,4,1,9,
2025-09-03,Michael E Reed,Gannett,0,5,2,7,
2025-09-03,Cindy J Miller,Stericycle,2,5,2,9,
2025-09-03,Phillip D Green,Cullen Frost Bankers,1,5,3,9,
2025-09-03,Joseph D Margolis,Extra Space Storage,0,8,1,9,
2025-09-03,Mark A Skonieczny,REV Group,6,4,0,10,
2025-09-03,Ladd Wilks,ProFrac Holding,4,3,1,8,
2025-09-03,Sundaram Nagarajan,Nordson,0,11,1,12,
2025-09-03,Anne P Noonan,Summit Materials,0,0,0,0,
2025-09-03,Lori Flees,Valvoline inc,4,4,2,10,
2025-09-03,Scott H Baxter,Kontoor Brands,3,2,0,5,
2025-09-03,Tim Larson,Skyline Champion,6,0,0,6,
2025-09-03,Chuck Divita,Teladoc Health,9,20,5,34,
2025-09-03,W Bradley Southern,Louisiana-Pacific Corporation,0,0,0,0,
2025-09-03,George C Freeman III,Universal Corporation,4,6,0,10,
2025-09-03,James A Brock,Consol Energy,2,0,0,2,
2025-09-03,Robert Antokol,Playtika Holding,0,8,1,9,
2025-09-03,Joe Craft,Alliance Resource Partners,7,9,2,18,
2025-09-03,Paul Keel,Envista,1,7,1,9,
2025-09-03,Jared Isaacman,Shift4 Payments,7,28,5,40,
2025-09-03,Mark Mac McFarland,Talen Energy,3,1,1,5,
2025-09-03,Tony R Thene,Carpenter Technology,3,10,0,13,
2025-09-03,Melissa D Smith,WEX,2,7,0,9,
2025-09-03,James Jim C Ryan III,Old National Bancorp,1,0,0,1,
2025-09-03,Peter J Federico,AGNC Investment,1,0,0,1,
2025-09-03,Brent L Yeagy,Wabash National,0,0,0,0,
2025-09-03,Henry A Fernandez,MSCI,3,13,0,16,
2025-09-03,Mark Penn,Stagwell,13,24,2,39,
2025-09-03,Julie Schertell,Mativ,2,8,0,10,
2025-09-03,Ashish Chand,Belden,3,6,1,10,
2025-09-03,Greg Anderson,Allegiant Travel Company,5,7,0,12,
2025-09-03,Drew Houston,Dropbox,14,20,6,40,
2025-09-03,Kevin T Conroy,Exact Sciences,2,5,2,9,
2025-09-03,Rex D Geveden,BWX Technologies,5,6,0,11,
2025-09-03,Scott R Wells,Clear Channel Outdoor Hldgs,0,0,0,0,
2025-09-03,Paul Bay,Ingram Micro,9,26,5,40,
2025-09-04,Doug McMillon,Walmart,16,20,4,40,
2025-09-04,Andrew Jassy,Amazon,4,31,5,40,
2025-09-04,Tim Cook,Apple,14,21,5,40,
2025-09-04,Stephen Hemsley,UnitedHealth,8,26,6,40,
2025-09-04,Warren Buffett,Berkshire Hathaway,9,27,4,40,
2025-09-04,David Joyner,CVS Health,7,28,5,40,
2025-09-04,Darren Woods,Exxon Mobil,9,23,7,39,
2025-09-04,Sundar Pichai,Alphabet,15,17,8,40,
2025-09-04,Brian Tyler,McKesson,4,16,5,25,
2025-09-04,Robert Mauch,Cencora,3,7,0,10,
2025-09-04,Ron Vachris,Costco,6,33,1,40,
2025-09-04,Jamie Dimon,JPMorgan Chase,11,16,13,40,
2025-09-04,Satya Nadella,Microsoft,14,23,3,40,
2025-09-04,Jason Hollar,Cardinal Health,14,22,4,40,
2025-09-04,Mike Wirth,Chevron,18,17,5,40,
2025-09-04,David Cordani,Cigna,20,16,4,40,
2025-09-04,Jim Farley,Ford Motor,15,20,5,40,
2025-09-04,Brian Moynihan,Bank of America,7,29,4,40,
2025-09-04,Mary Barra,General Motors,12,23,5,40,
2025-09-04,Gail Boudreaux,Elevance Health,16,17,7,40,
2025-09-04,Jane Fraser,Citigroup,14,21,5,40,
2025-09-04,Sarah London,Centene,13,18,9,40,
2025-09-04,Ted Decker,Home Depot,12,23,5,40,
2025-09-04,Maryann Mannen,Marathon Petroleum,6,14,1,21,
2025-09-04,Ron Sargent,Kroger,5,23,12,40,
2025-09-04,Mark Lashier,Phillips 66,12,19,7,38,
2025-09-04,Priscilla Almodovar,Fannie Mae,10,17,13,40,
2025-09-04,Tim Wentworth,Walgreens,7,25,8,40,
2025-09-04,Lane Riggs,Valero Energy,13,9,0,22,
2025-09-04,Mark Zuckerberg,Meta,9,19,12,40,
2025-09-04,Hans Vestberg,Verizon,15,21,4,40,
2025-09-04,John Stankey,AT&T,13,22,5,40,
2025-09-04,Brian Roberts,Comcast,12,26,2,40,
2025-09-04,Charles Scharf,Wells Fargo,27,6,7,40,
2025-09-04,David Solomon,Goldman Sachs,10,21,9,40,
2025-09-04,Michael Hutchins,Freddie Mac,3,10,3,16,
2025-09-04,Michael Fiddelke,Target,11,21,8,40,
2025-09-04,Jim Rechtin,Humana,18,17,5,40,
2025-09-04,Jon Farney,State Farm Insurance,1,13,3,17,
2025-09-04,Elon Musk,Tesla,15,18,7,40,
2025-09-04,Ted Pick,Morgan Stanley,14,23,3,40,
2025-09-04,Joaquin Duato,Johnson & Johnson,11,25,4,40,
2025-09-04,Juan Luciano,Archer Daniels Midland,3,19,18,40,
2025-09-04,Ramon Laguarta,PepsiCo,7,28,5,40,
2025-09-04,Carol Tom√©,UPS,9,22,9,40,
2025-09-04,Rajesh Subramaniam,FedEx,9,29,0,38,
2025-09-04,Bob Iger,Walt Disney,8,30,2,40,
2025-09-04,Michael Dell,Dell Technologies,10,26,4,40,
2025-09-04,Marvin Ellison,Lowes,13,25,1,39,
2025-09-04,Jon Moeller,Procter & Gamble,4,28,8,40,
2025-09-04,Thomas Long,Energy Transfer,8,0,2,10,
2025-09-04,Kelly Ortberg,Boeing,9,26,5,40,
2025-09-04,Susan Morris,Albertsons,13,24,3,40,
2025-09-04,Kevin Hourican,Sysco,9,28,3,40,
2025-09-04,Christopher Calio,RTX,7,11,0,18,
2025-09-04,Larry Culp,General Electric,11,26,3,40,
2025-09-04,James Taiclet,Lockheed Martin,13,19,8,40,
2025-09-04,Stephen Squeri,American Express,16,22,2,40,
2025-09-04,Joe Creed,Caterpillar,11,27,2,40,
2025-09-04,Michel Khalaf,MetLife,11,19,1,31,
2025-09-04,Samuel Hazen,HCA Healthcare,8,7,0,15,
2025-09-04,Tricia Griffith,Progressive Insurance,9,26,5,40,
2025-09-04,Arvind Krishna,IBM,16,20,4,40,
2025-09-04,John May,Deere,10,25,5,40,
2025-09-04,Jensen Huang,Nvidia,8,27,5,40,
2025-09-04,Philip Smith,StoneX,0,9,1,10,
2025-09-04,Robert M Davis,Merck,5,19,0,24,
2025-09-04,Ryan Lance,ConocoPhillips,16,21,3,40,
2025-09-04,Albert Bourla,Pfizer,20,12,8,40,
2025-09-04,Ed Bastian,Delta Air Lines,11,19,10,40,
2025-09-04,Patrick Zammit,TD Synnex,10,15,0,25,
2025-09-04,Kevin Murphy,Publix Super Markets,10,22,1,33,
2025-09-04,Thomas J Wilson,Allstate,1,8,1,10,
2025-09-04,Chuck Robbins,Cisco Systems,15,22,3,40,
2025-09-04,Kirt Walker,Nationwide,15,18,2,35,
2025-09-04,Christopher Winfrey,Charter Communications,5,17,5,27,
2025-09-04,Bob Michael,AbbVie,0,0,0,0,
2025-09-04,Craig DeSanto,New York Life Insurance,3,17,0,20,
2025-09-04,Lip-Bu Tan,Intel,8,17,15,40,
2025-09-04,Ernie Herrman,TJX,16,22,2,40,
2025-09-04,Andrew Sullivan,Prudential Financial,12,20,0,32,
2025-09-04,Enrique Lores,Hewlett Packard,11,17,6,34,
2025-09-04,Scott Kirby,United Airlines,33,4,3,40,
2025-09-04,George Holm,Performance Food,10,22,2,34,
2025-09-04,Donnie King,Tyson Foods,8,26,6,40,
2025-09-04,Robert Isom,American Airlines,7,26,7,40,
2025-09-04,Timothy M Sweeney,Liberty Mutual Insurance,12,0,0,12,
2025-09-04,Elliott Hill,Nike,10,27,3,40,
2025-09-04,Safra Catz,Oracle,12,21,7,40,
2025-09-04,AJ Jim Teague,Enterprise Products Partners,7,13,0,20,
2025-09-04,Richard Fairbank,Capital One,16,22,2,40,
2025-09-04,Wilfred Chiang,Plains GP,1,1,0,2,
2025-09-04,Michael Kasbar,World Kinect,2,11,0,13,
2025-09-04,Peter Zaffino,American International Group,8,28,4,40,
2025-09-04,James Quincey,The Coca-Cola Company,10,27,3,40,
2025-09-04,Thasunda Brown Duckett,TIAA,20,20,0,40,
2025-09-04,Jay Debertin,CHS,6,10,4,20,
2025-09-04,Chris Boerner,Bristol-Myers Squibb,10,23,7,40,
2025-09-04,Corie Barry,Best Buy,39,1,0,40,
2025-09-04,Marc Casper,Thermo Fisher Scientific,12,24,4,40,
2025-09-04,Roger Crandall,Mass Mutual,3,7,0,10,
2025-09-04,Juan Andrade,USAA,5,16,0,21,
2025-09-04,Phebe Novakovic,General Dynamics,27,10,3,40,
2025-09-04,Alan Schnitzer,Travelers Insurance,3,5,1,9,
2025-09-04,David Zaslav,Warner Bros Discovery,5,24,11,40,
2025-09-04,Gunjan Kedia,US Bancorp,14,24,2,40,
2025-09-04,Robert Ford,Abbott Laboratories,11,23,6,40,
2025-09-04,Kathy Warden,Northrop Grumman,14,21,5,40,
2025-09-04,Tim Gerend,Northwestern Mutual,14,25,1,40,
2025-09-04,Todd Vasos,Dollar General,7,24,9,40,
2025-09-04,Matthew Lucey,PBF Energy,7,3,0,10,
2025-09-04,Dara Khosrowshahi,Uber,12,22,6,40,
2025-09-04,Vimal Kapur,Honeywell,11,29,0,40,
2025-09-04,Dirk Van de Put,Mondelez,8,30,2,40,
2025-09-04,Brian Niccol,Starbucks,13,27,0,40,
2025-09-04,Cristiano Amon,Qualcomm,13,26,1,40,
2025-09-04,Hock Tan,Broadcom,11,25,4,40,
2025-09-04,David Flitman,US Foods,2,7,0,9,
2025-09-04,Paul Romanowski,DR Horton,5,15,5,25,
2025-09-04,Jacek Olczak,Philip Morris,13,24,3,40,
2025-09-04,Preston Feight,Paccar,6,24,1,31,
2025-09-04,Marc Benioff,Salesforce,8,18,14,40,
2025-09-04,Leon Topalian,Nucor,15,22,3,40,
2025-09-04,Michael Dastoor,Jabil,1,9,0,10,
2025-09-04,Jonathan Jaffe,Lennar,2,7,1,10,
2025-09-04,David Ricks,Eli Lilly,8,21,11,40,
2025-09-04,Joe Zubretsky,Molina Healthcare,6,7,4,17,
2025-09-04,Jennifer Rumsey,Cummins,7,27,6,40,
2025-09-04,Robin Vince,Bank of New York Mellon,20,19,1,40,
2025-09-04,Ted Sarandos,Netflix,14,24,2,40,
2025-09-04,William H Rogers Jr,Truist Financial,2,6,1,9,
2025-09-04,Sean Kerins,Arrow Electronics,2,13,0,15,
2025-09-04,William M Brown,3M,2,8,0,10,
2025-09-04,Ryan McInerney,Visa,13,23,4,40,
2025-09-04,Marc Rowan,Apollo Global Management,15,20,5,40,
2025-09-04,Tim Go,HF Sinclair,6,3,0,9,
2025-09-04,Robert Sulentic,CBRE Group,1,7,1,9,
2025-09-04,William Demchak,PNC Financial Services,16,19,5,40,
2025-09-04,Bryan DeBoer,Lithia Motors,12,26,1,39,
2025-09-04,William Nash,CarMax,4,4,2,10,
2025-09-04,Brian Robbins,Paramount Global,5,33,1,39,
2025-09-04,Michael Creedon,Dollar Tree,3,34,3,40,
2025-09-04,Sandy Douglas,United Natural Foods,34,5,1,40,
2025-09-04,Alex Chriss,PayPal,14,23,3,40,
2025-09-04,Roger Penske,Penske Automotive,18,21,1,40,
2025-09-04,Antonio Neri,Hewlett Packard Enterprise,10,21,8,39,
2025-09-04,Harry Sideris,Duke Energy,35,5,0,40,
2025-09-04,Vicki Hollub,Occidental Petroleum,21,14,4,39,
2025-09-04,Lawrence Coben,NRG Energy,5,3,0,8,
2025-09-04,Robert Bradway,Amgen,9,29,2,40,
2025-09-04,John Ketchum,NextEra Energy,20,19,1,40,
2025-09-04,Rainer Blair,Danaher,7,15,2,24,
2025-09-04,Daniel O'Day,Gilead Sciences,19,17,4,40,
2025-09-04,Michael Manley,AutoNation,3,6,1,10,
2025-09-04,Carlos Abrams-Rivera,Kraft Heinz,7,29,4,40,
2025-09-04,Philip Gallagher,Avnet,1,5,1,7,
2025-09-04,Gary Dickerson,Applied Materials,6,23,11,40,
2025-09-04,Bob Jordan,Southwest Airlines,10,23,7,40,
2025-09-04,Rick Wurster,Charles Schwab,13,22,4,39,
2025-09-04,Lorenzo Simonelli,Baker Hughes,16,20,4,40,
2025-09-04,Chris Kempczinski,McDonalds,11,22,7,40,
2025-09-04,Christopher Womack,Southern Company,3,7,0,10,
2025-09-04,Michael Miebach,Mastercard,11,26,3,40,
2025-09-04,Joseph Dominguez,Constellation Energy,13,11,1,25,
2025-09-04,Christopher Swift,The Hartford,16,21,3,40,
2025-09-04,Patricia Poppe,PG&E,8,15,2,25,
2025-09-04,Bom Kim,Coupang,12,27,1,40,
2025-09-04,Ezra Yacob,EOG Resources,24,13,3,40,
2025-09-04,Jim Vena,Union Pacific,19,21,0,40,
2025-09-04,Matt Schroeder,Rite Aid,4,33,3,40,
2025-09-04,Tony Spring,Macys,11,26,3,40,
2025-09-04,Anthony Capuano,Marriott International,14,23,3,40,
2025-09-04,Raymond E Scott,Lear Corporation,6,4,0,10,
2025-09-04,William Stengel II,Genuine Parts,0,2,0,2,
2025-09-04,Heidi Petz,Sherwin-Williams,9,28,3,40,
2025-09-04,Jeff Miller,Halliburton,13,21,6,40,
2025-09-04,Kathleen Quirk,Freeport-McMoRan,13,19,2,34,
2025-09-04,Michael Rapino,Live Nation Entertainment,13,24,3,40,
2025-09-04,John Doyle,Marsh & McLennan,10,8,0,18,
2025-09-04,Lisa Su,Advanced Micro Devices,16,20,4,40,
2025-09-04,Frank Holding,First Citizens BancShares,9,14,2,25,
2025-09-04,John Engel,WESCO International,5,11,1,17,
2025-09-04,David Gitlin,Carrier Global,14,23,3,40,
2025-09-04,Lourenco Goncalves,Cleveland-Cliffs,7,21,12,40,
2025-09-04,Calvin G Butler Jr,Exelon,6,4,0,10,
2025-09-04,Joseph Bae,KKR,19,19,2,40,
2025-09-04,Christine Leahy,CDW,0,10,2,12,
2025-09-04,Glenn Fogel,Booking Holdings,10,24,6,40,
2025-09-04,Brian Doubles,Synchrony Financial,5,7,2,14,
2025-09-04,Earl Austin,Quanta Services,2,6,1,9,
2025-09-04,Christian Ulbrich,Jones Lang LaSalle,9,16,0,25,
2025-09-04,Saumya Sutaria,Tenet Healthcare,6,2,1,9,
2025-09-04,William Gifford,Altria,3,4,2,9,
2025-09-04,Kevin Lobo,Stryker,12,25,3,40,
2025-09-04,Michael Hsu,Kimberly-Clark,6,6,1,13,
2025-09-04,Jack Fusco,Cheniere Energy,19,18,3,40,
2025-09-04,James Conroy,Ross Stores,4,11,0,15,
2025-09-04,Anthony Smurfit,Smurfit Westrock,4,6,0,10,
2025-09-04,Jeffrey Harmening,General Mills,4,18,5,27,
2025-09-04,Mark Stewart,Goodyear Tire & Rubber,5,34,1,40,
2025-09-04,Bob Eddy,BJs Wholesale Club,3,22,3,28,
2025-09-04,Peter Arduini,GE HealthCare Technologies,6,11,0,17,
2025-09-04,Noel Wallace,Colgate-Palmolive,10,24,2,36,
2025-09-04,Marc Bitzer,Whirlpool,12,13,15,40,
2025-09-04,Chris Kubasik,L3Harris Technologies,7,13,1,21,
2025-09-04,Shantanu Narayen,Adobe,19,19,1,39,
2025-09-04,Thomas Polen,Becton Dickinson,6,4,0,10,
2025-09-04,Richard P Dealy,Pioneer Natural Resources,5,2,0,7,
2025-09-04,Ravi Kumar S,Cognizant Technology Solutions,12,24,3,39,
2025-09-04,Andrew Clyde,Murphy USA,13,25,2,40,
2025-09-04,Mike Lyons,Fiserv,4,12,1,17,
2025-09-04,Jennifer Parmentier,Parker-Hannifin,2,12,0,14,
2025-09-04,William Fehrman,American Electric Power,3,7,0,10,
2025-09-04,Andrew Silvernail,International Paper,5,23,0,28,
2025-09-04,Jonas Prising,ManpowerGroup,7,22,2,31,
2025-09-04,John Zillmer,Aramark,6,14,2,22,
2025-09-04,Mark Millett,Steel Dynamics,19,2,0,21,
2025-09-04,Dan Amos,Aflac,13,18,9,40,
2025-09-04,Tony Cheng,Reinsurance Group of America,2,11,2,15,
2025-09-04,Karsanbhai,Emerson Electric,8,16,3,27,
2025-09-04,Ronald P O'Hanley,State Street,7,15,0,22,
2025-09-04,Timothy Knavish,PPG Industries,1,2,0,3,
2025-09-04,David Burritt,United States Steel,8,20,11,39,
2025-09-04,Maria Black,Automatic Data Processing,4,5,0,9,
2025-09-04,Daryl Kenningham,Group 1 Automotive,9,29,2,40,
2025-09-04,Robert Blue,Dominion Energy,28,11,1,40,
2025-09-04,Larry Fink,BlackRock,8,25,7,40,
2025-09-04,Pierce Norton II,Oneok,4,3,1,8,
2025-09-04,David Bozeman,CH Robinson Worldwide,2,7,0,9,
2025-09-04,Haviv Ilan,Texas Instruments,12,25,3,40,
2025-09-04,Michael Bender,Kohls,1,25,14,40,
2025-09-04,Philip Daniele III,AutoZone,0,2,0,2,
2025-09-04,Timothy Archer,Lam Research,2,8,0,10,
2025-09-04,Charles Magro,Corteva,5,3,1,9,
2025-09-04,Rick Lanoha,Peter Kiewit Sons',0,2,0,2,
2025-09-04,Peter Jackson,Builders FirstSource,5,12,1,18,
2025-09-04,Martin Schroeter,Kyndryl,10,28,1,39,
2025-09-04,Hamid Akhavan,EchoStar,5,26,9,40,
2025-09-04,Bill Westrate,American Family Insurance,10,17,2,29,
2025-09-04,Avigal Soreq,Delek US,4,9,5,18,
2025-09-04,Beth Ford,Land O'Lakes,19,21,0,40,
2025-09-04,Walker Martin,Sempra,0,2,0,2,
2025-09-04,Eric Slifka,Global Partners,12,22,6,40,
2025-09-04,DG Macpherson,WW Grainger,2,7,1,10,
2025-09-04,Bob Pragada,Jacobs Solutions,6,8,0,14,
2025-09-04,Pedro Pizarro,Edison International,16,8,16,40,
2025-09-04,William Hornbuckle,MGM Resorts International,7,22,1,30,
2025-09-04,Andrew McMahon,Guardian Life insurance,6,12,0,18,
2025-09-04,Christopher O'Herlihy,Illinois Tool Works,3,5,2,10,
2025-09-04,James Cracchiolo,Ameriprise Financial,2,22,2,26,
2025-09-04,Ryan Marshall,PulteGroup,9,14,11,34,
2025-09-04,Matthew Meloy,Targa Resources,5,5,0,10,
2025-09-04,Michael Rhodes,Ally Financial,10,25,4,39,
2025-09-04,Joseph Fadool,BorgWarner,4,10,0,14,
2025-09-04,St√©phane de La Faverie,Est√©e Lauder,9,27,4,40,
2025-09-04,Benjamin Tisch,Loews,3,7,0,10,
2025-09-04,Brad Beckham,O'Reilly Automotive,4,18,1,23,
2025-09-04,Thomas Gayner,Markel Group,2,8,0,10,
2025-09-04,Donald Allan,Stanley Black & Decker,9,30,1,40,
2025-09-04,Sanjay Mehrotra,Micron Technology,17,21,2,40,
2025-09-04,James Breuer,Fluor,1,2,1,4,
2025-09-04,Thomas Bell,Leidos,9,19,2,30,
2025-09-04,Scott Smith,Viatris,6,4,0,10,
2025-09-04,Kimberly Dang,Kinder Morgan,11,1,0,12,
2025-09-04,Christophe Beck,Ecolab,19,21,0,40,
2025-09-04,Brent Shafer,Baxter International,1,9,0,10,
2025-09-04,Clay Gaspar,Devon Energy,21,3,0,24,
2025-09-04,Steven Cahillane,Kellanova,2,7,0,9,
2025-09-04,Raul Nicholas Vargas Ochoa,Farmers Insurance Exchange,0,0,0,0,
2025-09-04,Darren Rebelez,Caseys General Stores,3,6,0,9,
2025-09-04,Ari Bousbib,IQVIA,6,16,1,23,
2025-09-04,Jon Vander Ark,Republic Services,11,18,11,40,
2025-09-04,Timothy Cofer,Keurig Dr Pepper,2,6,1,9,
2025-09-04,Karla Lewis,Reliance Inc,3,6,0,9,
2025-09-04,David Hult,Asbury Automotive Group,7,32,1,40,
2025-09-04,Darryl Button,Pacific Life,1,8,0,9,
2025-09-04,James Burke,Vistra,7,3,0,10,
2025-09-04,John Barrett,Western & Southern Financial,10,28,2,40,
2025-09-04,William Krueger,The Andersons Inc,0,2,0,2,
2025-09-04,Erik Nordstrom,Nordstrom,6,27,6,39,
2025-09-04,John Wren,Omnicom Group,14,20,6,40,
2025-09-04,Stephanie Ferris,Fidelity National Information Services,16,22,2,40,
2025-09-04,Timothy Cawley,Consolidated Edison,5,5,0,10,
2025-09-04,Joseph Hinrichs,CSX,6,11,1,18,
2025-09-04,Troy Rudd,AECOM,7,24,4,35,
2025-09-04,Kathleen Johnson,Lumen Technologies,3,5,1,9,
2025-09-04,Harry Lawton III,Tractor Supply,1,1,0,2,
2025-09-04,Raul Fernandez,DXC Technology,4,33,2,39,
2025-09-04,Eric Hansotia,AGCO,17,22,1,40,
2025-09-04,David Bruton Smith,Sonic Automotive,5,8,9,22,
2025-09-04,Sasan Goodarzi,Intuit,10,26,4,40,
2025-09-04,Matthew Flannery,United Rentals,33,2,0,35,
2025-09-04,Marc Miller,Universal Health Services,4,21,3,28,
2025-09-04,Michael Mahoney,Boston Scientific,11,29,0,40,
2025-09-04,Judith Marks,Otis Worldwide,2,3,0,5,
2025-09-04,Robert Frenzel,Xcel Energy,3,2,2,7,
2025-09-04,Penny Pennington,Edward Jones,9,25,6,40,
2025-09-04,Daniel Fisher,Ball,1,20,6,27,
2025-09-04,Justin Jude,LKQ,4,6,1,11,
2025-09-04,James Blackledge,Mutual of Omaha,3,31,2,36,
2025-09-04,Bruce Bodine,Mosaic,3,8,0,11,
2025-09-04,Scott Donnelly,Textron,9,28,3,40,
2025-09-04,Adam Schechter,Labcorp Holdings,3,6,1,10,
2025-09-04,Deanna Strable-Soethout,Principal Financial,2,6,0,8,
2025-09-04,Leonard Schleifer,Regeneron Pharmaceuticals,7,26,7,40,
2025-09-04,Paul Shoukry,Raymond James Financial,15,24,1,40,
2025-09-04,Lauren Hobart,Dicks Sporting Goods,13,24,3,40,
2025-09-04,Jamie Whisnant,Auto-Owners Insurance,0,2,0,2,
2025-09-04,Ariane Gorin,Expedia,9,30,1,40,
2025-09-04,Shelley Simpson,JB Hunt Transport Services,8,29,3,40,
2025-09-04,Ren√© Jones,M&T Bank,13,24,3,40,
2025-09-04,Gerardo Norcia,DTE Energy,5,4,0,9,
2025-09-04,Andr√©s Gluski,AES,17,21,0,38,
2025-09-04,Timothy Spence,Fifth Third Bancorp,5,3,2,10,
2025-09-04,Eduardo Menezes,Air Products & Chemicals,4,4,2,10,
2025-09-04,Wendell Weeks,Corning,14,24,2,40,
2025-09-04,Anthony Guzzi,EMCOR Group,4,3,1,8,
2025-09-04,Adam Norwitt,Amphenol,3,18,0,21,
2025-09-04,Jean-Marc Gilson,Westlake Corporation,2,3,2,7,
2025-09-04,Lori Koch,DuPont,8,18,0,26,
2025-09-04,Derek Chang,Liberty Media,36,3,1,40,
2025-09-04,Martina Cheung,S&P Global,11,28,0,39,
2025-09-04,Tim Hingtgen,Community Health Systems,11,27,2,40,
2025-09-04,Brian Tierney,FirstEnergy,5,22,3,30,
2025-09-04,Rick McKenney,Unum Group,5,5,0,10,
2025-09-04,Stanley Bergman,Henry Schein,11,28,1,40,
2025-09-04,Tiang Yew Tan,Western Digital,0,2,0,2,
2025-09-04,Vincent Roche,Analog Devices,13,23,3,39,
2025-09-04,Sean Connolly,Conagra Brands,7,31,2,40,
2025-09-04,Bruce Van Saun,Citizens Financial Group,14,26,0,40,
2025-09-04,Mark George,Norfolk Southern,18,19,3,40,
2025-09-04,Andrew Marsh,Entergy,4,4,0,8,
2025-09-04,Robert Berkley,WR Berkley,9,28,3,40,
2025-09-04,Javier Rodriguez,DaVita,14,14,1,29,
2025-09-04,Michael O'Grady,Northern Trust,25,6,1,32,
2025-09-04,James Snee,Hormel Foods,2,26,1,29,
2025-09-04,Timothy J Donahue,Crown Holdings,1,10,0,11,
2025-09-04,Joseph Ferraro,Avis Budget,3,5,1,9,
2025-09-04,Niraj Shah,Wayfair,7,25,8,40,
2025-09-04,Jos√© Mas,MasTec,6,14,1,21,
2025-09-04,Joseph Nolan,Eversource Energy,5,3,1,9,
2025-09-04,Thomas Palmer,Newmont,5,5,0,10,
2025-09-04,Robert Sanchez,Ryder System,11,9,1,21,
2025-09-04,Michael Nolan,Fidelity National Financial,2,0,0,2,
2025-09-04,Gavin Hattersley,Molson Coors Beverage,6,29,5,40,
2025-09-04,Thomas Reeg,Caesars Entertainment,6,5,0,11,
2025-09-04,Ellen Cooper,Lincoln National,3,7,0,10,
2025-09-04,Bracken Darrell,VF Corporation,10,27,3,40,
2025-09-04,Erik Fyrwald,International Flavors & Fragrances,7,9,2,18,
2025-09-04,Christopher Kastner,Huntington Ingalls Industries,3,5,0,8,
2025-09-04,Shane O'Kelly,Advance Auto Parts,13,23,4,40,
2025-09-04,Ralph LaRossa,Public Service Enterprise Group,10,19,0,29,
2025-09-04,Kecia Steelman,Ulta Beauty,33,5,2,40,
2025-09-04,Michele Buck,Hershey,6,32,2,40,
2025-09-04,Sumit Singh,Chewy,12,24,4,40,
2025-09-04,Steven Vondran,American Tower,4,6,0,10,
2025-09-04,Jeffrey Lorberbaum,Mohawk Industries,11,6,1,18,
2025-09-04,Keith Demmings,Assurant,2,8,0,10,
2025-09-04,Robert Martin,Thor Industries,3,6,1,10,
2025-09-04,Kathleen Mazzarella,Graybar Electric,1,7,1,9,
2025-09-04,Joey Wat,Yum China,12,26,2,40,
2025-09-04,Scott Richardson,Celanese,10,26,4,40,
2025-09-04,David Rawlinson II,QVC,7,15,2,24,
2025-09-04,Alan Armstrong,Williams,24,12,4,40,
2025-09-04,Philippe Krakowsky,Interpublic Group,13,25,2,40,
2025-09-04,Brendan McCracken,Ovintiv,7,5,0,12,
2025-09-04,Andrew Teno,Icahn Enterprises,5,5,0,10,
2025-09-04,Stephen Steinour,Huntington Bancshares,1,8,0,9,
2025-09-04,Timothy NeCastro,Erie Insurance,3,6,1,10,
2025-09-04,Ernest Garcia III,Carvana,21,15,4,40,
2025-09-04,R Bruce McDonald,Dana Incorporated,3,7,1,11,
2025-09-04,William Oplinger,Alcoa Corporation,2,6,1,9,
2025-09-04,Mark Pearson,Equitable,7,8,0,15,
2025-09-04,Richard Wallace,KLA,4,5,0,9,
2025-09-04,Ricardo Cardenas,Darden Restaurants,4,3,1,8,
2025-09-04,Mikael Bratt,Autoliv,6,7,2,15,
2025-09-04,Benito Minicucci,Alaska Air,3,4,1,8,
2025-09-04,Christopher Gorman,KeyCorp,5,5,0,10,
2025-09-04,Robert Goldstein,Las Vegas Sands,5,30,5,40,
2025-09-04,Edward Pesicka,Owens & Minor,3,32,2,37,
2025-09-04,Christopher Nassetta,Hilton Worldwide,7,17,2,26,
2025-09-04,Jamie Iannone,Ebay,17,19,4,40,
2025-09-04,Patrick Gallagher,Arthur J Gallagher,9,29,2,40,
2025-09-04,Rich Steinmeier,LPL Financial,24,14,2,40,
2025-09-04,Stephen Spray,Cincinnati Financial,1,6,3,10,
2025-09-04,Douglas Yearley,Toll Brothers,10,24,6,40,
2025-09-04,Gregory Brown,Motorola Solutions,2,8,0,10,
2025-09-04,Brian Chesky,Airbnb,2,30,8,40,
2025-09-04,Jeffrey Sprecher,Intercontinental Exchange,13,23,4,40,
2025-09-04,Robert Thomson,News Corp,6,30,4,40,
2025-09-04,Scott Boatwright,Chipotle Mexican Grill,8,27,5,40,
2025-09-04,Reshma Kewalramani,Vertex Pharmaceuticals,21,14,5,40,
2025-09-04,Christopher Viehbacher,Biogen,0,26,2,28,
2025-09-04,Malcolm Wilson,GXO Logistics,7,22,0,29,
2025-09-04,Tony Sarsam,SpartanNash,15,23,2,40,
2025-09-04,Michael O‚ÄôSullivan,Burlington Stores,8,28,4,40,
2025-09-04,Teresa Rasmussen,Thrivent Financial for Lutherans,4,1,0,5,
2025-09-04,Eugene Bredow,NVR,0,3,0,3,
2025-09-04,Brian Chambers,Owens Corning,3,11,0,14,
2025-09-04,Rafael Santana,Westinghouse Air Brake Technologies,3,7,1,11,
2025-09-04,John Pfeifer,Oshkosh,5,24,4,33,
2025-09-04,Cameron Bready,Global Payments,8,30,2,40,
2025-09-04,Calvin McDonald,Lululemon athletica,9,30,1,40,
2025-09-04,J Kent Masters,Albemarle Corporation,3,6,0,9,
2025-09-04,Joanna Geraghty,JetBlue Airways,13,20,7,40,
2025-09-04,Robert Steer,Seaboard,1,4,0,5,
2025-09-04,William Newlands,Constellation Brands,0,2,2,4,
2025-09-04,Michael Doss,Graphic Packaging,4,8,1,13,
2025-09-04,Gil West,Hertz,7,22,8,37,
2025-09-04,Malcolm C Roberts,FM Global,2,9,2,13,
2025-09-04,Mick Beekhuizen,Campbell Soup,9,23,1,33,
2025-09-04,Daniel Wall,Expeditors International of Washington,3,4,0,7,
2025-09-04,Gregory Roberts,A-Mark Precious Metals,1,4,1,6,
2025-09-04,Horacio Rozanski,Booz Allen Hamilton,17,18,5,40,
2025-09-04,James Davis,Quest Diagnostics,5,5,0,10,
2025-09-04,Dennis Mathew,Altice,5,28,7,40,
2025-09-04,Stefan Larsson,PVH,10,25,5,40,
2025-09-04,Mark Costa,Eastman Chemical,5,16,4,25,
2025-09-04,Joyce Mullen,Insight Enterprises,6,9,0,15,
2025-09-04,John Turner,Regions Financial,19,19,2,40,
2025-09-04,Julian G Francis,Beacon Roofing Supply,0,1,0,1,
2025-09-04,Blake Moret,Rockwell Automation,11,28,1,40,
2025-09-04,Mike Speetzen,Polaris Inc,2,16,2,20,
2025-09-04,William McDermott,ServiceNow,3,6,0,9,
2025-09-04,Jure Sola,Sanmina,2,12,0,14,
2025-09-04,Bob Flexon,UGI Utilities Inc,0,1,0,1,
2025-09-04,Scott Lauber,WEC Energy,14,6,0,20,
2025-09-04,Jon Rousseau,BrightSpring Health Services,20,20,0,40,
2025-09-04,Todd Schneider,Cintas,13,17,1,31,
2025-09-04,Peter Matt,Commercial Metals,5,4,0,9,
2025-09-04,Robert D Lawler,Continental Resources,1,0,0,1,
2025-09-04,Domenic Dell‚ÄôOsso Jr,Expand Energy,4,0,0,4,
2025-09-04,Jason P Wells,CenterPoint Energy,9,4,1,14,
2025-09-04,H Michael Krimbill,NGL Energy Partners,5,3,0,8,
2025-09-04,Tony Xu,DoorDash,14,18,8,40,
2025-09-04,Clay Williams,NOV,7,19,4,30,
2025-09-04,Kristin Peck,Zoetis,12,20,1,33,
2025-09-04,Mark Smucker,JM Smucker,12,22,6,40,
2025-09-04,Steve Sanghi,Microchip Technology,10,27,3,40,
2025-09-04,Richard Tobin,Dover Corporation,5,3,0,8,
2025-09-04,Kaes Van‚Äôt Hof,Diamondback Energy,21,15,3,39,
2025-09-04,Deon Stander,Avery Dennison,0,13,0,13,
2025-09-04,Vincent Sorgi,PPL,8,10,1,19,
2025-09-04,Hassane El-Khoury,ON Semiconductor,2,18,4,24,
2025-09-04,Arie Kotler,ARKO,5,22,1,28,
2025-09-04,William Monteleone,Par Pacific,1,7,2,10,
2025-09-04,John Christmann IV,APA,5,4,1,10,
2025-09-04,Adaire Fox-Martin,Equinix,16,20,4,40,
2025-09-04,Joseph M Otting,Flagstar Financial,2,6,2,10,
2025-09-04,Mary Dillon,Foot Locker,11,25,4,40,
2025-09-04,James Zallie,Ingredion,4,5,1,10,
2025-09-04,Christopher Peterson,Newell Brands,0,9,1,10,
2025-09-04,Scott Salmirs,ABM Industries,6,9,1,16,
2025-09-04,Christopher Hilger,Securian Financial,0,6,1,7,
2025-09-04,Hamid Moghadam,Prologis,7,28,5,40,
2025-09-04,Stephen Schwarzman,Blackstone,15,19,6,40,
2025-09-04,Robert Greenberg,Skechers USA,6,23,3,32,
2025-09-04,Keith Allman,Masco,4,9,1,14,
2025-09-04,Rusty Rush,Rush Enterprises,15,22,3,40,
2025-09-04,Jennifer Johnson,Franklin Resources,1,7,2,10,
2025-09-04,Gerry P Smith,ODP Business Solutions,0,0,0,0,
2025-09-04,Carl Lindner lll,American Financial,0,0,0,0,
2025-09-04,Mark Kowlzan,Packaging Corp of America,0,9,1,10,
2025-09-04,Thomas Hill,Vulcan Materials,4,6,2,12,
2025-09-04,Milan Galik,Interactive Brokers,7,19,1,27,
2025-09-04,Laura Alber,Williams-Sonoma,13,23,4,40,
2025-09-04,Mario Harik,XPO,8,31,1,40,
2025-09-04,Devin Stockfish,Weyerhaeuser,5,5,0,10,
2025-09-04,Thomas J McInerney,Genworth Financial,0,6,0,6,
2025-09-04,Garrick Rochow,CMS Energy,11,3,1,15,
2025-09-04,Toni Townes-Whitley,Science Applications International,12,23,1,36,
2025-09-04,Rich Handler,Jefferies Financial,12,10,2,24,
2025-09-04,Daniel Heaf,Bath & Body Works,12,26,2,40,
2025-09-04,Andrew Wilson,Electronic Arts,15,16,9,40,
2025-09-04,Sheryl Palmer,Taylor Morrison Home,7,12,1,20,
2025-09-04,Ivan Tornos,Zimmer Biomet,8,29,3,40,
2025-09-04,Linda Rendle,Clorox,2,34,2,38,
2025-09-04,Matthew Pine,Xylem Inc,1,8,1,10,
2025-09-04,Heather Lavallee,Voya Financial,6,11,2,19,
2025-09-04,Daniel Florness,Fastenal,3,5,1,9,
2025-09-04,Albert Nahmad,Watsco,2,8,0,10,
2025-09-04,Carl Eschenbach,Workday,12,19,9,40,
2025-09-04,Craig Smiddy,Old Republic International,2,6,1,9,
2025-09-04,Frank C Sullivan,RPM International,4,8,0,12,
2025-09-04,Matthew Missad,UFP Industries,7,3,0,10,
2025-09-04,Martin J Lyons,Ameren,1,4,1,6,
2025-09-04,Adam W Miller,Knight Swift Transportation,0,3,1,4,
2025-09-04,Rodney Sacks,Monster Beverage,12,26,1,39,
2025-09-04,Gary Guthart,Intuitive Surgical,14,23,3,40,
2025-09-04,Charles Liang,Super Micro Computer,33,6,1,40,
2025-09-04,Christopher Caldwell,Concentrix,3,5,0,8,
2025-09-04,Gordon J Hardie,O-I Glass,0,4,0,4,
2025-09-04,David Gibbs,Yum Brands,3,36,1,40,
2025-09-04,Steve Henry,Domtar,5,5,0,10,
2025-09-04,Chuck Treadway,CommScope,8,20,3,31,
2025-09-04,Rob Vitale,Post Holdings,1,11,5,17,
2025-09-04,Steven J Moskowitz,Crown Castle,2,5,3,10,
2025-09-04,Emmanuel Ligner,Avantor,3,11,1,15,
2025-09-04,Stuart Bradie,KBR,15,17,4,36,
2025-09-04,Carrie Wheeler,Opendoor Technologies,10,28,2,40,
2025-09-04,Russell Becker,APi Group,4,5,1,10,
2025-09-04,Toby Rice,EQT,24,14,2,40,
2025-09-04,Jesse Arenivas,EnLink Midstream,7,10,0,17,
2025-09-04,Nikesh Arora,Palo Alto Networks,7,25,8,40,
2025-09-04,Steven Bandrowczak,Xerox,1,8,1,10,
2025-09-04,Vicente Reynal,Ingersoll Rand,7,27,0,34,
2025-09-04,William T Dillard II,Dillards,3,5,2,10,
2025-09-04,C Howard Nye,Martin Marietta Materials,2,5,3,10,
2025-09-04,Giordano Albertazzi,Vertiv,16,20,4,40,
2025-09-04,Stephane Bancel,Moderna,9,22,9,40,
2025-09-04,Nate R Jorgensen,Boise Cascade,0,0,0,0,
2025-09-04,Jack Sinclair,Sprouts Farmers Market,15,24,1,40,
2025-09-04,Padraig McDonnell,Agilent Technologies,11,15,0,26,
2025-09-04,Kenneth T Lane,Olin,0,0,0,0,
2025-09-04,Randall C Stuewe,Darling Ingredients,28,1,0,29,
2025-09-04,R Howard Coker,Sonoco Products,4,5,1,10,
2025-09-04,John Mengucci,CACI International,20,18,2,40,
2025-09-04,Mark Witkowski,Core & Main,0,8,1,9,
2025-09-04,Lee M Tillman,Marathon Oil,4,4,0,8,
2025-09-04,Mark Hoplamazian,Hyatt Hotels,16,20,4,40,
2025-09-04,David S Chernow,Select Medical,0,8,1,9,
2025-09-04,Brendan M Foley,McCormick & Company,0,8,0,8,
2025-09-04,Joanne Crevoiserat,Tapestry,15,21,4,40,
2025-09-04,John Plant,Howmet Aerospace,6,13,3,22,
2025-09-04,Shankh Mitra,Welltower,19,19,2,40,
2025-09-04,W Anthony Will,CF Industries,4,4,0,8,
2025-09-04,David A Zapico,Ametek,2,16,0,18,
2025-09-04,Kevin Stein,TransDigm,10,8,3,21,
2025-09-04,Craig Billings,Wynn Resorts,13,24,3,40,
2025-09-04,William J Way,Southwestern Energy,1,1,0,2,
2025-09-04,Giel Rutten,Amkor Technology,2,9,1,12,
2025-09-04,Paul Sarvadi,Insperity,4,5,1,10,
2025-09-04,Donald Zurbay,Patterson Companies Inc,0,1,0,1,
2025-09-04,Rob Sharps,T Rowe Price,11,23,5,39,
2025-09-04,Patrice Louvet,Ralph Lauren,14,16,10,40,
2025-09-04,Jeffrey Mezger,KB Home,1,30,9,40,
2025-09-04,David M Foulkes,Brunswick,0,7,0,7,
2025-09-04,M Keith Waddell,Robert Half,2,8,1,11,
2025-09-04,Jay Snowden,PENN Entertainment,18,19,3,40,
2025-09-04,George Kurian,NetApp,15,22,3,40,
2025-09-04,Kevin Ali,Organon,9,20,1,30,
2025-09-04,Joel D Anderson,Petco Health and Wellness,3,9,0,12,
2025-09-04,Louis V Pinkham,Regal Rexnord,0,0,0,0,
2025-09-04,Jay Geldmacher,Resideo Technologies,10,5,1,16,
2025-09-04,Marcus Lemonis,Camping World,5,26,9,40,
2025-09-04,Peter R Huntsman,Huntsman,6,11,4,21,
2025-09-04,Hillary Super,Victorias Secret,11,5,8,24,
2025-09-04,Michelle Gass,Levi Strauss,10,26,3,39,
2025-09-04,Neil Hunn,Roper Technologies,2,20,0,22,
2025-09-04,Steven P Lawrence,Academy Sports and Outdoors,1,1,0,2,
2025-09-04,Phillippe Lord,Meritage Homes,9,16,0,25,
2025-09-04,David C Dauch,American Axle & Manufacturing,5,6,2,13,
2025-09-04,Olumide Soroye,Fortive,1,8,0,9,
2025-09-04,Adena Friedman,Nasdaq,12,24,4,40,
2025-09-04,Tim Gokey,Broadridge Financial Solutions,3,13,1,17,
2025-09-04,Patrick M Shanahan,Spirit AeroSystems,1,9,0,10,
2025-09-04,Robert Kyncl,Warner Music Group,8,31,1,40,
2025-09-04,Denise Dignam,Chemours,2,19,4,25,
2025-09-04,Jim DeVries,ADT,9,7,1,17,
2025-09-04,Bernard Zovighian,Edwards Lifesciences,8,5,2,15,
2025-09-04,Mark E Seaton,First American Financial,1,9,0,10,
2025-09-04,John C Roche,Hanover Insurance Group,7,20,1,28,
2025-09-04,Adam J Greenlee,Silgan,0,4,0,4,
2025-09-04,Jayne Hrdlicka,Endeavor Group,0,1,0,1,
2025-09-04,Robert Fauber,Moodys Corporation,0,6,0,6,
2025-09-04,Thomas E Jorden,Coterra Energy,9,0,0,9,
2025-09-04,Eugene A Hall,Gartner,1,9,0,10,
2025-09-04,Kevin Plank,Under Armour,8,28,4,40,
2025-09-04,James W Lanning,Ingles Markets,3,4,0,7,
2025-09-04,Matthew T Farrell,Church & Dwight,6,7,0,13,
2025-09-04,Kevin M Freeman,Old Dominion Freight Line,0,0,0,0,
2025-09-04,Joe Shoen,U-Haul,14,21,4,39,
2025-09-04,Mark Bertolini,Oscar Health,12,19,9,40,
2025-09-04,Jayshree Ullal,Arista Networks,21,17,2,40,
2025-09-04,Sassine Ghazi,Synopsys,11,26,3,40,
2025-09-04,Jochen Zeitz,Harley-Davidson,6,24,10,40,
2025-09-04,Nick Jeffery,Frontier Communications,10,24,2,36,
2025-09-04,Thomas Edward McCormick,Primoris Services,0,4,0,4,
2025-09-04,D Christian Koch,Carlisle Companies,1,4,1,6,
2025-09-04,David E Simon,Simon Property Group,2,5,3,10,
2025-09-04,Stephen Bratspies,Hanesbrands,3,10,1,14,
2025-09-04,Ryan M. Schneider,Anywhere Real Estate Inc,0,1,0,1,
2025-09-04,George Bobb III,Teledyne Technologies,1,4,1,6,
2025-09-04,Terrence A Duffy,CME Group,6,9,1,16,
2025-09-04,Rami Rahim,Juniper Networks,10,28,2,40,
2025-09-04,Sue Nabi,Coty,16,18,6,40,
2025-09-04,Peter D Arvan,Pool Corporation,2,7,0,9,
2025-09-04,David Campbell,Evergy,12,9,0,21,
2025-09-04,Matthew J Murphy,Marvell Technology,4,5,1,10,
2025-09-04,Lloyd Yates,NiSource,6,4,0,10,
2025-09-04,William C Stone,SS&C Technologies,2,6,0,8,
2025-09-04,Mark Rourke,Schneider National,9,19,1,29,
2025-09-04,Andrew Anagnost,Autodesk,7,25,8,40,
2025-09-04,Dustin Semach,Sealed Air Corporation,0,10,0,10,
2025-09-04,William L Meaney,Iron Mountain,2,19,0,21,
2025-09-04,Andy P Power,Digital Realty Trust,0,0,0,0,
2025-09-04,Satish Dhanasekaran,Keysight Technologies,3,11,0,14,
2025-09-04,Frank M Svoboda,Globe Life,3,4,3,10,
2025-09-04,Carey A Smith,Parsons Corporation,1,3,0,4,
2025-09-04,Ynon Kreiz,Mattel,10,23,7,40,
2025-09-04,Karen S Haller,Southwest Gas,3,6,0,9,
2025-09-04,Terrance Williams,TruStage,4,6,1,11,
2025-09-04,Eric W Gerstenberg,Clean Harbors,3,2,2,7,
2025-09-04,Gunner Smith,Cornerstone Building Brands,1,8,0,9,
2025-09-04,Gerben W Bakker,Hubbell,1,4,0,5,
2025-09-04,Dave Davis,Spirit Airlines,5,31,4,40,
2025-09-04,Michael J Smith,Lamb Weston,0,7,3,10,
2025-09-04,Strauss Zelnick,Take-Two Interactive Software,13,18,9,40,
2025-09-04,John C Turner Jr,GMS,3,6,0,9,
2025-09-04,David M O'Malley,Penn Mutual Life Insurance,1,2,0,3,
2025-09-04,Frank A Lonegro,Landstar System,3,3,0,6,
2025-09-04,James F Risoleo,Host Hotels & Resorts,6,17,0,23,
2025-09-04,Ken Xie,Fortinet,13,19,8,40,
2025-09-04,Doug Shulman,OneMain,3,7,0,10,
2025-09-04,Ryan Cohen,GameStop,11,21,8,40,
2025-09-04,Mark W Begor,Equifax,2,12,0,14,
2025-09-04,Jay L Schottenstein,American Eagle Outfitters,9,15,1,25,
2025-09-04,Curtis C Farmer,Comerica,4,9,0,13,
2025-09-04,Ole Rosgaard,Greif,3,17,1,21,
2025-09-04,Brian E Lane,Comfort Systems USA,9,0,0,9,
2025-09-04,Robert M Buck,TopBuild,0,5,1,6,
2025-09-04,Ralph Andretta,Bread Financial,3,9,0,12,
2025-09-04,Jim Anderson,Coherent,6,33,1,40,
2025-09-04,Walter C. D. Carlson,Telephone & Data Systems,0,2,0,2,
2025-09-04,Ronald Kruszewski,Stifel Financial,7,4,0,11,
2025-09-04,Richard Hayne,Urban Outfitters,11,21,8,40,
2025-09-04,Simon Meester,Terex,3,7,0,10,
2025-09-04,Edward J Lehner,Ryerson Holding,0,2,1,3,
2025-09-04,Nicholas T Pinchuk,Snap-on,4,5,0,9,
2025-09-04,Ryals McMullian,Flowers Foods,5,28,2,35,
2025-09-04,D Bryan Jordan,First Horizon,4,8,1,13,
2025-09-04,John B Gibson,Paychex,3,6,0,9,
2025-09-04,Chris Cocks,Hasbro,12,18,10,40,
2025-09-04,Pete McPartland,Sentry Insurance Group,0,2,0,2,
2025-09-04,Michael Arougheti,Ares Management,17,21,2,40,
2025-09-04,Alok Maskara,Lennox International,5,4,1,10,
2025-09-04,James C Grech,Peabody Energy,3,0,0,3,
2025-09-04,Joseph P Lacher Jr,Kemper,4,18,4,26,
2025-09-04,Perry A Sook,Nexstar Media Group,7,30,1,38,
2025-09-04,Wade Davis,TelevisaUnivision,14,24,2,40,
2025-09-04,Scott L Thompson,Tempur Sealy International,0,7,0,7,
2025-09-04,Mike Simonds,TriNet Group,0,9,0,9,
2025-09-04,B Andrew Rose,Worthington Enterprises,1,2,0,3,
2025-09-04,Bruce L Caswell,Maximus,5,5,0,10,
2025-09-04,Robert L Reffkin,Compass,1,6,0,7,
2025-09-04,Mark Eubanks,Brinks Company,1,2,1,4,
2025-09-04,Peter Quigley,Kelly Services inc,2,8,0,10,
2025-09-04,David L Yowan,Navient,2,3,0,5,
2025-09-04,Mary E Kipp,Puget Sound Energy,4,0,2,6,
2025-09-04,Adam Aron,AMC Entertainment,18,14,8,40,
2025-09-04,Mark J Tarr,Encompass Health,2,6,1,9,
2025-09-04,Liam K Griffin,Skyworks Solutions,1,6,1,8,
2025-09-04,Richard G Kyle,Timken,8,22,1,31,
2025-09-04,Ron Gusek,Liberty Energy,23,1,0,24,
2025-09-04,John E Geller Jr,Marriott Vacations Worldwide,6,6,0,12,
2025-09-04,Karl G. Glassman,Leggett & Platt,0,4,0,4,
2025-09-04,Bruce K Thorn,Big Lots,3,5,2,10,
2025-09-04,Jonathan H Weis,Weis Markets,11,28,0,39,
2025-09-04,Jeffrey B Guldner,Pinnacle West Capital,1,4,0,5,
2025-09-04,Arkadiy Dobkin,EPAM Systems,12,17,2,31,
2025-09-04,Paul M Rady,Antero Resources,4,9,0,13,
2025-09-04,Michael Spanos,Bloomin Brands,1,8,1,10,
2025-09-04,Nicole A Kivisto,MDU Resources Group,1,5,0,6,
2025-09-04,Gerald L Morgan,Texas Roadhouse,3,3,4,10,
2025-09-04,Gabriel Tirador,Mercury General,4,4,2,10,
2025-09-04,Nicholas I Fink,Fortune Brands Innovations,3,4,0,7,
2025-09-04,Paul E Burdiss,Zions Bancorp,1,1,0,2,
2025-09-04,William J Christensen,JELD-WEN Holding,4,5,0,9,
2025-09-04,Evan Spiegel,Snap Inc,20,17,3,40,
2025-09-04,Bill Burns,Zebra Technologies,8,24,1,33,
2025-09-04,Steven Sell,Agilon Health,1,7,1,9,
2025-09-04,Richard M Olson,Toro Company,1,15,0,16,
2025-09-04,Eric S Yuan,Zoom Video Communications,6,7,0,13,
2025-09-04,Dan L Batrack,Tetra Tech,2,4,1,7,
2025-09-04,Joseph D Russell Jr,Public Storage,0,8,0,8,
2025-09-04,Jacob Thaysen,Illumina inc,5,7,0,12,
2025-09-04,Debra A Cafaro,Ventas inc,7,5,0,12,
2025-09-04,Pierre R Brondeau,FMC Corporation,1,4,1,6,
2025-09-04,Judy R McReynolds,ArcBest,6,14,1,21,
2025-09-04,Russell J Weiner,Dominos Pizza inc,0,0,0,0,
2025-09-04,Theodore S Hanson,ASGN,0,3,0,3,
2025-09-04,RJ Scaringe,Rivian Automotive,11,27,2,40,
2025-09-04,Jeffrey N Simmons,Elanco Animal Health,2,5,1,8,
2025-09-04,Tim O Shaughnessy,Graham Holdings Company,3,6,0,9,
2025-09-04,Thomas V Taylor,Floor & Decor,1,1,2,4,
2025-09-04,Neil A Schrimsher,Applied Industrial Technologies,5,24,1,30,
2025-09-04,Robert E Price,PriceSmart,4,6,0,10,
2025-09-04,John David Risher,Lyft,1,5,1,7,
2025-09-04,Gary B Smith,Ciena,4,8,0,12,
2025-09-04,Joey Levin,IAC,7,31,1,39,
2025-09-04,Jim Jacobs,Country Financial,7,3,2,12,
2025-09-04,Devin B McGranahan,Western Union,1,5,0,6,
2025-09-04,R Scott Rowe,Flowserve,5,4,1,10,
2025-09-04,Kenneth A Vecchione,Western Alliance Bancorp,0,0,1,1,
2025-09-04,John C Rademacher,Option Care Health,10,1,0,11,
2025-09-04,Doug Black,SiteOne Landscape Supply,3,23,2,28,
2025-09-04,Oliver G Brewer III,Topgolf Callaway Brands,1,0,0,1,
2025-09-04,Glenn Sanford,eXp World,15,21,4,40,
2025-09-04,Fran Horowitz,Abercrombie & Fitch,14,19,7,40,
2025-09-04,Kevin Akers,Atmos Energy,7,2,1,10,
2025-09-04,Alessandro Maselli,Catalent,4,11,2,17,
2025-09-04,J Powell Brown,Brown & Brown,11,22,7,40,
2025-09-04,Aman Bhutani,GoDaddy,16,22,2,40,
2025-09-04,John C. Griffith,American Water Works,1,3,0,4,
2025-09-04,John J Marchioni,Selective Insurance Group,4,13,3,20,
2025-09-04,Lawson E Whiting,Brown-Forman,1,7,2,10,
2025-09-04,Dave Peacock,Advantage Solutions,20,8,0,28,
2025-09-04,Mick Farrell,ResMed,16,22,1,39,
2025-09-04,Kamal Hathi,Splunk,1,4,0,5,
2025-09-04,Todd Kelsey,Plexus,2,6,0,8,
2025-09-04,Phillip D Yeager,Hub Group,3,6,0,9,
2025-09-04,Steven B Hedlund,Lincoln Electric,5,10,0,15,
2025-09-04,Timothy C Oliver,NCR Atleos,0,1,0,1,
2025-09-04,Bruce Fleming,Calumet,2,7,0,9,
2025-09-04,Daniel S. Peyovich,Dycom Industries,1,6,0,7,
2025-09-04,Avner M Applbaum,Valmont Industries,0,8,1,9,
2025-09-04,Kimberly A Fields,ATI inc,5,10,0,15,
2025-09-04,Khozema Z Shipchandler,Twilio,0,2,0,2,
2025-09-04,Gary C Bhojwani,CNO Financial Group,1,7,1,9,
2025-09-04,William Andrew Hendricks Jr,Patterson-UTI Energy,1,0,0,1,
2025-09-04,Kevin D Hochman,Brinker International,1,4,1,6,
2025-09-04,James C Foster,Charles River Laboratories International,2,8,1,11,
2025-09-04,Rajiv K Prasad,Hyster-Yale,2,5,0,7,
2025-09-04,Eric T Steigerwalt,Brighthouse Financial,1,2,0,3,
2025-09-04,Thomas L Ryan,Service Corp International,5,5,0,10,
2025-09-04,Charles M Nifong Jr,CrossAmerica Partners,0,0,0,0,
2025-09-04,Anirudh Devgan,Cadence,10,23,3,36,
2025-09-04,Andi Owen,MillerKnoll,16,15,9,40,
2025-09-04,Sumit Roy,Realty Income,13,17,2,32,
2025-09-04,Timothy John Fitzgerald,Middleby,0,0,0,0,
2025-09-04,Robert H Schottenstein,M/I Homes,2,9,0,11,
2025-09-04,Stephen P MacMillan,Hologic,1,7,0,8,
2025-09-04,Lisa M Barton,Alliant Energy,5,0,0,5,
2025-09-04,Aaron P Jagdfeld,Generac,1,5,0,6,
2025-09-04,Erik Gershwind,MSC Industrial Direct,4,4,2,10,
2025-09-04,Varun Krishna,Rocket Companies,8,31,1,40,
2025-09-04,Fahmi Karam,Upbound Group,5,4,0,9,
2025-09-04,NADominic Ng,East West Bancorp,0,0,0,0,
2025-09-04,Mark Wang,Hilton Grand Vacations,38,2,0,40,
2025-09-04,Robert J Sheedy Jr,Grocery Outlet Holding,0,0,0,0,
2025-09-04,Simon D Campion,Dentsply Sirona,0,3,0,3,
2025-09-04,Jeremy Wensinger,V2X,6,9,0,15,
2025-09-04,Andrew Rees,Crocs,15,14,11,40,
2025-09-04,David M Maura,Spectrum Brands,6,1,0,7,
2025-09-04,Sachin S Lawande,Visteon,0,0,0,0,
2025-09-04,Neil M Ashe,Acuity Inc,0,1,0,1,
2025-09-04,Lorie L Tekorius,Greenbrier,2,8,0,10,
2025-09-04,John R Ciulla,Webster Financial,5,5,0,10,
2025-09-04,Sean D Keohane,Cabot Corporation,4,3,0,7,
2025-09-04,Drew M Wilkerson,RXO inc,0,0,0,0,
2025-09-04,Daniel E Brown,Chord Energy,1,1,0,2,
2025-09-04,Javier D Ferrer Fernandez,Popular inc,0,0,0,0,
2025-09-04,Olivier Rabiller,Garrett Motion inc,3,9,0,12,
2025-09-04,Ronald N Tutor,Tutor Perini Corporation,2,6,1,9,
2025-09-04,Jeff Liaw,Copart,4,5,1,10,
2025-09-04,Aman Narang,Toast inc,5,5,1,11,
2025-09-04,Joseph M Hogan,Align Technology,2,5,0,7,
2025-09-04,Kevin J Wheeler,A O Smith,0,16,1,17,
2025-09-04,Christopher A Cartwright,TransUnion,2,0,2,4,
2025-09-04,James Kelly,NCR Voyix,2,12,1,15,
2025-09-04,Tom Leighton,Akamai Technologies,14,15,6,35,
2025-09-04,Robert G Painter,Trimble,7,2,0,9,
2025-09-04,Tony Helton,Medical Mutual of Ohio,1,4,1,6,
2025-09-04,Caroline S Grace,AMN Healthcare Services,0,0,0,0,
2025-09-04,Patrick Kaltenbach,Mettler-Toledo International,3,5,1,9,
2025-09-04,Michael L Baur,ScanSource,0,3,0,3,
2025-09-04,Jason Lippert,LCI Industries,1,10,0,11,
2025-09-04,Fredric J Tomczyk,Cboe Global Markets,1,6,0,7,
2025-09-04,Octavio Marquez,Diebold Nixdorf,6,10,1,17,
2025-09-04,Sivasankaran Somasundaram,ChampionX,7,2,0,9,
2025-09-04,Ronald F Clarke,Corpay,0,1,0,1,
2025-09-04,Robert W Pittman,iHeartMedia,5,3,0,8,
2025-09-04,Patrick Zalupski,Dream Finders Homes,23,15,2,40,
2025-09-04,Keith E Smith,Boyd Gaming,1,6,1,8,
2025-09-04,Mehran Assadi,NLV Financial,1,1,0,2,
2025-09-04,Barry R Port,Ensign Group,3,4,2,9,
2025-09-04,Denise A Paulonis,Sally Beauty,1,2,0,3,
2025-09-04,Clifford A Skelton,Conduent,0,0,0,0,
2025-09-04,Jean-Michel Ribieras,Sylvamo,2,7,0,9,
2025-09-04,Douglas F Bauer,Tri Pointe Homes,0,5,0,5,
2025-09-04,Shawn O'Connell,EnerSys,2,5,0,7,
2025-09-04,Bill Meury,Incyte,7,16,0,23,
2025-09-04,Dale Francescon,Century Communities,2,8,3,13,
2025-09-04,Michael Nierenberg,Rithm Capital,8,26,1,35,
2025-09-04,Michael J Brown,Euronet Worldwide,2,8,0,10,
2025-09-04,Scott Seu,Hawaiian Electric Industries,4,17,3,24,
2025-09-04,Jason D Robins,DraftKings,5,3,0,8,
2025-09-04,Jonathan J Mazelsky,IDEXX Laboratories,1,2,1,4,
2025-09-04,Richard S Swartz,MYR Group,0,2,0,2,
2025-09-04,Stefano Caroti,Deckers Outdoor,2,6,1,9,
2025-09-04,Kevin R Sayer,DexCom,2,3,0,5,
2025-09-04,John T C Lee,MKS Instruments,4,9,1,14,
2025-09-04,Edward B Pitoniak,VICI Properties,1,7,0,8,
2025-09-04,Albert White III,Cooper Cos,0,0,0,0,
2025-09-04,Barry L Biffle,Frontier Airlines,1,6,6,13,
2025-09-04,Robert A Bruggeworth,Qorvo,5,4,0,9,
2025-09-04,Winnie Park,Five Below,9,27,4,40,
2025-09-04,Steven Oakland,TreeHouse Foods,2,14,0,16,
2025-09-04,James S Hagedorn,Scotts Miracle-Gro,1,0,0,1,
2025-09-04,Michael Cannon-Brookes,Atlassian,19,19,2,40,
2025-09-04,Bertrand Loy,Entegris,3,11,1,15,
2025-09-04,William E Waltz,Atkore,3,7,0,10,
2025-09-04,Celeste B Mastin,H B Fuller,1,4,0,5,
2025-09-04,Kyle T Larkin,Granite Construction,1,7,0,8,
2025-09-04,Michael J Happe,Winnebago Industries,1,3,0,4,
2025-09-04,Steven H Gunby,FTI Consulting,5,10,0,15,
2025-09-04,Stephan B Tanda,AptarGroup,0,4,3,7,
2025-09-04,Timothy P Boyle,Columbia Sportswear,3,3,2,8,
2025-09-04,Anthony J Wood,Roku,4,5,1,10,
2025-09-04,M Christopher Doyle,Civitas Resources,1,2,0,3,
2025-09-04,Andy Eidson,Alpha Metallurgical Resources,1,7,2,10,
2025-09-04,Andy L Nemeth,Patrick Industries,4,1,0,5,
2025-09-04,Roger W Jenkins,Murphy Oil,3,16,0,19,
2025-09-04,Kevin S Blair,Synovus Financial,7,2,0,9,
2025-09-04,Julie Felss Masino,Cracker Barrel Old Country Store,6,18,16,40,
2025-09-04,David M Overton,Cheesecake Factory,1,9,0,10,
2025-09-04,Nick DeIuliis,CNX Resources,8,3,0,11,
2025-09-04,Christopher Pappas,Chefs Warehouse,3,7,1,11,
2025-09-04,Tod Carpenter,Donaldson Company,2,8,0,10,
2025-09-04,Gregory L Christopher,Mueller Industries,2,6,0,8,
2025-09-04,Rob Saltiel,MRC Global,7,13,2,22,
2025-09-04,Jillian C Evanko,Chart Industries,3,6,0,9,
2025-09-04,Dave Guilmette,Alight Solutions,3,7,0,10,
2025-09-04,Joel Smejkal,Vishay Intertechnology,5,4,1,10,
2025-09-04,Dennis Degner,Range Resources,3,8,0,11,
2025-09-04,Ira D Robbins,Valley National Bancorp,1,1,0,2,
2025-09-04,Bernard Kim,Match Group,14,19,7,40,
2025-09-04,Vincent Pilette,Gen Digital,2,14,0,16,
2025-09-04,Timothy S Crane,Wintrust Financial,2,8,0,10,
2025-09-04,Pat Roche,Moog inc,4,11,2,17,
2025-09-04,Mark R Widmar,First Solar,3,6,1,10,
2025-09-04,Niko Lahanas,Central Garden & Pet,1,11,0,12,
2025-09-04,Chris Osowski,Green Plains inc,8,14,1,23,
2025-09-04,Derek J Leathers,Werner Enterprises,2,8,0,10,
2025-09-04,Adam Foroughi,AppLovin,9,27,4,40,
2025-09-04,Luca Savi,ITT,3,7,0,10,
2025-09-04,Lawrence H Silber,Herc Rentals,0,0,0,0,
2025-09-04,Hilton H Howell Jr,Gray Television,7,21,1,29,
2025-09-04,Eric D Ashleman,IDEX,0,9,1,10,
2025-09-04,Owen D Thomas,Boston Properties,3,7,0,10,
2025-09-04,Kurt Wolf,Pitney Bowes,5,20,2,27,
2025-09-04,Sara E Armbruster,Steelcase,2,0,0,2,
2025-09-04,Charles D. Young,Sun Communities,2,5,0,7,
2025-09-04,Suzanne Foster,AdaptHealth,5,7,1,13,
2025-09-04,Grant E Sims,Genesis Energy,2,2,0,4,
2025-09-04,Laura Prieskorn,Jackson Financial,3,5,2,10,
2025-09-04,Rick L Wessel,FirstCash,4,5,1,10,
2025-09-04,Sherman Miller,Cal-Maine Foods,11,28,1,40,
2025-09-04,Paul A Lang,Arch Resources,5,3,1,9,
2025-09-04,Ashish K Khandpur,Avient,2,6,0,8,
2025-09-04,Shyam K Reddy,BlueLinx,1,7,0,8,
2025-09-04,Christopher S Ripley,Sinclair,1,7,0,8,
2025-09-04,Stacy Kymes,BOK Financial,8,7,0,15,
2025-09-04,James H Walter,Permian Resources,0,1,0,1,
2025-09-04,Jason Murray,PACS Group,5,14,2,21,
2025-09-04,Brian Armstrong,Coinbase Global,12,24,4,40,
2025-09-04,Oscar K Brown,Western Midstream Partners,1,3,0,4,
2025-09-04,Nicholas R Lower,Federated Mutual Insurance,0,0,0,0,
2025-09-04,Morris Goldfarb,G-III Apparel Group,11,23,6,40,
2025-09-04,Mark D Morelli,Vontier,0,4,0,4,
2025-09-04,Matthew J Cox,Matson inc,0,6,0,6,
2025-09-04,David W Grzebinski,Kirby Corporation,1,3,0,4,
2025-09-04,Keith A Harvey,Kaiser Aluminum,3,4,2,9,
2025-09-04,Eric Nyman,Vista Outdoor,4,11,1,16,
2025-09-04,Doug Howe,Designer Brands,4,19,0,23,
2025-09-04,Jerry E Gahlhoff Jr,Rollins inc,0,2,0,2,
2025-09-04,D Scott Barbour,Advanced Drainage Systems,2,2,0,4,
2025-09-04,Sean Gamble,Cinemark,19,20,1,40,
2025-09-04,George Kurtz,CrowdStrike,16,22,2,40,
2025-09-04,Bill Ready,Pinterest,25,15,0,40,
2025-09-04,Fidji Simo,Instacart,9,30,1,40,
2025-09-04,Kimberly K Ryan,Hillenbrand,3,5,0,8,
2025-09-04,David S Graziosi,Allison Transmission,1,17,2,20,
2025-09-04,Gary G Friedman,Restoration Hardware,1,4,0,5,
2025-09-04,Lucinda M Baier,Brookdale Senior Living,3,4,0,7,
2025-09-04,Brian J Blaser,QuidelOrtho,1,9,0,10,
2025-09-04,E Jean Savage,Trinity Industries,1,7,1,9,
2025-09-04,Liam J Kelly,Teleflex,2,5,1,8,
2025-09-04,Laurans A Mendelson,HEICO,8,21,1,30,
2025-09-04,Frank H Laukien,Bruker,1,8,0,9,
2025-09-04,Harvey M Schwartz,Carlyle Group,5,14,0,19,
2025-09-04,Mark S LaVigne,Energizer,2,0,0,2,
2025-09-04,Joel Quadracci,Quad/Graphics,12,23,5,40,
2025-09-04,Amar Maletira,Rackspace Technology,5,13,2,20,
2025-09-04,Udit Batra,Waters Corporation,10,26,0,36,
2025-09-04,Eric M Green,West Pharmaceutical Services,1,9,0,10,
2025-09-04,Doug Palladini,Carters inc,2,2,2,6,
2025-09-04,G Mike Mikan,NeueHealth,4,2,0,6,
2025-09-04,Russell ChipChilds,SkyWest,0,0,0,0,
2025-09-04,Christopher H Hunter,Acadia Healthcare,0,1,0,1,
2025-09-04,Prahlad Singh,Revvity,2,7,0,9,
2025-09-04,Maria M Pope,Portland General Electric,1,1,0,2,
2025-09-04,Charles Chip Blankenship,Woodward inc,0,1,0,1,
2025-09-04,Mike Steib,TEGNA,12,18,1,31,
2025-09-04,Kurt J Ekert,Sabre Corporation,0,1,0,1,
2025-09-04,Matt Wilson,Light & Wonder,16,20,4,40,
2025-09-04,Rob Katz,Vail Resorts,4,12,24,40,
2025-09-04,Schnitzer Steel Industries,Radius Recycling,10,25,5,40,
2025-09-04,David A Spector,PennyMac Financial Services,3,1,0,4,
2025-09-04,Frederick J Holzgrefe III,Saia inc,1,1,0,2,
2025-09-04,Mark J Parrell,Equity Residential,4,6,0,10,
2025-09-04,John W Lindsay,Helmerich & Payne,0,4,0,4,
2025-09-04,Gary D Burnison,Korn Ferry,3,14,0,17,
2025-09-04,Timothy J McGrath,PC Connection Inc,1,2,0,3,
2025-09-04,Lynn M Bamford,Curtiss-Wright,13,9,0,22,
2025-09-04,Jonathan W Witter,Sallie Mae,0,1,0,1,
2025-09-04,Jeff Benck,Benchmark Electronics,8,6,0,14,
2025-09-04,Charles H Giancarlo,Pure Storage,0,3,0,3,
2025-09-04,Brian R Gray,Knife River Corporation,0,1,0,1,
2025-09-04,Jay Schmidt,Caleres inc,3,5,2,10,
2025-09-04,Dale Asplund,BrightView Holdings,1,5,0,6,
2025-09-04,Jeffrey S Edwards,Cooper-Standard,0,5,0,5,
2025-09-04,Glenn J Williams,Primerica,6,1,2,9,
2025-09-04,Francois Locoh-Donou,F5,8,20,3,31,
2025-09-04,Joseph Wm Foran,Matador Resources,7,10,0,17,
2025-09-04,Sridhar Ramaswamy,Snowflake inc,11,25,4,40,
2025-09-04,Mark D Dankberg,Viasat,2,4,2,8,
2025-09-04,Francisco J Leon,California Resources,1,4,1,6,
2025-09-04,Peter Stern,Peloton,18,18,4,40,
2025-09-04,David Baszucki,Roblox,11,21,8,40,
2025-09-04,Jeffrey W Edwards,Installed Building Products,0,3,0,3,
2025-09-04,Clark Lauritzen,First National of Nebraska,1,7,0,8,
2025-09-04,Carlos Alberini,Guess inc,12,27,1,40,
2025-09-04,Shyam P Kambeyanda,ESAB,3,4,0,7,
2025-09-04,Edmund Shallcross III,Amica Mutual Insurance,1,5,0,6,
2025-09-04,Benjamin W Schall,AvalonBay Communities,1,6,1,8,
2025-09-04,Allan C Thygesen,DocuSign,4,6,0,10,
2025-09-04,Bryan J Knutson,Titan Machinery,1,2,1,4,
2025-09-04,Heath Sampson,ModivCare,8,1,1,10,
2025-09-04,Ara K Hovnanian,Hovnanian Enterprises,2,18,1,21,
2025-09-04,Joshua G Silverman,Etsy,2,3,0,5,
2025-09-04,Kevin Roycraft,Adams Resources & Energy,5,4,1,10,
2025-09-04,J Eric Evans,Surgery Partners,0,3,0,3,
2025-09-04,Clint E Stein,Columbia Banking System,1,7,0,8,
2025-09-04,Lee M Shavel,Verisk Analytics,3,7,0,10,
2025-09-04,Dave Banyard Jr,MasterBrand,0,0,0,0,
2025-09-04,Peter R Ingram,Hawaiian Airlines inc,1,0,0,1,
2025-09-04,Kristin A Dolan,AMC Networks,3,2,0,5,
2025-09-04,Brendan T Cavanagh,SBA Communications,1,2,0,3,
2025-09-04,George F Chappelle Jr,Americold Realty Trust,1,3,0,4,
2025-09-04,Thomas E Gottwald,NewMarket Corporation,2,7,0,9,
2025-09-04,Thomas J Baltimore Jr,Park Hotels & Resorts,3,31,0,34,
2025-09-04,Peter M Moglia,Alexandria Real Estate Equities,3,6,0,9,
2025-09-04,Ronald J Kramer,Griffon Corporation,1,6,0,7,
2025-09-04,John L Plueger,Air Lease,2,13,0,15,
2025-09-04,Jennifer F Scanlon,UL Solutions,1,4,0,5,
2025-09-04,Greg Smith,Teradyne,2,9,2,13,
2025-09-04,Sean Trauschke,OGE Energy,19,5,0,24,
2025-09-04,Norman D Schwartz,Bio-Rad Laboratories,0,1,1,2,
2025-09-04,Scott Doyle,Spire inc,4,4,1,9,
2025-09-04,Michael E Reed,Gannett,0,5,2,7,
2025-09-04,Cindy J Miller,Stericycle,2,4,2,8,
2025-09-04,Phillip D Green,Cullen Frost Bankers,1,5,3,9,
2025-09-04,Joseph D Margolis,Extra Space Storage,0,9,1,10,
2025-09-04,Mark A Skonieczny,REV Group,5,4,1,10,
2025-09-04,Ladd Wilks,ProFrac Holding,4,3,1,8,
2025-09-04,Sundaram Nagarajan,Nordson,0,10,1,11,
2025-09-04,Anne P Noonan,Summit Materials,0,0,0,0,
2025-09-04,Lori Flees,Valvoline inc,4,4,1,9,
2025-09-04,Scott H Baxter,Kontoor Brands,3,2,0,5,
2025-09-04,Tim Larson,Skyline Champion,7,0,0,7,
2025-09-04,Chuck Divita,Teladoc Health,9,20,5,34,
2025-09-04,W Bradley Southern,Louisiana-Pacific Corporation,0,0,0,0,
2025-09-04,George C Freeman III,Universal Corporation,4,5,0,9,
2025-09-04,James A Brock,Consol Energy,2,0,0,2,
2025-09-04,Robert Antokol,Playtika Holding,1,7,1,9,
2025-09-04,Joe Craft,Alliance Resource Partners,7,9,2,18,
2025-09-04,Paul Keel,Envista,1,7,1,9,
2025-09-04,Jared Isaacman,Shift4 Payments,5,29,6,40,
2025-09-04,Mark Mac McFarland,Talen Energy,3,1,1,5,
2025-09-04,Tony R Thene,Carpenter Technology,2,9,0,11,
2025-09-04,Melissa D Smith,WEX,2,6,1,9,
2025-09-04,James Jim C Ryan III,Old National Bancorp,1,0,0,1,
2025-09-04,Peter J Federico,AGNC Investment,1,0,0,1,
2025-09-04,Brent L Yeagy,Wabash National,0,0,0,0,
2025-09-04,Henry A Fernandez,MSCI,3,13,0,16,
2025-09-04,Mark Penn,Stagwell,14,23,2,39,
2025-09-04,Julie Schertell,Mativ,2,9,0,11,
2025-09-04,Ashish Chand,Belden,2,6,2,10,
2025-09-04,Greg Anderson,Allegiant Travel Company,5,7,0,12,
2025-09-04,Drew Houston,Dropbox,14,19,7,40,
2025-09-04,Kevin T Conroy,Exact Sciences,2,5,2,9,
2025-09-04,Rex D Geveden,BWX Technologies,4,7,0,11,
2025-09-04,Scott R Wells,Clear Channel Outdoor Hldgs,0,0,0,0,
2025-09-04,Paul Bay,Ingram Micro,11,24,5,40,
2025-09-05,Doug McMillon,Walmart,16,19,5,40,
2025-09-05,Andrew Jassy,Amazon,3,32,5,40,
2025-09-05,Tim Cook,Apple,10,28,2,40,
2025-09-05,Stephen Hemsley,UnitedHealth,8,26,6,40,
2025-09-05,Warren Buffett,Berkshire Hathaway,10,23,7,40,
2025-09-05,David Joyner,CVS Health,8,28,4,40,
2025-09-05,Darren Woods,Exxon Mobil,8,24,7,39,
2025-09-05,Sundar Pichai,Alphabet,0,0,0,0,
2025-09-05,Brian Tyler,McKesson,4,15,5,24,
2025-09-05,Robert Mauch,Cencora,0,0,0,0,
2025-09-05,Ron Vachris,Costco,7,31,2,40,
2025-09-05,Jamie Dimon,JPMorgan Chase,10,18,12,40,
2025-09-05,Satya Nadella,Microsoft,17,21,2,40,
2025-09-05,Jason Hollar,Cardinal Health,14,21,5,40,
2025-09-05,Mike Wirth,Chevron,17,17,6,40,
2025-09-05,David Cordani,Cigna,20,16,4,40,
2025-09-05,Jim Farley,Ford Motor,13,21,6,40,
2025-09-05,Brian Moynihan,Bank of America,7,28,5,40,
2025-09-05,Mary Barra,General Motors,14,21,5,40,
2025-09-05,Gail Boudreaux,Elevance Health,16,17,7,40,
2025-09-05,Jane Fraser,Citigroup,12,21,7,40,
2025-09-05,Sarah London,Centene,13,18,9,40,
2025-09-05,Ted Decker,Home Depot,15,20,5,40,
2025-09-05,Maryann Mannen,Marathon Petroleum,6,13,1,20,
2025-09-05,Ron Sargent,Kroger,5,24,11,40,
2025-09-05,Mark Lashier,Phillips 66,12,18,8,38,
2025-09-05,Priscilla Almodovar,Fannie Mae,10,18,12,40,
2025-09-05,Tim Wentworth,Walgreens,9,23,8,40,
2025-09-05,Lane Riggs,Valero Energy,13,9,0,22,
2025-09-05,Mark Zuckerberg,Meta,5,22,13,40,
2025-09-05,Hans Vestberg,Verizon,16,20,4,40,
2025-09-05,John Stankey,AT&T,12,24,4,40,
2025-09-05,Brian Roberts,Comcast,11,27,2,40,
2025-09-05,Charles Scharf,Wells Fargo,27,7,6,40,
2025-09-05,David Solomon,Goldman Sachs,8,23,9,40,
2025-09-05,Michael Hutchins,Freddie Mac,3,10,4,17,
2025-09-05,Michael Fiddelke,Target,12,22,6,40,
2025-09-05,Jim Rechtin,Humana,18,17,5,40,
2025-09-05,Jon Farney,State Farm Insurance,1,13,3,17,
2025-09-05,Elon Musk,Tesla,16,21,3,40,
2025-09-05,Ted Pick,Morgan Stanley,16,21,3,40,
2025-09-05,Joaquin Duato,Johnson & Johnson,10,26,4,40,
2025-09-05,Juan Luciano,Archer Daniels Midland,3,20,17,40,
2025-09-05,Ramon Laguarta,PepsiCo,7,29,4,40,
2025-09-05,Carol Tom√©,UPS,8,22,10,40,
2025-09-05,Rajesh Subramaniam,FedEx,9,28,0,37,
2025-09-05,Bob Iger,Walt Disney,8,29,3,40,
2025-09-05,Michael Dell,Dell Technologies,12,24,4,40,
2025-09-05,Marvin Ellison,Lowes,14,25,0,39,
2025-09-05,Jon Moeller,Procter & Gamble,3,29,7,39,
2025-09-05,Thomas Long,Energy Transfer,8,0,2,10,
2025-09-05,Kelly Ortberg,Boeing,12,24,4,40,
2025-09-05,Susan Morris,Albertsons,12,25,3,40,
2025-09-05,Kevin Hourican,Sysco,9,28,3,40,
2025-09-05,Christopher Calio,RTX,7,11,0,18,
2025-09-05,Larry Culp,General Electric,11,26,3,40,
2025-09-05,James Taiclet,Lockheed Martin,13,19,8,40,
2025-09-05,Stephen Squeri,American Express,15,23,2,40,
2025-09-05,Joe Creed,Caterpillar,11,28,1,40,
2025-09-05,Michel Khalaf,MetLife,11,19,1,31,
2025-09-05,Samuel Hazen,HCA Healthcare,8,7,0,15,
2025-09-05,Tricia Griffith,Progressive Insurance,9,26,5,40,
2025-09-05,Arvind Krishna,IBM,14,21,5,40,
2025-09-05,John May,Deere,9,25,6,40,
2025-09-05,Jensen Huang,Nvidia,7,26,7,40,
2025-09-05,Philip Smith,StoneX,0,10,1,11,
2025-09-05,Robert M Davis,Merck,4,19,0,23,
2025-09-05,Ryan Lance,ConocoPhillips,16,21,3,40,
2025-09-05,Albert Bourla,Pfizer,20,12,8,40,
2025-09-05,Ed Bastian,Delta Air Lines,11,19,10,40,
2025-09-05,Patrick Zammit,TD Synnex,10,14,0,24,
2025-09-05,Kevin Murphy,Publix Super Markets,10,22,1,33,
2025-09-05,Thomas J Wilson,Allstate,1,8,1,10,
2025-09-05,Chuck Robbins,Cisco Systems,13,24,3,40,
2025-09-05,Kirt Walker,Nationwide,13,18,2,33,
2025-09-05,Christopher Winfrey,Charter Communications,5,17,5,27,
2025-09-05,Bob Michael,AbbVie,0,0,0,0,
2025-09-05,Craig DeSanto,New York Life Insurance,3,17,0,20,
2025-09-05,Lip-Bu Tan,Intel,9,18,13,40,
2025-09-05,Ernie Herrman,TJX,16,22,2,40,
2025-09-05,Andrew Sullivan,Prudential Financial,12,21,0,33,
2025-09-05,Enrique Lores,Hewlett Packard,11,17,7,35,
2025-09-05,Scott Kirby,United Airlines,33,4,3,40,
2025-09-05,George Holm,Performance Food,11,23,2,36,
2025-09-05,Donnie King,Tyson Foods,8,26,6,40,
2025-09-05,Robert Isom,American Airlines,7,25,8,40,
2025-09-05,Timothy M Sweeney,Liberty Mutual Insurance,12,0,0,12,
2025-09-05,Elliott Hill,Nike,7,32,1,40,
2025-09-05,Safra Catz,Oracle,11,21,8,40,
2025-09-05,AJ Jim Teague,Enterprise Products Partners,7,13,0,20,
2025-09-05,Richard Fairbank,Capital One,15,22,3,40,
2025-09-05,Wilfred Chiang,Plains GP,0,1,0,1,
2025-09-05,Michael Kasbar,World Kinect,2,12,0,14,
2025-09-05,Peter Zaffino,American International Group,7,29,4,40,
2025-09-05,James Quincey,The Coca-Cola Company,10,28,2,40,
2025-09-05,Thasunda Brown Duckett,TIAA,21,19,0,40,
2025-09-05,Jay Debertin,CHS,6,10,4,20,
2025-09-05,Chris Boerner,Bristol-Myers Squibb,10,23,7,40,
2025-09-05,Corie Barry,Best Buy,38,1,0,39,
2025-09-05,Marc Casper,Thermo Fisher Scientific,12,25,3,40,
2025-09-05,Roger Crandall,Mass Mutual,3,7,0,10,
2025-09-05,Juan Andrade,USAA,5,16,0,21,
2025-09-05,Phebe Novakovic,General Dynamics,27,10,3,40,
2025-09-05,Alan Schnitzer,Travelers Insurance,3,5,1,9,
2025-09-05,David Zaslav,Warner Bros Discovery,5,23,12,40,
2025-09-05,Gunjan Kedia,US Bancorp,14,24,2,40,
2025-09-05,Robert Ford,Abbott Laboratories,11,23,6,40,
2025-09-05,Kathy Warden,Northrop Grumman,14,21,5,40,
2025-09-05,Tim Gerend,Northwestern Mutual,14,25,1,40,
2025-09-05,Todd Vasos,Dollar General,5,24,11,40,
2025-09-05,Matthew Lucey,PBF Energy,7,3,0,10,
2025-09-05,Dara Khosrowshahi,Uber,11,22,7,40,
2025-09-05,Vimal Kapur,Honeywell,12,28,0,40,
2025-09-05,Dirk Van de Put,Mondelez,11,27,2,40,
2025-09-05,Brian Niccol,Starbucks,13,27,0,40,
2025-09-05,Cristiano Amon,Qualcomm,13,26,1,40,
2025-09-05,Hock Tan,Broadcom,15,24,1,40,
2025-09-05,David Flitman,US Foods,2,7,0,9,
2025-09-05,Paul Romanowski,DR Horton,6,15,5,26,
2025-09-05,Jacek Olczak,Philip Morris,14,23,3,40,
2025-09-05,Preston Feight,Paccar,8,28,2,38,
2025-09-05,Marc Benioff,Salesforce,6,23,11,40,
2025-09-05,Leon Topalian,Nucor,15,22,3,40,
2025-09-05,Michael Dastoor,Jabil,1,8,0,9,
2025-09-05,Jonathan Jaffe,Lennar,1,7,2,10,
2025-09-05,David Ricks,Eli Lilly,9,21,10,40,
2025-09-05,Joe Zubretsky,Molina Healthcare,6,5,4,15,
2025-09-05,Jennifer Rumsey,Cummins,7,27,6,40,
2025-09-05,Robin Vince,Bank of New York Mellon,20,19,1,40,
2025-09-05,Ted Sarandos,Netflix,12,26,2,40,
2025-09-05,William H Rogers Jr,Truist Financial,2,6,1,9,
2025-09-05,Sean Kerins,Arrow Electronics,2,12,0,14,
2025-09-05,William M Brown,3M,2,8,0,10,
2025-09-05,Ryan McInerney,Visa,14,22,4,40,
2025-09-05,Marc Rowan,Apollo Global Management,15,20,5,40,
2025-09-05,Tim Go,HF Sinclair,6,3,0,9,
2025-09-05,Robert Sulentic,CBRE Group,1,7,1,9,
2025-09-05,William Demchak,PNC Financial Services,15,20,5,40,
2025-09-05,Bryan DeBoer,Lithia Motors,12,26,1,39,
2025-09-05,William Nash,CarMax,4,4,2,10,
2025-09-05,Brian Robbins,Paramount Global,6,33,1,40,
2025-09-05,Michael Creedon,Dollar Tree,3,34,3,40,
2025-09-05,Sandy Douglas,United Natural Foods,34,5,1,40,
2025-09-05,Alex Chriss,PayPal,14,23,3,40,
2025-09-05,Roger Penske,Penske Automotive,17,22,1,40,
2025-09-05,Antonio Neri,Hewlett Packard Enterprise,12,20,8,40,
2025-09-05,Harry Sideris,Duke Energy,35,5,0,40,
2025-09-05,Vicki Hollub,Occidental Petroleum,20,15,4,39,
2025-09-05,Lawrence Coben,NRG Energy,5,3,0,8,
2025-09-05,Robert Bradway,Amgen,9,29,2,40,
2025-09-05,John Ketchum,NextEra Energy,21,18,1,40,
2025-09-05,Rainer Blair,Danaher,7,15,2,24,
2025-09-05,Daniel O'Day,Gilead Sciences,16,20,4,40,
2025-09-05,Michael Manley,AutoNation,3,5,1,9,
2025-09-05,Carlos Abrams-Rivera,Kraft Heinz,6,30,4,40,
2025-09-05,Philip Gallagher,Avnet,1,5,1,7,
2025-09-05,Gary Dickerson,Applied Materials,7,23,10,40,
2025-09-05,Bob Jordan,Southwest Airlines,9,24,7,40,
2025-09-05,Rick Wurster,Charles Schwab,12,22,5,39,
2025-09-05,Lorenzo Simonelli,Baker Hughes,17,20,3,40,
2025-09-05,Chris Kempczinski,McDonalds,11,22,7,40,
2025-09-05,Christopher Womack,Southern Company,3,7,0,10,
2025-09-05,Michael Miebach,Mastercard,11,26,3,40,
2025-09-05,Joseph Dominguez,Constellation Energy,13,11,1,25,
2025-09-05,Christopher Swift,The Hartford,17,19,4,40,
2025-09-05,Patricia Poppe,PG&E,7,13,2,22,
2025-09-05,Bom Kim,Coupang,12,27,1,40,
2025-09-05,Ezra Yacob,EOG Resources,22,15,3,40,
2025-09-05,Jim Vena,Union Pacific,19,21,0,40,
2025-09-05,Matt Schroeder,Rite Aid,4,33,3,40,
2025-09-05,Tony Spring,Macys,11,25,4,40,
2025-09-05,Anthony Capuano,Marriott International,14,23,3,40,
2025-09-05,Raymond E Scott,Lear Corporation,5,5,0,10,
2025-09-05,William Stengel II,Genuine Parts,0,4,0,4,
2025-09-05,Heidi Petz,Sherwin-Williams,10,28,2,40,
2025-09-05,Jeff Miller,Halliburton,12,21,7,40,
2025-09-05,Kathleen Quirk,Freeport-McMoRan,14,19,2,35,
2025-09-05,Michael Rapino,Live Nation Entertainment,13,24,3,40,
2025-09-05,John Doyle,Marsh & McLennan,10,8,0,18,
2025-09-05,Lisa Su,Advanced Micro Devices,16,18,6,40,
2025-09-05,Frank Holding,First Citizens BancShares,9,14,2,25,
2025-09-05,John Engel,WESCO International,5,12,1,18,
2025-09-05,David Gitlin,Carrier Global,15,23,2,40,
2025-09-05,Lourenco Goncalves,Cleveland-Cliffs,5,20,15,40,
2025-09-05,Calvin G Butler Jr,Exelon,6,4,0,10,
2025-09-05,Joseph Bae,KKR,18,19,3,40,
2025-09-05,Christine Leahy,CDW,0,10,2,12,
2025-09-05,Glenn Fogel,Booking Holdings,10,24,6,40,
2025-09-05,Brian Doubles,Synchrony Financial,5,7,2,14,
2025-09-05,Earl Austin,Quanta Services,2,6,2,10,
2025-09-05,Christian Ulbrich,Jones Lang LaSalle,8,16,0,24,
2025-09-05,Saumya Sutaria,Tenet Healthcare,6,2,1,9,
2025-09-05,William Gifford,Altria,2,5,2,9,
2025-09-05,Kevin Lobo,Stryker,12,25,3,40,
2025-09-05,Michael Hsu,Kimberly-Clark,6,7,1,14,
2025-09-05,Jack Fusco,Cheniere Energy,19,18,3,40,
2025-09-05,James Conroy,Ross Stores,4,11,0,15,
2025-09-05,Anthony Smurfit,Smurfit Westrock,4,6,0,10,
2025-09-05,Jeffrey Harmening,General Mills,3,17,5,25,
2025-09-05,Mark Stewart,Goodyear Tire & Rubber,5,34,1,40,
2025-09-05,Bob Eddy,BJs Wholesale Club,3,22,3,28,
2025-09-05,Peter Arduini,GE HealthCare Technologies,5,11,0,16,
2025-09-05,Noel Wallace,Colgate-Palmolive,10,23,2,35,
2025-09-05,Marc Bitzer,Whirlpool,13,12,15,40,
2025-09-05,Chris Kubasik,L3Harris Technologies,6,13,0,19,
2025-09-05,Shantanu Narayen,Adobe,18,20,1,39,
2025-09-05,Thomas Polen,Becton Dickinson,6,4,0,10,
2025-09-05,Richard P Dealy,Pioneer Natural Resources,6,1,0,7,
2025-09-05,Ravi Kumar S,Cognizant Technology Solutions,13,24,3,40,
2025-09-05,Andrew Clyde,Murphy USA,12,26,2,40,
2025-09-05,Mike Lyons,Fiserv,4,12,1,17,
2025-09-05,Jennifer Parmentier,Parker-Hannifin,2,12,0,14,
2025-09-05,William Fehrman,American Electric Power,3,7,0,10,
2025-09-05,Andrew Silvernail,International Paper,4,23,0,27,
2025-09-05,Jonas Prising,ManpowerGroup,7,22,2,31,
2025-09-05,John Zillmer,Aramark,6,13,2,21,
2025-09-05,Mark Millett,Steel Dynamics,19,2,0,21,
2025-09-05,Dan Amos,Aflac,14,18,8,40,
2025-09-05,Tony Cheng,Reinsurance Group of America,3,10,2,15,
2025-09-05,Karsanbhai,Emerson Electric,7,15,3,25,
2025-09-05,Ronald P O'Hanley,State Street,7,16,0,23,
2025-09-05,Timothy Knavish,PPG Industries,1,2,0,3,
2025-09-05,David Burritt,United States Steel,7,20,13,40,
2025-09-05,Maria Black,Automatic Data Processing,4,5,0,9,
2025-09-05,Daryl Kenningham,Group 1 Automotive,8,30,2,40,
2025-09-05,Robert Blue,Dominion Energy,28,11,1,40,
2025-09-05,Larry Fink,BlackRock,7,24,9,40,
2025-09-05,Pierce Norton II,Oneok,5,3,1,9,
2025-09-05,David Bozeman,CH Robinson Worldwide,2,8,0,10,
2025-09-05,Haviv Ilan,Texas Instruments,11,26,3,40,
2025-09-05,Michael Bender,Kohls,1,25,14,40,
2025-09-05,Philip Daniele III,AutoZone,0,2,0,2,
2025-09-05,Timothy Archer,Lam Research,3,7,0,10,
2025-09-05,Charles Magro,Corteva,5,3,1,9,
2025-09-05,Rick Lanoha,Peter Kiewit Sons',0,2,0,2,
2025-09-05,Peter Jackson,Builders FirstSource,5,12,1,18,
2025-09-05,Martin Schroeter,Kyndryl,11,28,0,39,
2025-09-05,Hamid Akhavan,EchoStar,4,26,10,40,
2025-09-05,Bill Westrate,American Family Insurance,10,17,2,29,
2025-09-05,Avigal Soreq,Delek US,4,9,5,18,
2025-09-05,Beth Ford,Land O'Lakes,18,22,0,40,
2025-09-05,Walker Martin,Sempra,0,2,0,2,
2025-09-05,Eric Slifka,Global Partners,12,20,8,40,
2025-09-05,DG Macpherson,WW Grainger,2,7,1,10,
2025-09-05,Bob Pragada,Jacobs Solutions,6,8,0,14,
2025-09-05,Pedro Pizarro,Edison International,17,7,16,40,
2025-09-05,William Hornbuckle,MGM Resorts International,7,22,1,30,
2025-09-05,Andrew McMahon,Guardian Life insurance,6,12,0,18,
2025-09-05,Christopher O'Herlihy,Illinois Tool Works,2,6,2,10,
2025-09-05,James Cracchiolo,Ameriprise Financial,2,21,2,25,
2025-09-05,Ryan Marshall,PulteGroup,9,14,11,34,
2025-09-05,Matthew Meloy,Targa Resources,5,5,0,10,
2025-09-05,Michael Rhodes,Ally Financial,9,26,5,40,
2025-09-05,Joseph Fadool,BorgWarner,4,10,0,14,
2025-09-05,St√©phane de La Faverie,Est√©e Lauder,11,24,5,40,
2025-09-05,Benjamin Tisch,Loews,3,7,0,10,
2025-09-05,Brad Beckham,O'Reilly Automotive,4,17,1,22,
2025-09-05,Thomas Gayner,Markel Group,1,8,0,9,
2025-09-05,Donald Allan,Stanley Black & Decker,9,30,1,40,
2025-09-05,Sanjay Mehrotra,Micron Technology,16,22,2,40,
2025-09-05,James Breuer,Fluor,0,2,0,2,
2025-09-05,Thomas Bell,Leidos,8,19,2,29,
2025-09-05,Scott Smith,Viatris,6,4,0,10,
2025-09-05,Kimberly Dang,Kinder Morgan,11,1,0,12,
2025-09-05,Christophe Beck,Ecolab,19,21,0,40,
2025-09-05,Brent Shafer,Baxter International,1,9,0,10,
2025-09-05,Clay Gaspar,Devon Energy,22,3,0,25,
2025-09-05,Steven Cahillane,Kellanova,1,8,0,9,
2025-09-05,Raul Nicholas Vargas Ochoa,Farmers Insurance Exchange,0,0,0,0,
2025-09-05,Darren Rebelez,Caseys General Stores,3,6,0,9,
2025-09-05,Ari Bousbib,IQVIA,6,16,2,24,
2025-09-05,Jon Vander Ark,Republic Services,10,19,11,40,
2025-09-05,Timothy Cofer,Keurig Dr Pepper,2,5,1,8,
2025-09-05,Karla Lewis,Reliance Inc,3,6,0,9,
2025-09-05,David Hult,Asbury Automotive Group,9,30,1,40,
2025-09-05,Darryl Button,Pacific Life,1,8,0,9,
2025-09-05,James Burke,Vistra,7,3,0,10,
2025-09-05,John Barrett,Western & Southern Financial,10,28,2,40,
2025-09-05,William Krueger,The Andersons Inc,0,2,0,2,
2025-09-05,Erik Nordstrom,Nordstrom,6,28,5,39,
2025-09-05,John Wren,Omnicom Group,14,20,6,40,
2025-09-05,Stephanie Ferris,Fidelity National Information Services,16,22,2,40,
2025-09-05,Timothy Cawley,Consolidated Edison,5,5,0,10,
2025-09-05,Joseph Hinrichs,CSX,7,11,1,19,
2025-09-05,Troy Rudd,AECOM,7,25,4,36,
2025-09-05,Kathleen Johnson,Lumen Technologies,3,6,1,10,
2025-09-05,Harry Lawton III,Tractor Supply,1,1,0,2,
2025-09-05,Raul Fernandez,DXC Technology,4,30,3,37,
2025-09-05,Eric Hansotia,AGCO,17,22,1,40,
2025-09-05,David Bruton Smith,Sonic Automotive,5,8,9,22,
2025-09-05,Sasan Goodarzi,Intuit,11,25,4,40,
2025-09-05,Matthew Flannery,United Rentals,31,2,0,33,
2025-09-05,Marc Miller,Universal Health Services,4,21,3,28,
2025-09-05,Michael Mahoney,Boston Scientific,12,28,0,40,
2025-09-05,Judith Marks,Otis Worldwide,2,3,0,5,
2025-09-05,Robert Frenzel,Xcel Energy,3,2,2,7,
2025-09-05,Penny Pennington,Edward Jones,9,25,6,40,
2025-09-05,Daniel Fisher,Ball,3,24,6,33,
2025-09-05,Justin Jude,LKQ,4,6,1,11,
2025-09-05,James Blackledge,Mutual of Omaha,2,31,1,34,
2025-09-05,Bruce Bodine,Mosaic,2,9,0,11,
2025-09-05,Scott Donnelly,Textron,8,29,3,40,
2025-09-05,Adam Schechter,Labcorp Holdings,3,6,1,10,
2025-09-05,Deanna Strable-Soethout,Principal Financial,2,6,0,8,
2025-09-05,Leonard Schleifer,Regeneron Pharmaceuticals,7,26,7,40,
2025-09-05,Paul Shoukry,Raymond James Financial,15,24,1,40,
2025-09-05,Lauren Hobart,Dicks Sporting Goods,13,23,4,40,
2025-09-05,Jamie Whisnant,Auto-Owners Insurance,0,2,0,2,
2025-09-05,Ariane Gorin,Expedia,9,30,1,40,
2025-09-05,Shelley Simpson,JB Hunt Transport Services,9,28,3,40,
2025-09-05,Ren√© Jones,M&T Bank,13,23,4,40,
2025-09-05,Gerardo Norcia,DTE Energy,5,4,0,9,
2025-09-05,Andr√©s Gluski,AES,17,21,0,38,
2025-09-05,Timothy Spence,Fifth Third Bancorp,5,4,1,10,
2025-09-05,Eduardo Menezes,Air Products & Chemicals,4,5,1,10,
2025-09-05,Wendell Weeks,Corning,15,23,2,40,
2025-09-05,Anthony Guzzi,EMCOR Group,4,3,1,8,
2025-09-05,Adam Norwitt,Amphenol,3,18,0,21,
2025-09-05,Jean-Marc Gilson,Westlake Corporation,2,3,2,7,
2025-09-05,Lori Koch,DuPont,7,18,0,25,
2025-09-05,Derek Chang,Liberty Media,37,2,1,40,
2025-09-05,Martina Cheung,S&P Global,11,27,0,38,
2025-09-05,Tim Hingtgen,Community Health Systems,11,27,2,40,
2025-09-05,Brian Tierney,FirstEnergy,5,22,3,30,
2025-09-05,Rick McKenney,Unum Group,5,4,0,9,
2025-09-05,Stanley Bergman,Henry Schein,11,28,1,40,
2025-09-05,Tiang Yew Tan,Western Digital,0,3,0,3,
2025-09-05,Vincent Roche,Analog Devices,13,23,3,39,
2025-09-05,Sean Connolly,Conagra Brands,7,31,2,40,
2025-09-05,Bruce Van Saun,Citizens Financial Group,15,25,0,40,
2025-09-05,Mark George,Norfolk Southern,19,18,3,40,
2025-09-05,Andrew Marsh,Entergy,4,4,0,8,
2025-09-05,Robert Berkley,WR Berkley,9,28,3,40,
2025-09-05,Javier Rodriguez,DaVita,14,14,1,29,
2025-09-05,Michael O'Grady,Northern Trust,24,6,1,31,
2025-09-05,James Snee,Hormel Foods,2,26,1,29,
2025-09-05,Timothy J Donahue,Crown Holdings,2,10,0,12,
2025-09-05,Joseph Ferraro,Avis Budget,3,5,1,9,
2025-09-05,Niraj Shah,Wayfair,8,24,8,40,
2025-09-05,Jos√© Mas,MasTec,6,14,1,21,
2025-09-05,Joseph Nolan,Eversource Energy,5,3,1,9,
2025-09-05,Thomas Palmer,Newmont,5,5,0,10,
2025-09-05,Robert Sanchez,Ryder System,9,7,1,17,
2025-09-05,Michael Nolan,Fidelity National Financial,4,0,0,4,
2025-09-05,Gavin Hattersley,Molson Coors Beverage,6,29,5,40,
2025-09-05,Thomas Reeg,Caesars Entertainment,0,0,0,0,
2025-09-05,Ellen Cooper,Lincoln National,3,7,0,10,
2025-09-05,Bracken Darrell,VF Corporation,9,28,3,40,
2025-09-05,Erik Fyrwald,International Flavors & Fragrances,7,8,2,17,
2025-09-05,Christopher Kastner,Huntington Ingalls Industries,3,5,0,8,
2025-09-05,Shane O'Kelly,Advance Auto Parts,14,22,4,40,
2025-09-05,Ralph LaRossa,Public Service Enterprise Group,10,19,0,29,
2025-09-05,Kecia Steelman,Ulta Beauty,34,5,1,40,
2025-09-05,Michele Buck,Hershey,7,31,2,40,
2025-09-05,Sumit Singh,Chewy,12,25,3,40,
2025-09-05,Steven Vondran,American Tower,4,6,0,10,
2025-09-05,Jeffrey Lorberbaum,Mohawk Industries,11,6,1,18,
2025-09-05,Keith Demmings,Assurant,2,8,0,10,
2025-09-05,Robert Martin,Thor Industries,3,6,1,10,
2025-09-05,Kathleen Mazzarella,Graybar Electric,1,7,1,9,
2025-09-05,Joey Wat,Yum China,12,26,2,40,
2025-09-05,Scott Richardson,Celanese,9,25,4,38,
2025-09-05,David Rawlinson II,QVC,7,15,2,24,
2025-09-05,Alan Armstrong,Williams,26,11,3,40,
2025-09-05,Philippe Krakowsky,Interpublic Group,13,24,3,40,
2025-09-05,Brendan McCracken,Ovintiv,7,5,0,12,
2025-09-05,Andrew Teno,Icahn Enterprises,5,5,0,10,
2025-09-05,Stephen Steinour,Huntington Bancshares,2,8,0,10,
2025-09-05,Timothy NeCastro,Erie Insurance,3,6,1,10,
2025-09-05,Ernest Garcia III,Carvana,24,12,4,40,
2025-09-05,R Bruce McDonald,Dana Incorporated,3,7,1,11,
2025-09-05,William Oplinger,Alcoa Corporation,2,7,1,10,
2025-09-05,Mark Pearson,Equitable,7,8,0,15,
2025-09-05,Richard Wallace,KLA,5,5,0,10,
2025-09-05,Ricardo Cardenas,Darden Restaurants,4,3,1,8,
2025-09-05,Mikael Bratt,Autoliv,6,7,2,15,
2025-09-05,Benito Minicucci,Alaska Air,3,3,1,7,
2025-09-05,Christopher Gorman,KeyCorp,5,5,0,10,
2025-09-05,Robert Goldstein,Las Vegas Sands,4,31,5,40,
2025-09-05,Edward Pesicka,Owens & Minor,3,33,2,38,
2025-09-05,Christopher Nassetta,Hilton Worldwide,7,17,2,26,
2025-09-05,Jamie Iannone,Ebay,15,21,4,40,
2025-09-05,Patrick Gallagher,Arthur J Gallagher,9,29,2,40,
2025-09-05,Rich Steinmeier,LPL Financial,24,14,2,40,
2025-09-05,Stephen Spray,Cincinnati Financial,1,6,3,10,
2025-09-05,Douglas Yearley,Toll Brothers,10,24,6,40,
2025-09-05,Gregory Brown,Motorola Solutions,2,8,0,10,
2025-09-05,Brian Chesky,Airbnb,3,30,7,40,
2025-09-05,Jeffrey Sprecher,Intercontinental Exchange,15,23,2,40,
2025-09-05,Robert Thomson,News Corp,5,31,4,40,
2025-09-05,Scott Boatwright,Chipotle Mexican Grill,8,27,5,40,
2025-09-05,Reshma Kewalramani,Vertex Pharmaceuticals,21,14,5,40,
2025-09-05,Christopher Viehbacher,Biogen,0,26,2,28,
2025-09-05,Malcolm Wilson,GXO Logistics,6,22,0,28,
2025-09-05,Tony Sarsam,SpartanNash,17,21,2,40,
2025-09-05,Michael O‚ÄôSullivan,Burlington Stores,9,27,4,40,
2025-09-05,Teresa Rasmussen,Thrivent Financial for Lutherans,4,1,0,5,
2025-09-05,Eugene Bredow,NVR,0,4,1,5,
2025-09-05,Brian Chambers,Owens Corning,3,11,0,14,
2025-09-05,Rafael Santana,Westinghouse Air Brake Technologies,2,7,1,10,
2025-09-05,John Pfeifer,Oshkosh,4,25,4,33,
2025-09-05,Cameron Bready,Global Payments,8,30,2,40,
2025-09-05,Calvin McDonald,Lululemon athletica,9,30,1,40,
2025-09-05,J Kent Masters,Albemarle Corporation,3,6,0,9,
2025-09-05,Joanna Geraghty,JetBlue Airways,13,20,7,40,
2025-09-05,Robert Steer,Seaboard,1,4,0,5,
2025-09-05,William Newlands,Constellation Brands,0,2,2,4,
2025-09-05,Michael Doss,Graphic Packaging,4,9,1,14,
2025-09-05,Gil West,Hertz,7,21,8,36,
2025-09-05,Malcolm C Roberts,FM Global,2,9,2,13,
2025-09-05,Mick Beekhuizen,Campbell Soup,9,23,0,32,
2025-09-05,Daniel Wall,Expeditors International of Washington,3,4,0,7,
2025-09-05,Gregory Roberts,A-Mark Precious Metals,1,4,1,6,
2025-09-05,Horacio Rozanski,Booz Allen Hamilton,17,18,5,40,
2025-09-05,James Davis,Quest Diagnostics,5,5,0,10,
2025-09-05,Dennis Mathew,Altice,5,28,7,40,
2025-09-05,Stefan Larsson,PVH,10,25,5,40,
2025-09-05,Mark Costa,Eastman Chemical,5,16,4,25,
2025-09-05,Joyce Mullen,Insight Enterprises,6,11,0,17,
2025-09-05,John Turner,Regions Financial,19,19,2,40,
2025-09-05,Julian G Francis,Beacon Roofing Supply,0,1,0,1,
2025-09-05,Blake Moret,Rockwell Automation,11,27,2,40,
2025-09-05,Mike Speetzen,Polaris Inc,2,17,2,21,
2025-09-05,William McDermott,ServiceNow,4,5,0,9,
2025-09-05,Jure Sola,Sanmina,2,11,0,13,
2025-09-05,Bob Flexon,UGI Utilities Inc,0,1,0,1,
2025-09-05,Scott Lauber,WEC Energy,13,6,0,19,
2025-09-05,Jon Rousseau,BrightSpring Health Services,20,19,1,40,
2025-09-05,Todd Schneider,Cintas,14,18,1,33,
2025-09-05,Peter Matt,Commercial Metals,5,3,0,8,
2025-09-05,Robert D Lawler,Continental Resources,1,0,0,1,
2025-09-05,Domenic Dell‚ÄôOsso Jr,Expand Energy,4,0,0,4,
2025-09-05,Jason P Wells,CenterPoint Energy,9,4,1,14,
2025-09-05,H Michael Krimbill,NGL Energy Partners,6,3,0,9,
2025-09-05,Tony Xu,DoorDash,12,22,6,40,
2025-09-05,Clay Williams,NOV,8,19,5,32,
2025-09-05,Kristin Peck,Zoetis,12,20,1,33,
2025-09-05,Mark Smucker,JM Smucker,13,21,6,40,
2025-09-05,Steve Sanghi,Microchip Technology,8,28,4,40,
2025-09-05,Richard Tobin,Dover Corporation,5,3,0,8,
2025-09-05,Kaes Van‚Äôt Hof,Diamondback Energy,20,16,3,39,
2025-09-05,Deon Stander,Avery Dennison,0,13,0,13,
2025-09-05,Vincent Sorgi,PPL,8,10,1,19,
2025-09-05,Hassane El-Khoury,ON Semiconductor,2,17,5,24,
2025-09-05,Arie Kotler,ARKO,5,22,1,28,
2025-09-05,William Monteleone,Par Pacific,1,6,2,9,
2025-09-05,John Christmann IV,APA,5,4,1,10,
2025-09-05,Adaire Fox-Martin,Equinix,14,22,4,40,
2025-09-05,Joseph M Otting,Flagstar Financial,2,6,2,10,
2025-09-05,Mary Dillon,Foot Locker,11,25,4,40,
2025-09-05,James Zallie,Ingredion,4,5,1,10,
2025-09-05,Christopher Peterson,Newell Brands,0,9,1,10,
2025-09-05,Scott Salmirs,ABM Industries,7,8,1,16,
2025-09-05,Christopher Hilger,Securian Financial,0,6,0,6,
2025-09-05,Hamid Moghadam,Prologis,6,29,5,40,
2025-09-05,Stephen Schwarzman,Blackstone,14,20,6,40,
2025-09-05,Robert Greenberg,Skechers USA,5,23,3,31,
2025-09-05,Keith Allman,Masco,4,9,1,14,
2025-09-05,Rusty Rush,Rush Enterprises,16,21,3,40,
2025-09-05,Jennifer Johnson,Franklin Resources,1,7,2,10,
2025-09-05,Gerry P Smith,ODP Business Solutions,0,1,0,1,
2025-09-05,Carl Lindner lll,American Financial,0,0,0,0,
2025-09-05,Mark Kowlzan,Packaging Corp of America,0,9,1,10,
2025-09-05,Thomas Hill,Vulcan Materials,4,6,2,12,
2025-09-05,Milan Galik,Interactive Brokers,7,18,1,26,
2025-09-05,Laura Alber,Williams-Sonoma,12,24,4,40,
2025-09-05,Mario Harik,XPO,8,31,1,40,
2025-09-05,Devin Stockfish,Weyerhaeuser,5,5,0,10,
2025-09-05,Thomas J McInerney,Genworth Financial,1,6,0,7,
2025-09-05,Garrick Rochow,CMS Energy,11,3,1,15,
2025-09-05,Toni Townes-Whitley,Science Applications International,12,22,1,35,
2025-09-05,Rich Handler,Jefferies Financial,12,11,2,25,
2025-09-05,Daniel Heaf,Bath & Body Works,11,27,2,40,
2025-09-05,Andrew Wilson,Electronic Arts,13,19,8,40,
2025-09-05,Sheryl Palmer,Taylor Morrison Home,8,12,1,21,
2025-09-05,Ivan Tornos,Zimmer Biomet,8,29,3,40,
2025-09-05,Linda Rendle,Clorox,2,34,2,38,
2025-09-05,Matthew Pine,Xylem Inc,1,8,1,10,
2025-09-05,Heather Lavallee,Voya Financial,6,11,2,19,
2025-09-05,Daniel Florness,Fastenal,3,4,1,8,
2025-09-05,Albert Nahmad,Watsco,2,7,0,9,
2025-09-05,Carl Eschenbach,Workday,12,19,9,40,
2025-09-05,Craig Smiddy,Old Republic International,1,6,1,8,
2025-09-05,Frank C Sullivan,RPM International,4,8,0,12,
2025-09-05,Matthew Missad,UFP Industries,7,3,0,10,
2025-09-05,Martin J Lyons,Ameren,2,3,1,6,
2025-09-05,Adam W Miller,Knight Swift Transportation,0,2,1,3,
2025-09-05,Rodney Sacks,Monster Beverage,12,26,1,39,
2025-09-05,Gary Guthart,Intuitive Surgical,14,23,3,40,
2025-09-05,Charles Liang,Super Micro Computer,33,6,1,40,
2025-09-05,Christopher Caldwell,Concentrix,3,5,0,8,
2025-09-05,Gordon J Hardie,O-I Glass,0,4,0,4,
2025-09-05,David Gibbs,Yum Brands,3,37,0,40,
2025-09-05,Steve Henry,Domtar,5,5,0,10,
2025-09-05,Chuck Treadway,CommScope,8,20,3,31,
2025-09-05,Rob Vitale,Post Holdings,1,11,5,17,
2025-09-05,Steven J Moskowitz,Crown Castle,2,5,3,10,
2025-09-05,Emmanuel Ligner,Avantor,3,11,1,15,
2025-09-05,Stuart Bradie,KBR,14,16,4,34,
2025-09-05,Carrie Wheeler,Opendoor Technologies,10,28,2,40,
2025-09-05,Russell Becker,APi Group,4,5,1,10,
2025-09-05,Toby Rice,EQT,24,14,2,40,
2025-09-05,Jesse Arenivas,EnLink Midstream,7,10,0,17,
2025-09-05,Nikesh Arora,Palo Alto Networks,6,25,9,40,
2025-09-05,Steven Bandrowczak,Xerox,1,8,1,10,
2025-09-05,Vicente Reynal,Ingersoll Rand,7,26,0,33,
2025-09-05,William T Dillard II,Dillards,3,5,2,10,
2025-09-05,C Howard Nye,Martin Marietta Materials,2,5,3,10,
2025-09-05,Giordano Albertazzi,Vertiv,17,19,4,40,
2025-09-05,Stephane Bancel,Moderna,10,20,10,40,
2025-09-05,Nate R Jorgensen,Boise Cascade,0,0,0,0,
2025-09-05,Jack Sinclair,Sprouts Farmers Market,15,24,1,40,
2025-09-05,Padraig McDonnell,Agilent Technologies,12,14,0,26,
2025-09-05,Kenneth T Lane,Olin,0,0,0,0,
2025-09-05,Randall C Stuewe,Darling Ingredients,27,1,0,28,
2025-09-05,R Howard Coker,Sonoco Products,4,5,1,10,
2025-09-05,John Mengucci,CACI International,19,19,2,40,
2025-09-05,Mark Witkowski,Core & Main,0,8,1,9,
2025-09-05,Lee M Tillman,Marathon Oil,4,4,0,8,
2025-09-05,Mark Hoplamazian,Hyatt Hotels,15,21,4,40,
2025-09-05,David S Chernow,Select Medical,0,8,1,9,
2025-09-05,Brendan M Foley,McCormick & Company,0,8,0,8,
2025-09-05,Joanne Crevoiserat,Tapestry,14,21,5,40,
2025-09-05,John Plant,Howmet Aerospace,6,13,3,22,
2025-09-05,Shankh Mitra,Welltower,18,20,2,40,
2025-09-05,W Anthony Will,CF Industries,4,4,0,8,
2025-09-05,David A Zapico,Ametek,3,16,0,19,
2025-09-05,Kevin Stein,TransDigm,9,8,3,20,
2025-09-05,Craig Billings,Wynn Resorts,13,24,3,40,
2025-09-05,William J Way,Southwestern Energy,1,0,0,1,
2025-09-05,Giel Rutten,Amkor Technology,2,9,1,12,
2025-09-05,Paul Sarvadi,Insperity,4,4,1,9,
2025-09-05,Donald Zurbay,Patterson Companies Inc,1,4,0,5,
2025-09-05,Rob Sharps,T Rowe Price,13,22,5,40,
2025-09-05,Patrice Louvet,Ralph Lauren,14,16,10,40,
2025-09-05,Jeffrey Mezger,KB Home,1,29,10,40,
2025-09-05,David M Foulkes,Brunswick,1,7,0,8,
2025-09-05,M Keith Waddell,Robert Half,2,8,1,11,
2025-09-05,Jay Snowden,PENN Entertainment,18,19,3,40,
2025-09-05,George Kurian,NetApp,15,22,3,40,
2025-09-05,Kevin Ali,Organon,9,20,1,30,
2025-09-05,Joel D Anderson,Petco Health and Wellness,3,9,0,12,
2025-09-05,Louis V Pinkham,Regal Rexnord,0,0,0,0,
2025-09-05,Jay Geldmacher,Resideo Technologies,9,6,1,16,
2025-09-05,Marcus Lemonis,Camping World,6,24,10,40,
2025-09-05,Peter R Huntsman,Huntsman,7,11,4,22,
2025-09-05,Hillary Super,Victorias Secret,11,4,8,23,
2025-09-05,Michelle Gass,Levi Strauss,11,25,3,39,
2025-09-05,Neil Hunn,Roper Technologies,2,20,0,22,
2025-09-05,Steven P Lawrence,Academy Sports and Outdoors,1,1,0,2,
2025-09-05,Phillippe Lord,Meritage Homes,8,16,0,24,
2025-09-05,David C Dauch,American Axle & Manufacturing,5,6,2,13,
2025-09-05,Olumide Soroye,Fortive,1,8,0,9,
2025-09-05,Adena Friedman,Nasdaq,13,23,4,40,
2025-09-05,Tim Gokey,Broadridge Financial Solutions,3,12,1,16,
2025-09-05,Patrick M Shanahan,Spirit AeroSystems,0,9,0,9,
2025-09-05,Robert Kyncl,Warner Music Group,9,30,1,40,
2025-09-05,Denise Dignam,Chemours,2,19,4,25,
2025-09-05,Jim DeVries,ADT,9,7,1,17,
2025-09-05,Bernard Zovighian,Edwards Lifesciences,7,6,2,15,
2025-09-05,Mark E Seaton,First American Financial,1,9,0,10,
2025-09-05,John C Roche,Hanover Insurance Group,7,20,1,28,
2025-09-05,Adam J Greenlee,Silgan,0,4,0,4,
2025-09-05,Jayne Hrdlicka,Endeavor Group,0,1,0,1,
2025-09-05,Robert Fauber,Moodys Corporation,0,5,0,5,
2025-09-05,Thomas E Jorden,Coterra Energy,8,0,0,8,
2025-09-05,Eugene A Hall,Gartner,1,9,0,10,
2025-09-05,Kevin Plank,Under Armour,8,29,3,40,
2025-09-05,James W Lanning,Ingles Markets,3,4,0,7,
2025-09-05,Matthew T Farrell,Church & Dwight,6,7,0,13,
2025-09-05,Kevin M Freeman,Old Dominion Freight Line,0,0,0,0,
2025-09-05,Joe Shoen,U-Haul,14,21,4,39,
2025-09-05,Mark Bertolini,Oscar Health,12,19,9,40,
2025-09-05,Jayshree Ullal,Arista Networks,23,16,1,40,
2025-09-05,Sassine Ghazi,Synopsys,12,25,3,40,
2025-09-05,Jochen Zeitz,Harley-Davidson,6,24,10,40,
2025-09-05,Nick Jeffery,Frontier Communications,10,25,2,37,
2025-09-05,Thomas Edward McCormick,Primoris Services,0,4,0,4,
2025-09-05,D Christian Koch,Carlisle Companies,1,4,1,6,
2025-09-05,David E Simon,Simon Property Group,2,5,3,10,
2025-09-05,Stephen Bratspies,Hanesbrands,3,10,1,14,
2025-09-05,Ryan M. Schneider,Anywhere Real Estate Inc,0,1,0,1,
2025-09-05,George Bobb III,Teledyne Technologies,1,4,1,6,
2025-09-05,Terrence A Duffy,CME Group,6,9,1,16,
2025-09-05,Rami Rahim,Juniper Networks,10,28,2,40,
2025-09-05,Sue Nabi,Coty,17,17,6,40,
2025-09-05,Peter D Arvan,Pool Corporation,2,7,0,9,
2025-09-05,David Campbell,Evergy,12,8,0,20,
2025-09-05,Matthew J Murphy,Marvell Technology,5,4,1,10,
2025-09-05,Lloyd Yates,NiSource,5,4,0,9,
2025-09-05,William C Stone,SS&C Technologies,2,6,0,8,
2025-09-05,Mark Rourke,Schneider National,10,19,1,30,
2025-09-05,Andrew Anagnost,Autodesk,8,24,8,40,
2025-09-05,Dustin Semach,Sealed Air Corporation,0,10,0,10,
2025-09-05,William L Meaney,Iron Mountain,2,18,0,20,
2025-09-05,Andy P Power,Digital Realty Trust,0,0,0,0,
2025-09-05,Satish Dhanasekaran,Keysight Technologies,2,11,0,13,
2025-09-05,Frank M Svoboda,Globe Life,3,4,3,10,
2025-09-05,Carey A Smith,Parsons Corporation,1,3,0,4,
2025-09-05,Ynon Kreiz,Mattel,8,24,8,40,
2025-09-05,Karen S Haller,Southwest Gas,3,6,0,9,
2025-09-05,Terrance Williams,TruStage,5,6,1,12,
2025-09-05,Eric W Gerstenberg,Clean Harbors,4,2,1,7,
2025-09-05,Gunner Smith,Cornerstone Building Brands,1,8,0,9,
2025-09-05,Gerben W Bakker,Hubbell,1,4,0,5,
2025-09-05,Dave Davis,Spirit Airlines,5,21,3,29,
2025-09-05,Michael J Smith,Lamb Weston,0,7,3,10,
2025-09-05,Strauss Zelnick,Take-Two Interactive Software,12,19,9,40,
2025-09-05,John C Turner Jr,GMS,2,7,0,9,
2025-09-05,David M O'Malley,Penn Mutual Life Insurance,1,3,0,4,
2025-09-05,Frank A Lonegro,Landstar System,3,3,0,6,
2025-09-05,James F Risoleo,Host Hotels & Resorts,6,17,0,23,
2025-09-05,Ken Xie,Fortinet,13,20,7,40,
2025-09-05,Doug Shulman,OneMain,3,7,0,10,
2025-09-05,Ryan Cohen,GameStop,11,21,8,40,
2025-09-05,Mark W Begor,Equifax,3,12,0,15,
2025-09-05,Jay L Schottenstein,American Eagle Outfitters,12,17,1,30,
2025-09-05,Curtis C Farmer,Comerica,3,9,0,12,
2025-09-05,Ole Rosgaard,Greif,3,18,1,22,
2025-09-05,Brian E Lane,Comfort Systems USA,9,0,0,9,
2025-09-05,Robert M Buck,TopBuild,0,5,1,6,
2025-09-05,Ralph Andretta,Bread Financial,3,9,0,12,
2025-09-05,Jim Anderson,Coherent,6,34,0,40,
2025-09-05,Walter C. D. Carlson,Telephone & Data Systems,0,2,0,2,
2025-09-05,Ronald Kruszewski,Stifel Financial,7,5,0,12,
2025-09-05,Richard Hayne,Urban Outfitters,10,22,8,40,
2025-09-05,Simon Meester,Terex,3,7,0,10,
2025-09-05,Edward J Lehner,Ryerson Holding,0,2,1,3,
2025-09-05,Nicholas T Pinchuk,Snap-on,3,6,0,9,
2025-09-05,Ryals McMullian,Flowers Foods,5,28,3,36,
2025-09-05,D Bryan Jordan,First Horizon,4,8,1,13,
2025-09-05,John B Gibson,Paychex,3,6,0,9,
2025-09-05,Chris Cocks,Hasbro,12,18,10,40,
2025-09-05,Pete McPartland,Sentry Insurance Group,0,2,0,2,
2025-09-05,Michael Arougheti,Ares Management,17,22,1,40,
2025-09-05,Alok Maskara,Lennox International,6,3,1,10,
2025-09-05,James C Grech,Peabody Energy,3,0,0,3,
2025-09-05,Joseph P Lacher Jr,Kemper,4,18,4,26,
2025-09-05,Perry A Sook,Nexstar Media Group,7,30,1,38,
2025-09-05,Wade Davis,TelevisaUnivision,14,25,1,40,
2025-09-05,Scott L Thompson,Tempur Sealy International,0,7,0,7,
2025-09-05,Mike Simonds,TriNet Group,0,9,0,9,
2025-09-05,B Andrew Rose,Worthington Enterprises,1,2,0,3,
2025-09-05,Bruce L Caswell,Maximus,5,5,0,10,
2025-09-05,Robert L Reffkin,Compass,1,6,0,7,
2025-09-05,Mark Eubanks,Brinks Company,1,2,1,4,
2025-09-05,Peter Quigley,Kelly Services inc,2,8,0,10,
2025-09-05,David L Yowan,Navient,2,3,0,5,
2025-09-05,Mary E Kipp,Puget Sound Energy,4,0,2,6,
2025-09-05,Adam Aron,AMC Entertainment,18,14,8,40,
2025-09-05,Mark J Tarr,Encompass Health,2,6,1,9,
2025-09-05,Liam K Griffin,Skyworks Solutions,1,6,1,8,
2025-09-05,Richard G Kyle,Timken,6,20,1,27,
2025-09-05,Ron Gusek,Liberty Energy,23,1,0,24,
2025-09-05,John E Geller Jr,Marriott Vacations Worldwide,6,5,0,11,
2025-09-05,Karl G. Glassman,Leggett & Platt,0,4,0,4,
2025-09-05,Bruce K Thorn,Big Lots,3,5,2,10,
2025-09-05,Jonathan H Weis,Weis Markets,11,28,0,39,
2025-09-05,Jeffrey B Guldner,Pinnacle West Capital,1,4,0,5,
2025-09-05,Arkadiy Dobkin,EPAM Systems,11,17,1,29,
2025-09-05,Paul M Rady,Antero Resources,4,8,0,12,
2025-09-05,Michael Spanos,Bloomin Brands,1,8,1,10,
2025-09-05,Nicole A Kivisto,MDU Resources Group,1,5,0,6,
2025-09-05,Gerald L Morgan,Texas Roadhouse,3,3,4,10,
2025-09-05,Gabriel Tirador,Mercury General,4,4,2,10,
2025-09-05,Nicholas I Fink,Fortune Brands Innovations,4,4,0,8,
2025-09-05,Paul E Burdiss,Zions Bancorp,1,1,0,2,
2025-09-05,William J Christensen,JELD-WEN Holding,4,5,0,9,
2025-09-05,Evan Spiegel,Snap Inc,20,17,3,40,
2025-09-05,Bill Burns,Zebra Technologies,7,24,1,32,
2025-09-05,Steven Sell,Agilon Health,1,8,1,10,
2025-09-05,Richard M Olson,Toro Company,1,15,0,16,
2025-09-05,Eric S Yuan,Zoom Video Communications,6,7,0,13,
2025-09-05,Dan L Batrack,Tetra Tech,2,3,1,6,
2025-09-05,Joseph D Russell Jr,Public Storage,0,8,0,8,
2025-09-05,Jacob Thaysen,Illumina inc,5,7,0,12,
2025-09-05,Debra A Cafaro,Ventas inc,7,5,0,12,
2025-09-05,Pierre R Brondeau,FMC Corporation,1,4,1,6,
2025-09-05,Judy R McReynolds,ArcBest,6,15,1,22,
2025-09-05,Russell J Weiner,Dominos Pizza inc,0,0,0,0,
2025-09-05,Theodore S Hanson,ASGN,0,3,0,3,
2025-09-05,RJ Scaringe,Rivian Automotive,10,28,2,40,
2025-09-05,Jeffrey N Simmons,Elanco Animal Health,2,5,1,8,
2025-09-05,Tim O Shaughnessy,Graham Holdings Company,3,6,0,9,
2025-09-05,Thomas V Taylor,Floor & Decor,1,1,2,4,
2025-09-05,Neil A Schrimsher,Applied Industrial Technologies,5,25,1,31,
2025-09-05,Robert E Price,PriceSmart,4,6,0,10,
2025-09-05,John David Risher,Lyft,1,4,2,7,
2025-09-05,Gary B Smith,Ciena,4,8,0,12,
2025-09-05,Joey Levin,IAC,7,32,1,40,
2025-09-05,Jim Jacobs,Country Financial,7,3,2,12,
2025-09-05,Devin B McGranahan,Western Union,1,6,0,7,
2025-09-05,R Scott Rowe,Flowserve,5,4,1,10,
2025-09-05,Kenneth A Vecchione,Western Alliance Bancorp,0,0,1,1,
2025-09-05,John C Rademacher,Option Care Health,10,1,0,11,
2025-09-05,Doug Black,SiteOne Landscape Supply,2,22,2,26,
2025-09-05,Oliver G Brewer III,Topgolf Callaway Brands,1,0,0,1,
2025-09-05,Glenn Sanford,eXp World,15,22,3,40,
2025-09-05,Fran Horowitz,Abercrombie & Fitch,13,21,6,40,
2025-09-05,Kevin Akers,Atmos Energy,7,2,1,10,
2025-09-05,Alessandro Maselli,Catalent,4,11,2,17,
2025-09-05,J Powell Brown,Brown & Brown,11,22,7,40,
2025-09-05,Aman Bhutani,GoDaddy,17,21,2,40,
2025-09-05,John C. Griffith,American Water Works,1,3,0,4,
2025-09-05,John J Marchioni,Selective Insurance Group,4,12,4,20,
2025-09-05,Lawson E Whiting,Brown-Forman,1,7,2,10,
2025-09-05,Dave Peacock,Advantage Solutions,20,8,0,28,
2025-09-05,Mick Farrell,ResMed,15,23,1,39,
2025-09-05,Kamal Hathi,Splunk,2,4,0,6,
2025-09-05,Todd Kelsey,Plexus,2,6,0,8,
2025-09-05,Phillip D Yeager,Hub Group,3,6,0,9,
2025-09-05,Steven B Hedlund,Lincoln Electric,5,10,0,15,
2025-09-05,Timothy C Oliver,NCR Atleos,0,1,0,1,
2025-09-05,Bruce Fleming,Calumet,1,8,0,9,
2025-09-05,Daniel S. Peyovich,Dycom Industries,1,5,0,6,
2025-09-05,Avner M Applbaum,Valmont Industries,0,8,1,9,
2025-09-05,Kimberly A Fields,ATI inc,5,9,0,14,
2025-09-05,Khozema Z Shipchandler,Twilio,0,2,0,2,
2025-09-05,Gary C Bhojwani,CNO Financial Group,1,7,1,9,
2025-09-05,William Andrew Hendricks Jr,Patterson-UTI Energy,0,0,0,0,
2025-09-05,Kevin D Hochman,Brinker International,1,4,1,6,
2025-09-05,James C Foster,Charles River Laboratories International,2,8,1,11,
2025-09-05,Rajiv K Prasad,Hyster-Yale,2,5,0,7,
2025-09-05,Eric T Steigerwalt,Brighthouse Financial,2,2,0,4,
2025-09-05,Thomas L Ryan,Service Corp International,5,5,0,10,
2025-09-05,Charles M Nifong Jr,CrossAmerica Partners,0,0,0,0,
2025-09-05,Anirudh Devgan,Cadence,10,25,3,38,
2025-09-05,Andi Owen,MillerKnoll,16,15,9,40,
2025-09-05,Sumit Roy,Realty Income,13,17,2,32,
2025-09-05,Timothy John Fitzgerald,Middleby,0,0,0,0,
2025-09-05,Robert H Schottenstein,M/I Homes,2,10,0,12,
2025-09-05,Stephen P MacMillan,Hologic,1,7,0,8,
2025-09-05,Lisa M Barton,Alliant Energy,5,0,0,5,
2025-09-05,Aaron P Jagdfeld,Generac,1,5,0,6,
2025-09-05,Erik Gershwind,MSC Industrial Direct,4,4,2,10,
2025-09-05,Varun Krishna,Rocket Companies,8,31,1,40,
2025-09-05,Fahmi Karam,Upbound Group,5,4,0,9,
2025-09-05,NADominic Ng,East West Bancorp,0,0,0,0,
2025-09-05,Mark Wang,Hilton Grand Vacations,38,2,0,40,
2025-09-05,Robert J Sheedy Jr,Grocery Outlet Holding,0,0,0,0,
2025-09-05,Simon D Campion,Dentsply Sirona,0,4,0,4,
2025-09-05,Jeremy Wensinger,V2X,6,9,0,15,
2025-09-05,Andrew Rees,Crocs,16,13,11,40,
2025-09-05,David M Maura,Spectrum Brands,6,1,0,7,
2025-09-05,Sachin S Lawande,Visteon,0,0,0,0,
2025-09-05,Neil M Ashe,Acuity Inc,0,1,0,1,
2025-09-05,Lorie L Tekorius,Greenbrier,2,8,0,10,
2025-09-05,John R Ciulla,Webster Financial,5,5,0,10,
2025-09-05,Sean D Keohane,Cabot Corporation,5,2,0,7,
2025-09-05,Drew M Wilkerson,RXO inc,0,0,0,0,
2025-09-05,Daniel E Brown,Chord Energy,1,1,0,2,
2025-09-05,Javier D Ferrer Fernandez,Popular inc,0,0,0,0,
2025-09-05,Olivier Rabiller,Garrett Motion inc,4,9,0,13,
2025-09-05,Ronald N Tutor,Tutor Perini Corporation,2,6,1,9,
2025-09-05,Jeff Liaw,Copart,4,4,2,10,
2025-09-05,Aman Narang,Toast inc,4,6,1,11,
2025-09-05,Joseph M Hogan,Align Technology,2,5,0,7,
2025-09-05,Kevin J Wheeler,A O Smith,0,17,1,18,
2025-09-05,Christopher A Cartwright,TransUnion,2,0,2,4,
2025-09-05,James Kelly,NCR Voyix,2,12,1,15,
2025-09-05,Tom Leighton,Akamai Technologies,14,15,6,35,
2025-09-05,Robert G Painter,Trimble,7,2,0,9,
2025-09-05,Tony Helton,Medical Mutual of Ohio,2,4,1,7,
2025-09-05,Caroline S Grace,AMN Healthcare Services,0,0,0,0,
2025-09-05,Patrick Kaltenbach,Mettler-Toledo International,2,6,0,8,
2025-09-05,Michael L Baur,ScanSource,0,3,0,3,
2025-09-05,Jason Lippert,LCI Industries,1,10,0,11,
2025-09-05,Fredric J Tomczyk,Cboe Global Markets,1,6,0,7,
2025-09-05,Octavio Marquez,Diebold Nixdorf,5,10,1,16,
2025-09-05,Sivasankaran Somasundaram,ChampionX,8,2,0,10,
2025-09-05,Ronald F Clarke,Corpay,0,1,0,1,
2025-09-05,Robert W Pittman,iHeartMedia,6,3,0,9,
2025-09-05,Patrick Zalupski,Dream Finders Homes,22,16,2,40,
2025-09-05,Keith E Smith,Boyd Gaming,1,6,1,8,
2025-09-05,Mehran Assadi,NLV Financial,1,1,0,2,
2025-09-05,Barry R Port,Ensign Group,3,4,2,9,
2025-09-05,Denise A Paulonis,Sally Beauty,1,2,0,3,
2025-09-05,Clifford A Skelton,Conduent,0,1,0,1,
2025-09-05,Jean-Michel Ribieras,Sylvamo,2,7,0,9,
2025-09-05,Douglas F Bauer,Tri Pointe Homes,0,5,0,5,
2025-09-05,Shawn O'Connell,EnerSys,2,5,0,7,
2025-09-05,Bill Meury,Incyte,7,15,0,22,
2025-09-05,Dale Francescon,Century Communities,3,9,3,15,
2025-09-05,Michael Nierenberg,Rithm Capital,9,26,1,36,
2025-09-05,Michael J Brown,Euronet Worldwide,2,8,0,10,
2025-09-05,Scott Seu,Hawaiian Electric Industries,4,17,3,24,
2025-09-05,Jason D Robins,DraftKings,5,3,0,8,
2025-09-05,Jonathan J Mazelsky,IDEXX Laboratories,1,2,1,4,
2025-09-05,Richard S Swartz,MYR Group,0,2,0,2,
2025-09-05,Stefano Caroti,Deckers Outdoor,2,7,1,10,
2025-09-05,Kevin R Sayer,DexCom,3,3,0,6,
2025-09-05,John T C Lee,MKS Instruments,4,9,1,14,
2025-09-05,Edward B Pitoniak,VICI Properties,1,7,0,8,
2025-09-05,Albert White III,Cooper Cos,0,0,0,0,
2025-09-05,Barry L Biffle,Frontier Airlines,1,5,6,12,
2025-09-05,Robert A Bruggeworth,Qorvo,5,4,0,9,
2025-09-05,Winnie Park,Five Below,9,27,4,40,
2025-09-05,Steven Oakland,TreeHouse Foods,2,14,0,16,
2025-09-05,James S Hagedorn,Scotts Miracle-Gro,1,0,0,1,
2025-09-05,Michael Cannon-Brookes,Atlassian,18,20,2,40,
2025-09-05,Bertrand Loy,Entegris,3,12,1,16,
2025-09-05,William E Waltz,Atkore,2,8,0,10,
2025-09-05,Celeste B Mastin,H B Fuller,1,4,0,5,
2025-09-05,Kyle T Larkin,Granite Construction,1,7,0,8,
2025-09-05,Michael J Happe,Winnebago Industries,1,2,0,3,
2025-09-05,Steven H Gunby,FTI Consulting,5,9,0,14,
2025-09-05,Stephan B Tanda,AptarGroup,0,4,3,7,
2025-09-05,Timothy P Boyle,Columbia Sportswear,3,3,2,8,
2025-09-05,Anthony J Wood,Roku,5,3,1,9,
2025-09-05,M Christopher Doyle,Civitas Resources,1,2,0,3,
2025-09-05,Andy Eidson,Alpha Metallurgical Resources,1,6,2,9,
2025-09-05,Andy L Nemeth,Patrick Industries,4,1,0,5,
2025-09-05,Roger W Jenkins,Murphy Oil,4,16,0,20,
2025-09-05,Kevin S Blair,Synovus Financial,6,3,0,9,
2025-09-05,Julie Felss Masino,Cracker Barrel Old Country Store,6,18,16,40,
2025-09-05,David M Overton,Cheesecake Factory,1,9,0,10,
2025-09-05,Nick DeIuliis,CNX Resources,8,3,0,11,
2025-09-05,Christopher Pappas,Chefs Warehouse,4,9,1,14,
2025-09-05,Tod Carpenter,Donaldson Company,2,8,0,10,
2025-09-05,Gregory L Christopher,Mueller Industries,2,6,0,8,
2025-09-05,Rob Saltiel,MRC Global,7,12,2,21,
2025-09-05,Jillian C Evanko,Chart Industries,3,6,0,9,
2025-09-05,Dave Guilmette,Alight Solutions,3,7,0,10,
2025-09-05,Joel Smejkal,Vishay Intertechnology,4,4,1,9,
2025-09-05,Dennis Degner,Range Resources,3,8,0,11,
2025-09-05,Ira D Robbins,Valley National Bancorp,1,1,0,2,
2025-09-05,Bernard Kim,Match Group,14,19,7,40,
2025-09-05,Vincent Pilette,Gen Digital,2,14,0,16,
2025-09-05,Timothy S Crane,Wintrust Financial,2,8,0,10,
2025-09-05,Pat Roche,Moog inc,4,11,2,17,
2025-09-05,Mark R Widmar,First Solar,2,8,1,11,
2025-09-05,Niko Lahanas,Central Garden & Pet,1,11,0,12,
2025-09-05,Chris Osowski,Green Plains inc,8,12,1,21,
2025-09-05,Derek J Leathers,Werner Enterprises,2,7,0,9,
2025-09-05,Adam Foroughi,AppLovin,10,26,4,40,
2025-09-05,Luca Savi,ITT,3,8,0,11,
2025-09-05,Lawrence H Silber,Herc Rentals,0,0,0,0,
2025-09-05,Hilton H Howell Jr,Gray Television,7,21,1,29,
2025-09-05,Eric D Ashleman,IDEX,0,9,1,10,
2025-09-05,Owen D Thomas,Boston Properties,3,7,0,10,
2025-09-05,Kurt Wolf,Pitney Bowes,6,19,2,27,
2025-09-05,Sara E Armbruster,Steelcase,2,0,0,2,
2025-09-05,Charles D. Young,Sun Communities,2,5,0,7,
2025-09-05,Suzanne Foster,AdaptHealth,5,7,1,13,
2025-09-05,Grant E Sims,Genesis Energy,2,2,0,4,
2025-09-05,Laura Prieskorn,Jackson Financial,3,5,2,10,
2025-09-05,Rick L Wessel,FirstCash,4,5,1,10,
2025-09-05,Sherman Miller,Cal-Maine Foods,10,29,1,40,
2025-09-05,Paul A Lang,Arch Resources,5,3,1,9,
2025-09-05,Ashish K Khandpur,Avient,2,6,0,8,
2025-09-05,Shyam K Reddy,BlueLinx,1,7,0,8,
2025-09-05,Christopher S Ripley,Sinclair,1,7,0,8,
2025-09-05,Stacy Kymes,BOK Financial,8,6,0,14,
2025-09-05,James H Walter,Permian Resources,0,1,0,1,
2025-09-05,Jason Murray,PACS Group,5,14,1,20,
2025-09-05,Brian Armstrong,Coinbase Global,11,23,6,40,
2025-09-05,Oscar K Brown,Western Midstream Partners,1,3,0,4,
2025-09-05,Nicholas R Lower,Federated Mutual Insurance,0,0,0,0,
2025-09-05,Morris Goldfarb,G-III Apparel Group,10,25,5,40,
2025-09-05,Mark D Morelli,Vontier,0,4,0,4,
2025-09-05,Matthew J Cox,Matson inc,0,6,0,6,
2025-09-05,David W Grzebinski,Kirby Corporation,1,3,0,4,
2025-09-05,Keith A Harvey,Kaiser Aluminum,3,4,2,9,
2025-09-05,Eric Nyman,Vista Outdoor,4,11,1,16,
2025-09-05,Doug Howe,Designer Brands,4,20,0,24,
2025-09-05,Jerry E Gahlhoff Jr,Rollins inc,0,2,0,2,
2025-09-05,D Scott Barbour,Advanced Drainage Systems,2,2,0,4,
2025-09-05,Sean Gamble,Cinemark,18,21,1,40,
2025-09-05,George Kurtz,CrowdStrike,16,21,3,40,
2025-09-05,Bill Ready,Pinterest,25,15,0,40,
2025-09-05,Fidji Simo,Instacart,9,30,1,40,
2025-09-05,Kimberly K Ryan,Hillenbrand,3,5,0,8,
2025-09-05,David S Graziosi,Allison Transmission,1,17,3,21,
2025-09-05,Gary G Friedman,Restoration Hardware,1,4,0,5,
2025-09-05,Lucinda M Baier,Brookdale Senior Living,3,5,0,8,
2025-09-05,Brian J Blaser,QuidelOrtho,0,0,0,0,
2025-09-05,E Jean Savage,Trinity Industries,1,7,1,9,
2025-09-05,Liam J Kelly,Teleflex,1,5,1,7,
2025-09-05,Laurans A Mendelson,HEICO,8,20,1,29,
2025-09-05,Frank H Laukien,Bruker,1,8,0,9,
2025-09-05,Harvey M Schwartz,Carlyle Group,5,14,0,19,
2025-09-05,Mark S LaVigne,Energizer,2,0,0,2,
2025-09-05,Joel Quadracci,Quad/Graphics,12,23,5,40,
2025-09-05,Amar Maletira,Rackspace Technology,6,13,2,21,
2025-09-05,Udit Batra,Waters Corporation,10,26,0,36,
2025-09-05,Eric M Green,West Pharmaceutical Services,1,9,0,10,
2025-09-05,Doug Palladini,Carters inc,2,2,2,6,
2025-09-05,G Mike Mikan,NeueHealth,4,2,0,6,
2025-09-05,Russell ChipChilds,SkyWest,0,0,0,0,
2025-09-05,Christopher H Hunter,Acadia Healthcare,0,1,0,1,
2025-09-05,Prahlad Singh,Revvity,2,7,0,9,
2025-09-05,Maria M Pope,Portland General Electric,1,1,0,2,
2025-09-05,Charles Chip Blankenship,Woodward inc,0,1,0,1,
2025-09-05,Mike Steib,TEGNA,12,19,1,32,
2025-09-05,Kurt J Ekert,Sabre Corporation,0,1,0,1,
2025-09-05,Matt Wilson,Light & Wonder,17,19,4,40,
2025-09-05,Rob Katz,Vail Resorts,0,0,0,0,
2025-09-05,Schnitzer Steel Industries,Radius Recycling,9,25,6,40,
2025-09-05,David A Spector,PennyMac Financial Services,3,1,0,4,
2025-09-05,Frederick J Holzgrefe III,Saia inc,1,1,0,2,
2025-09-05,Mark J Parrell,Equity Residential,4,6,0,10,
2025-09-05,John W Lindsay,Helmerich & Payne,0,4,0,4,
2025-09-05,Gary D Burnison,Korn Ferry,3,14,0,17,
2025-09-05,Timothy J McGrath,PC Connection Inc,1,2,0,3,
2025-09-05,Lynn M Bamford,Curtiss-Wright,12,9,0,21,
2025-09-05,Jonathan W Witter,Sallie Mae,0,1,0,1,
2025-09-05,Jeff Benck,Benchmark Electronics,8,7,0,15,
2025-09-05,Charles H Giancarlo,Pure Storage,0,3,0,3,
2025-09-05,Brian R Gray,Knife River Corporation,0,1,0,1,
2025-09-05,Jay Schmidt,Caleres inc,3,5,2,10,
2025-09-05,Dale Asplund,BrightView Holdings,1,5,0,6,
2025-09-05,Jeffrey S Edwards,Cooper-Standard,0,5,0,5,
2025-09-05,Glenn J Williams,Primerica,5,3,2,10,
2025-09-05,Francois Locoh-Donou,F5,8,20,3,31,
2025-09-05,Joseph Wm Foran,Matador Resources,6,10,0,16,
2025-09-05,Sridhar Ramaswamy,Snowflake inc,9,25,4,38,
2025-09-05,Mark D Dankberg,Viasat,2,4,3,9,
2025-09-05,Francisco J Leon,California Resources,1,4,1,6,
2025-09-05,Peter Stern,Peloton,18,18,4,40,
2025-09-05,David Baszucki,Roblox,10,21,9,40,
2025-09-05,Jeffrey W Edwards,Installed Building Products,0,3,0,3,
2025-09-05,Clark Lauritzen,First National of Nebraska,1,7,0,8,
2025-09-05,Carlos Alberini,Guess inc,12,27,1,40,
2025-09-05,Shyam P Kambeyanda,ESAB,3,4,0,7,
2025-09-05,Edmund Shallcross III,Amica Mutual Insurance,1,5,0,6,
2025-09-05,Benjamin W Schall,AvalonBay Communities,1,6,1,8,
2025-09-05,Allan C Thygesen,DocuSign,4,6,0,10,
2025-09-05,Bryan J Knutson,Titan Machinery,1,3,1,5,
2025-09-05,Heath Sampson,ModivCare,8,1,1,10,
2025-09-05,Ara K Hovnanian,Hovnanian Enterprises,2,18,1,21,
2025-09-05,Joshua G Silverman,Etsy,2,3,0,5,
2025-09-05,Kevin Roycraft,Adams Resources & Energy,5,4,1,10,
2025-09-05,J Eric Evans,Surgery Partners,1,1,0,2,
2025-09-05,Clint E Stein,Columbia Banking System,1,7,0,8,
2025-09-05,Lee M Shavel,Verisk Analytics,3,7,0,10,
2025-09-05,Dave Banyard Jr,MasterBrand,0,0,0,0,
2025-09-05,Peter R Ingram,Hawaiian Airlines inc,1,0,0,1,
2025-09-05,Kristin A Dolan,AMC Networks,3,2,0,5,
2025-09-05,Brendan T Cavanagh,SBA Communications,1,2,0,3,
2025-09-05,George F Chappelle Jr,Americold Realty Trust,1,3,0,4,
2025-09-05,Thomas E Gottwald,NewMarket Corporation,2,7,0,9,
2025-09-05,Thomas J Baltimore Jr,Park Hotels & Resorts,4,31,0,35,
2025-09-05,Peter M Moglia,Alexandria Real Estate Equities,3,6,0,9,
2025-09-05,Ronald J Kramer,Griffon Corporation,1,6,0,7,
2025-09-05,John L Plueger,Air Lease,2,13,0,15,
2025-09-05,Jennifer F Scanlon,UL Solutions,1,3,0,4,
2025-09-05,Greg Smith,Teradyne,2,9,2,13,
2025-09-05,Sean Trauschke,OGE Energy,19,5,0,24,
2025-09-05,Norman D Schwartz,Bio-Rad Laboratories,0,1,1,2,
2025-09-05,Scott Doyle,Spire inc,4,5,1,10,
2025-09-05,Michael E Reed,Gannett,0,5,2,7,
2025-09-05,Cindy J Miller,Stericycle,2,5,1,8,
2025-09-05,Phillip D Green,Cullen Frost Bankers,1,5,3,9,
2025-09-05,Joseph D Margolis,Extra Space Storage,0,8,1,9,
2025-09-05,Mark A Skonieczny,REV Group,6,3,1,10,
2025-09-05,Ladd Wilks,ProFrac Holding,4,3,0,7,
2025-09-05,Sundaram Nagarajan,Nordson,0,10,1,11,
2025-09-05,Anne P Noonan,Summit Materials,0,0,0,0,
2025-09-05,Lori Flees,Valvoline inc,4,5,1,10,
2025-09-05,Scott H Baxter,Kontoor Brands,2,2,0,4,
2025-09-05,Tim Larson,Skyline Champion,8,0,0,8,
2025-09-05,Chuck Divita,Teladoc Health,10,20,5,35,
2025-09-05,W Bradley Southern,Louisiana-Pacific Corporation,0,0,0,0,
2025-09-05,George C Freeman III,Universal Corporation,3,5,0,8,
2025-09-05,James A Brock,Consol Energy,2,0,0,2,
2025-09-05,Robert Antokol,Playtika Holding,1,7,1,9,
2025-09-05,Joe Craft,Alliance Resource Partners,7,9,2,18,
2025-09-05,Paul Keel,Envista,1,7,1,9,
2025-09-05,Jared Isaacman,Shift4 Payments,6,29,5,40,
2025-09-05,Mark Mac McFarland,Talen Energy,3,1,1,5,
2025-09-05,Tony R Thene,Carpenter Technology,2,9,0,11,
2025-09-05,Melissa D Smith,WEX,1,7,1,9,
2025-09-05,James Jim C Ryan III,Old National Bancorp,1,0,0,1,
2025-09-05,Peter J Federico,AGNC Investment,1,0,0,1,
2025-09-05,Brent L Yeagy,Wabash National,0,0,0,0,
2025-09-05,Henry A Fernandez,MSCI,3,13,0,16,
2025-09-05,Mark Penn,Stagwell,14,23,2,39,
2025-09-05,Julie Schertell,Mativ,2,9,0,11,
2025-09-05,Ashish Chand,Belden,3,6,1,10,
2025-09-05,Greg Anderson,Allegiant Travel Company,5,7,0,12,
2025-09-05,Drew Houston,Dropbox,14,19,7,40,
2025-09-05,Kevin T Conroy,Exact Sciences,2,5,2,9,
2025-09-05,Rex D Geveden,BWX Technologies,4,6,0,10,
2025-09-05,Scott R Wells,Clear Channel Outdoor Hldgs,0,0,0,0,
2025-09-05,Paul Bay,Ingram Micro,11,24,5,40,
2025-09-06,Doug McMillon,Walmart,16,19,5,40,
2025-09-06,Andrew Jassy,Amazon,3,32,5,40,
2025-09-06,Tim Cook,Apple,11,28,1,40,
2025-09-06,Stephen Hemsley,UnitedHealth,8,25,7,40,
2025-09-06,Warren Buffett,Berkshire Hathaway,11,21,8,40,
2025-09-06,David Joyner,CVS Health,7,28,5,40,
2025-09-06,Darren Woods,Exxon Mobil,9,23,7,39,
2025-09-06,Sundar Pichai,Alphabet,16,16,8,40,
2025-09-06,Brian Tyler,McKesson,4,14,5,23,
2025-09-06,Robert Mauch,Cencora,3,7,0,10,
2025-09-06,Ron Vachris,Costco,7,31,2,40,
2025-09-06,Jamie Dimon,JPMorgan Chase,11,17,12,40,
2025-09-06,Satya Nadella,Microsoft,16,22,2,40,
2025-09-06,Jason Hollar,Cardinal Health,14,21,5,40,
2025-09-06,Mike Wirth,Chevron,15,18,7,40,
2025-09-06,David Cordani,Cigna,21,16,3,40,
2025-09-06,Jim Farley,Ford Motor,12,22,6,40,
2025-09-06,Brian Moynihan,Bank of America,6,29,5,40,
2025-09-06,Mary Barra,General Motors,15,19,6,40,
2025-09-06,Gail Boudreaux,Elevance Health,16,17,7,40,
2025-09-06,Jane Fraser,Citigroup,13,20,7,40,
2025-09-06,Sarah London,Centene,14,17,9,40,
2025-09-06,Ted Decker,Home Depot,15,21,4,40,
2025-09-06,Maryann Mannen,Marathon Petroleum,5,13,1,19,
2025-09-06,Ron Sargent,Kroger,5,22,13,40,
2025-09-06,Mark Lashier,Phillips 66,12,19,7,38,
2025-09-06,Priscilla Almodovar,Fannie Mae,10,17,13,40,
2025-09-06,Tim Wentworth,Walgreens,9,23,8,40,
2025-09-06,Lane Riggs,Valero Energy,13,7,0,20,
2025-09-06,Mark Zuckerberg,Meta,5,22,13,40,
2025-09-06,Hans Vestberg,Verizon,14,22,4,40,
2025-09-06,John Stankey,AT&T,13,23,4,40,
2025-09-06,Brian Roberts,Comcast,10,27,3,40,
2025-09-06,Charles Scharf,Wells Fargo,27,7,6,40,
2025-09-06,David Solomon,Goldman Sachs,9,22,9,40,
2025-09-06,Michael Hutchins,Freddie Mac,3,10,4,17,
2025-09-06,Michael Fiddelke,Target,10,23,7,40,
2025-09-06,Jim Rechtin,Humana,18,17,5,40,
2025-09-06,Jon Farney,State Farm Insurance,1,13,3,17,
2025-09-06,Elon Musk,Tesla,8,29,3,40,
2025-09-06,Ted Pick,Morgan Stanley,15,22,3,40,
2025-09-06,Joaquin Duato,Johnson & Johnson,11,25,4,40,
2025-09-06,Juan Luciano,Archer Daniels Midland,3,21,16,40,
2025-09-06,Ramon Laguarta,PepsiCo,8,27,5,40,
2025-09-06,Carol Tom√©,UPS,6,23,11,40,
2025-09-06,Rajesh Subramaniam,FedEx,9,28,0,37,
2025-09-06,Bob Iger,Walt Disney,10,29,1,40,
2025-09-06,Michael Dell,Dell Technologies,11,25,4,40,
2025-09-06,Marvin Ellison,Lowes,14,24,1,39,
2025-09-06,Jon Moeller,Procter & Gamble,3,30,7,40,
2025-09-06,Thomas Long,Energy Transfer,8,0,2,10,
2025-09-06,Kelly Ortberg,Boeing,11,25,4,40,
2025-09-06,Susan Morris,Albertsons,13,24,3,40,
2025-09-06,Kevin Hourican,Sysco,8,28,4,40,
2025-09-06,Christopher Calio,RTX,7,11,0,18,
2025-09-06,Larry Culp,General Electric,11,26,3,40,
2025-09-06,James Taiclet,Lockheed Martin,13,19,8,40,
2025-09-06,Stephen Squeri,American Express,15,23,2,40,
2025-09-06,Joe Creed,Caterpillar,11,27,2,40,
2025-09-06,Michel Khalaf,MetLife,11,18,1,30,
2025-09-06,Samuel Hazen,HCA Healthcare,8,7,0,15,
2025-09-06,Tricia Griffith,Progressive Insurance,10,25,5,40,
2025-09-06,Arvind Krishna,IBM,13,21,6,40,
2025-09-06,John May,Deere,8,23,9,40,
2025-09-06,Jensen Huang,Nvidia,4,31,5,40,
2025-09-06,Philip Smith,StoneX,0,11,1,12,
2025-09-06,Robert M Davis,Merck,4,19,0,23,
2025-09-06,Ryan Lance,ConocoPhillips,16,21,3,40,
2025-09-06,Albert Bourla,Pfizer,25,10,5,40,
2025-09-06,Ed Bastian,Delta Air Lines,11,19,10,40,
2025-09-06,Patrick Zammit,TD Synnex,9,15,0,24,
2025-09-06,Kevin Murphy,Publix Super Markets,10,21,1,32,
2025-09-06,Thomas J Wilson,Allstate,1,9,1,11,
2025-09-06,Chuck Robbins,Cisco Systems,15,22,3,40,
2025-09-06,Kirt Walker,Nationwide,12,18,2,32,
2025-09-06,Christopher Winfrey,Charter Communications,5,17,5,27,
2025-09-06,Bob Michael,AbbVie,0,0,0,0,
2025-09-06,Craig DeSanto,New York Life Insurance,3,17,0,20,
2025-09-06,Lip-Bu Tan,Intel,8,20,12,40,
2025-09-06,Ernie Herrman,TJX,16,22,2,40,
2025-09-06,Andrew Sullivan,Prudential Financial,12,21,0,33,
2025-09-06,Enrique Lores,Hewlett Packard,11,17,6,34,
2025-09-06,Scott Kirby,United Airlines,33,4,3,40,
2025-09-06,George Holm,Performance Food,9,23,2,34,
2025-09-06,Donnie King,Tyson Foods,9,25,6,40,
2025-09-06,Robert Isom,American Airlines,7,25,8,40,
2025-09-06,Timothy M Sweeney,Liberty Mutual Insurance,12,0,0,12,
2025-09-06,Elliott Hill,Nike,8,30,2,40,
2025-09-06,Safra Catz,Oracle,11,21,8,40,
2025-09-06,AJ Jim Teague,Enterprise Products Partners,7,13,0,20,
2025-09-06,Richard Fairbank,Capital One,16,21,3,40,
2025-09-06,Wilfred Chiang,Plains GP,0,1,0,1,
2025-09-06,Michael Kasbar,World Kinect,2,11,0,13,
2025-09-06,Peter Zaffino,American International Group,8,28,4,40,
2025-09-06,James Quincey,The Coca-Cola Company,11,27,2,40,
2025-09-06,Thasunda Brown Duckett,TIAA,20,20,0,40,
2025-09-06,Jay Debertin,CHS,6,10,4,20,
2025-09-06,Chris Boerner,Bristol-Myers Squibb,10,24,6,40,
2025-09-06,Corie Barry,Best Buy,38,1,0,39,
2025-09-06,Marc Casper,Thermo Fisher Scientific,12,25,3,40,
2025-09-06,Roger Crandall,Mass Mutual,3,7,0,10,
2025-09-06,Juan Andrade,USAA,5,16,0,21,
2025-09-06,Phebe Novakovic,General Dynamics,27,10,3,40,
2025-09-06,Alan Schnitzer,Travelers Insurance,3,5,1,9,
2025-09-06,David Zaslav,Warner Bros Discovery,5,23,12,40,
2025-09-06,Gunjan Kedia,US Bancorp,14,24,2,40,
2025-09-06,Robert Ford,Abbott Laboratories,13,22,5,40,
2025-09-06,Kathy Warden,Northrop Grumman,14,21,5,40,
2025-09-06,Tim Gerend,Northwestern Mutual,13,26,1,40,
2025-09-06,Todd Vasos,Dollar General,8,24,8,40,
2025-09-06,Matthew Lucey,PBF Energy,7,3,0,10,
2025-09-06,Dara Khosrowshahi,Uber,11,22,7,40,
2025-09-06,Vimal Kapur,Honeywell,12,28,0,40,
2025-09-06,Dirk Van de Put,Mondelez,10,28,2,40,
2025-09-06,Brian Niccol,Starbucks,11,28,1,40,
2025-09-06,Cristiano Amon,Qualcomm,11,27,2,40,
2025-09-06,Hock Tan,Broadcom,14,24,2,40,
2025-09-06,David Flitman,US Foods,2,7,0,9,
2025-09-06,Paul Romanowski,DR Horton,6,15,5,26,
2025-09-06,Jacek Olczak,Philip Morris,14,23,3,40,
2025-09-06,Preston Feight,Paccar,6,26,1,33,
2025-09-06,Marc Benioff,Salesforce,5,20,15,40,
2025-09-06,Leon Topalian,Nucor,14,23,3,40,
2025-09-06,Michael Dastoor,Jabil,1,7,0,8,
2025-09-06,Jonathan Jaffe,Lennar,0,8,2,10,
2025-09-06,David Ricks,Eli Lilly,10,21,9,40,
2025-09-06,Joe Zubretsky,Molina Healthcare,6,5,4,15,
2025-09-06,Jennifer Rumsey,Cummins,7,27,6,40,
2025-09-06,Robin Vince,Bank of New York Mellon,20,19,1,40,
2025-09-06,Ted Sarandos,Netflix,13,25,2,40,
2025-09-06,William H Rogers Jr,Truist Financial,3,6,0,9,
2025-09-06,Sean Kerins,Arrow Electronics,2,12,0,14,
2025-09-06,William M Brown,3M,2,8,0,10,
2025-09-06,Ryan McInerney,Visa,13,23,4,40,
2025-09-06,Marc Rowan,Apollo Global Management,16,20,4,40,
2025-09-06,Tim Go,HF Sinclair,6,3,0,9,
2025-09-06,Robert Sulentic,CBRE Group,1,7,1,9,
2025-09-06,William Demchak,PNC Financial Services,16,19,5,40,
2025-09-06,Bryan DeBoer,Lithia Motors,12,26,1,39,
2025-09-06,William Nash,CarMax,4,4,2,10,
2025-09-06,Brian Robbins,Paramount Global,6,32,2,40,
2025-09-06,Michael Creedon,Dollar Tree,4,33,3,40,
2025-09-06,Sandy Douglas,United Natural Foods,34,5,1,40,
2025-09-06,Alex Chriss,PayPal,14,23,3,40,
2025-09-06,Roger Penske,Penske Automotive,18,21,1,40,
2025-09-06,Antonio Neri,Hewlett Packard Enterprise,12,20,8,40,
2025-09-06,Harry Sideris,Duke Energy,36,4,0,40,
2025-09-06,Vicki Hollub,Occidental Petroleum,21,15,3,39,
2025-09-06,Lawrence Coben,NRG Energy,5,3,0,8,
2025-09-06,Robert Bradway,Amgen,9,29,2,40,
2025-09-06,John Ketchum,NextEra Energy,23,17,0,40,
2025-09-06,Rainer Blair,Danaher,7,17,2,26,
2025-09-06,Daniel O'Day,Gilead Sciences,19,19,2,40,
2025-09-06,Michael Manley,AutoNation,3,6,1,10,
2025-09-06,Carlos Abrams-Rivera,Kraft Heinz,6,31,3,40,
2025-09-06,Philip Gallagher,Avnet,1,4,1,6,
2025-09-06,Gary Dickerson,Applied Materials,7,23,10,40,
2025-09-06,Bob Jordan,Southwest Airlines,10,23,6,39,
2025-09-06,Rick Wurster,Charles Schwab,12,22,5,39,
2025-09-06,Lorenzo Simonelli,Baker Hughes,16,20,4,40,
2025-09-06,Chris Kempczinski,McDonalds,11,23,6,40,
2025-09-06,Christopher Womack,Southern Company,2,7,0,9,
2025-09-06,Michael Miebach,Mastercard,11,26,3,40,
2025-09-06,Joseph Dominguez,Constellation Energy,13,11,1,25,
2025-09-06,Christopher Swift,The Hartford,17,19,4,40,
2025-09-06,Patricia Poppe,PG&E,8,14,2,24,
2025-09-06,Bom Kim,Coupang,13,26,1,40,
2025-09-06,Ezra Yacob,EOG Resources,23,14,3,40,
2025-09-06,Jim Vena,Union Pacific,21,19,0,40,
2025-09-06,Matt Schroeder,Rite Aid,4,33,3,40,
2025-09-06,Tony Spring,Macys,10,26,4,40,
2025-09-06,Anthony Capuano,Marriott International,13,24,3,40,
2025-09-06,Raymond E Scott,Lear Corporation,4,6,0,10,
2025-09-06,William Stengel II,Genuine Parts,0,4,0,4,
2025-09-06,Heidi Petz,Sherwin-Williams,9,28,3,40,
2025-09-06,Jeff Miller,Halliburton,12,21,7,40,
2025-09-06,Kathleen Quirk,Freeport-McMoRan,14,18,2,34,
2025-09-06,Michael Rapino,Live Nation Entertainment,13,24,3,40,
2025-09-06,John Doyle,Marsh & McLennan,11,8,0,19,
2025-09-06,Lisa Su,Advanced Micro Devices,16,19,5,40,
2025-09-06,Frank Holding,First Citizens BancShares,9,14,2,25,
2025-09-06,John Engel,WESCO International,5,12,1,18,
2025-09-06,David Gitlin,Carrier Global,15,23,2,40,
2025-09-06,Lourenco Goncalves,Cleveland-Cliffs,5,19,16,40,
2025-09-06,Calvin G Butler Jr,Exelon,6,4,0,10,
2025-09-06,Joseph Bae,KKR,19,18,3,40,
2025-09-06,Christine Leahy,CDW,0,9,2,11,
2025-09-06,Glenn Fogel,Booking Holdings,10,24,6,40,
2025-09-06,Brian Doubles,Synchrony Financial,5,7,2,14,
2025-09-06,Earl Austin,Quanta Services,2,6,2,10,
2025-09-06,Christian Ulbrich,Jones Lang LaSalle,8,17,0,25,
2025-09-06,Saumya Sutaria,Tenet Healthcare,5,3,1,9,
2025-09-06,William Gifford,Altria,3,4,2,9,
2025-09-06,Kevin Lobo,Stryker,12,25,3,40,
2025-09-06,Michael Hsu,Kimberly-Clark,6,6,1,13,
2025-09-06,Jack Fusco,Cheniere Energy,17,20,3,40,
2025-09-06,James Conroy,Ross Stores,4,11,0,15,
2025-09-06,Anthony Smurfit,Smurfit Westrock,4,5,0,9,
2025-09-06,Jeffrey Harmening,General Mills,3,17,5,25,
2025-09-06,Mark Stewart,Goodyear Tire & Rubber,4,35,1,40,
2025-09-06,Bob Eddy,BJs Wholesale Club,3,21,3,27,
2025-09-06,Peter Arduini,GE HealthCare Technologies,5,11,0,16,
2025-09-06,Noel Wallace,Colgate-Palmolive,11,23,2,36,
2025-09-06,Marc Bitzer,Whirlpool,12,14,14,40,
2025-09-06,Chris Kubasik,L3Harris Technologies,6,13,0,19,
2025-09-06,Shantanu Narayen,Adobe,18,20,1,39,
2025-09-06,Thomas Polen,Becton Dickinson,5,5,0,10,
2025-09-06,Richard P Dealy,Pioneer Natural Resources,5,2,0,7,
2025-09-06,Ravi Kumar S,Cognizant Technology Solutions,12,24,3,39,
2025-09-06,Andrew Clyde,Murphy USA,13,25,2,40,
2025-09-06,Mike Lyons,Fiserv,4,12,1,17,
2025-09-06,Jennifer Parmentier,Parker-Hannifin,2,11,0,13,
2025-09-06,William Fehrman,American Electric Power,3,7,0,10,
2025-09-06,Andrew Silvernail,International Paper,4,23,0,27,
2025-09-06,Jonas Prising,ManpowerGroup,7,22,2,31,
2025-09-06,John Zillmer,Aramark,6,12,2,20,
2025-09-06,Mark Millett,Steel Dynamics,19,2,0,21,
2025-09-06,Dan Amos,Aflac,14,19,7,40,
2025-09-06,Tony Cheng,Reinsurance Group of America,3,9,2,14,
2025-09-06,Karsanbhai,Emerson Electric,7,15,3,25,
2025-09-06,Ronald P O'Hanley,State Street,7,16,0,23,
2025-09-06,Timothy Knavish,PPG Industries,1,2,0,3,
2025-09-06,David Burritt,United States Steel,8,20,12,40,
2025-09-06,Maria Black,Automatic Data Processing,6,4,0,10,
2025-09-06,Daryl Kenningham,Group 1 Automotive,7,31,2,40,
2025-09-06,Robert Blue,Dominion Energy,28,11,1,40,
2025-09-06,Larry Fink,BlackRock,7,25,8,40,
2025-09-06,Pierce Norton II,Oneok,5,3,1,9,
2025-09-06,David Bozeman,CH Robinson Worldwide,2,8,0,10,
2025-09-06,Haviv Ilan,Texas Instruments,10,27,3,40,
2025-09-06,Michael Bender,Kohls,1,25,14,40,
2025-09-06,Philip Daniele III,AutoZone,0,2,0,2,
2025-09-06,Timothy Archer,Lam Research,3,7,0,10,
2025-09-06,Charles Magro,Corteva,4,3,1,8,
2025-09-06,Rick Lanoha,Peter Kiewit Sons',0,2,0,2,
2025-09-06,Peter Jackson,Builders FirstSource,5,11,1,17,
2025-09-06,Martin Schroeter,Kyndryl,11,27,1,39,
2025-09-06,Hamid Akhavan,EchoStar,5,25,7,37,
2025-09-06,Bill Westrate,American Family Insurance,10,17,2,29,
2025-09-06,Avigal Soreq,Delek US,4,9,5,18,
2025-09-06,Beth Ford,Land O'Lakes,18,22,0,40,
2025-09-06,Walker Martin,Sempra,0,2,0,2,
2025-09-06,Eric Slifka,Global Partners,14,20,6,40,
2025-09-06,DG Macpherson,WW Grainger,2,7,1,10,
2025-09-06,Bob Pragada,Jacobs Solutions,6,9,0,15,
2025-09-06,Pedro Pizarro,Edison International,16,8,16,40,
2025-09-06,William Hornbuckle,MGM Resorts International,7,23,1,31,
2025-09-06,Andrew McMahon,Guardian Life insurance,6,12,0,18,
2025-09-06,Christopher O'Herlihy,Illinois Tool Works,3,6,1,10,
2025-09-06,James Cracchiolo,Ameriprise Financial,2,22,2,26,
2025-09-06,Ryan Marshall,PulteGroup,9,14,11,34,
2025-09-06,Matthew Meloy,Targa Resources,5,5,0,10,
2025-09-06,Michael Rhodes,Ally Financial,9,26,5,40,
2025-09-06,Joseph Fadool,BorgWarner,4,10,0,14,
2025-09-06,St√©phane de La Faverie,Est√©e Lauder,10,26,4,40,
2025-09-06,Benjamin Tisch,Loews,3,7,0,10,
2025-09-06,Brad Beckham,O'Reilly Automotive,5,18,1,24,
2025-09-06,Thomas Gayner,Markel Group,2,8,0,10,
2025-09-06,Donald Allan,Stanley Black & Decker,9,30,1,40,
2025-09-06,Sanjay Mehrotra,Micron Technology,17,21,2,40,
2025-09-06,James Breuer,Fluor,0,2,1,3,
2025-09-06,Thomas Bell,Leidos,9,18,2,29,
2025-09-06,Scott Smith,Viatris,6,4,0,10,
2025-09-06,Kimberly Dang,Kinder Morgan,11,1,0,12,
2025-09-06,Christophe Beck,Ecolab,18,22,0,40,
2025-09-06,Brent Shafer,Baxter International,1,10,0,11,
2025-09-06,Clay Gaspar,Devon Energy,22,3,0,25,
2025-09-06,Steven Cahillane,Kellanova,2,7,0,9,
2025-09-06,Raul Nicholas Vargas Ochoa,Farmers Insurance Exchange,0,0,0,0,
2025-09-06,Darren Rebelez,Caseys General Stores,3,6,0,9,
2025-09-06,Ari Bousbib,IQVIA,6,17,1,24,
2025-09-06,Jon Vander Ark,Republic Services,11,19,10,40,
2025-09-06,Timothy Cofer,Keurig Dr Pepper,2,6,1,9,
2025-09-06,Karla Lewis,Reliance Inc,3,6,0,9,
2025-09-06,David Hult,Asbury Automotive Group,9,30,1,40,
2025-09-06,Darryl Button,Pacific Life,1,8,0,9,
2025-09-06,James Burke,Vistra,6,4,0,10,
2025-09-06,John Barrett,Western & Southern Financial,10,28,2,40,
2025-09-06,William Krueger,The Andersons Inc,0,2,0,2,
2025-09-06,Erik Nordstrom,Nordstrom,5,28,6,39,
2025-09-06,John Wren,Omnicom Group,14,20,6,40,
2025-09-06,Stephanie Ferris,Fidelity National Information Services,15,23,2,40,
2025-09-06,Timothy Cawley,Consolidated Edison,5,5,0,10,
2025-09-06,Joseph Hinrichs,CSX,6,11,1,18,
2025-09-06,Troy Rudd,AECOM,8,24,4,36,
2025-09-06,Kathleen Johnson,Lumen Technologies,3,6,1,10,
2025-09-06,Harry Lawton III,Tractor Supply,1,1,0,2,
2025-09-06,Raul Fernandez,DXC Technology,4,31,3,38,
2025-09-06,Eric Hansotia,AGCO,15,19,1,35,
2025-09-06,David Bruton Smith,Sonic Automotive,4,8,9,21,
2025-09-06,Sasan Goodarzi,Intuit,9,27,4,40,
2025-09-06,Matthew Flannery,United Rentals,34,2,0,36,
2025-09-06,Marc Miller,Universal Health Services,4,20,3,27,
2025-09-06,Michael Mahoney,Boston Scientific,11,29,0,40,
2025-09-06,Judith Marks,Otis Worldwide,2,3,0,5,
2025-09-06,Robert Frenzel,Xcel Energy,3,2,2,7,
2025-09-06,Penny Pennington,Edward Jones,8,26,6,40,
2025-09-06,Daniel Fisher,Ball,4,26,6,36,
2025-09-06,Justin Jude,LKQ,4,7,1,12,
2025-09-06,James Blackledge,Mutual of Omaha,3,30,1,34,
2025-09-06,Bruce Bodine,Mosaic,2,9,0,11,
2025-09-06,Scott Donnelly,Textron,9,28,3,40,
2025-09-06,Adam Schechter,Labcorp Holdings,3,5,1,9,
2025-09-06,Deanna Strable-Soethout,Principal Financial,2,6,0,8,
2025-09-06,Leonard Schleifer,Regeneron Pharmaceuticals,7,26,7,40,
2025-09-06,Paul Shoukry,Raymond James Financial,15,24,1,40,
2025-09-06,Lauren Hobart,Dicks Sporting Goods,12,24,4,40,
2025-09-06,Jamie Whisnant,Auto-Owners Insurance,0,2,0,2,
2025-09-06,Ariane Gorin,Expedia,8,31,1,40,
2025-09-06,Shelley Simpson,JB Hunt Transport Services,9,28,3,40,
2025-09-06,Ren√© Jones,M&T Bank,13,23,4,40,
2025-09-06,Gerardo Norcia,DTE Energy,6,3,0,9,
2025-09-06,Andr√©s Gluski,AES,16,22,0,38,
2025-09-06,Timothy Spence,Fifth Third Bancorp,5,4,1,10,
2025-09-06,Eduardo Menezes,Air Products & Chemicals,3,6,1,10,
2025-09-06,Wendell Weeks,Corning,15,23,2,40,
2025-09-06,Anthony Guzzi,EMCOR Group,4,3,1,8,
2025-09-06,Adam Norwitt,Amphenol,3,17,0,20,
2025-09-06,Jean-Marc Gilson,Westlake Corporation,2,4,0,6,
2025-09-06,Lori Koch,DuPont,7,18,0,25,
2025-09-06,Derek Chang,Liberty Media,36,3,1,40,
2025-09-06,Martina Cheung,S&P Global,11,27,0,38,
2025-09-06,Tim Hingtgen,Community Health Systems,11,27,2,40,
2025-09-06,Brian Tierney,FirstEnergy,5,22,3,30,
2025-09-06,Rick McKenney,Unum Group,5,4,0,9,
2025-09-06,Stanley Bergman,Henry Schein,11,28,1,40,
2025-09-06,Tiang Yew Tan,Western Digital,0,3,0,3,
2025-09-06,Vincent Roche,Analog Devices,14,24,2,40,
2025-09-06,Sean Connolly,Conagra Brands,7,31,2,40,
2025-09-06,Bruce Van Saun,Citizens Financial Group,13,26,1,40,
2025-09-06,Mark George,Norfolk Southern,19,18,3,40,
2025-09-06,Andrew Marsh,Entergy,4,4,0,8,
2025-09-06,Robert Berkley,WR Berkley,10,26,4,40,
2025-09-06,Javier Rodriguez,DaVita,14,14,1,29,
2025-09-06,Michael O'Grady,Northern Trust,27,6,1,34,
2025-09-06,James Snee,Hormel Foods,2,27,1,30,
2025-09-06,Timothy J Donahue,Crown Holdings,2,9,0,11,
2025-09-06,Joseph Ferraro,Avis Budget,3,5,1,9,
2025-09-06,Niraj Shah,Wayfair,8,24,8,40,
2025-09-06,Jos√© Mas,MasTec,6,14,1,21,
2025-09-06,Joseph Nolan,Eversource Energy,5,3,1,9,
2025-09-06,Thomas Palmer,Newmont,4,6,0,10,
2025-09-06,Robert Sanchez,Ryder System,11,9,1,21,
2025-09-06,Michael Nolan,Fidelity National Financial,4,0,0,4,
2025-09-06,Gavin Hattersley,Molson Coors Beverage,6,29,5,40,
2025-09-06,Thomas Reeg,Caesars Entertainment,6,5,0,11,
2025-09-06,Ellen Cooper,Lincoln National,3,5,0,8,
2025-09-06,Bracken Darrell,VF Corporation,10,27,3,40,
2025-09-06,Erik Fyrwald,International Flavors & Fragrances,9,6,2,17,
2025-09-06,Christopher Kastner,Huntington Ingalls Industries,3,5,0,8,
2025-09-06,Shane O'Kelly,Advance Auto Parts,14,22,4,40,
2025-09-06,Ralph LaRossa,Public Service Enterprise Group,11,18,0,29,
2025-09-06,Kecia Steelman,Ulta Beauty,33,6,1,40,
2025-09-06,Michele Buck,Hershey,6,32,2,40,
2025-09-06,Sumit Singh,Chewy,11,25,4,40,
2025-09-06,Steven Vondran,American Tower,4,6,0,10,
2025-09-06,Jeffrey Lorberbaum,Mohawk Industries,11,5,1,17,
2025-09-06,Keith Demmings,Assurant,2,8,0,10,
2025-09-06,Robert Martin,Thor Industries,3,6,1,10,
2025-09-06,Kathleen Mazzarella,Graybar Electric,1,7,1,9,
2025-09-06,Joey Wat,Yum China,13,25,2,40,
2025-09-06,Scott Richardson,Celanese,9,25,4,38,
2025-09-06,David Rawlinson II,QVC,7,15,2,24,
2025-09-06,Alan Armstrong,Williams,25,11,4,40,
2025-09-06,Philippe Krakowsky,Interpublic Group,13,24,3,40,
2025-09-06,Brendan McCracken,Ovintiv,7,5,0,12,
2025-09-06,Andrew Teno,Icahn Enterprises,5,4,1,10,
2025-09-06,Stephen Steinour,Huntington Bancshares,3,7,0,10,
2025-09-06,Timothy NeCastro,Erie Insurance,3,6,1,10,
2025-09-06,Ernest Garcia III,Carvana,23,13,4,40,
2025-09-06,R Bruce McDonald,Dana Incorporated,3,7,1,11,
2025-09-06,William Oplinger,Alcoa Corporation,2,7,1,10,
2025-09-06,Mark Pearson,Equitable,8,8,0,16,
2025-09-06,Richard Wallace,KLA,4,5,0,9,
2025-09-06,Ricardo Cardenas,Darden Restaurants,4,3,1,8,
2025-09-06,Mikael Bratt,Autoliv,7,6,2,15,
2025-09-06,Benito Minicucci,Alaska Air,3,3,1,7,
2025-09-06,Christopher Gorman,KeyCorp,5,5,0,10,
2025-09-06,Robert Goldstein,Las Vegas Sands,4,31,5,40,
2025-09-06,Edward Pesicka,Owens & Minor,3,32,2,37,
2025-09-06,Christopher Nassetta,Hilton Worldwide,7,16,2,25,
2025-09-06,Jamie Iannone,Ebay,16,21,3,40,
2025-09-06,Patrick Gallagher,Arthur J Gallagher,8,30,2,40,
2025-09-06,Rich Steinmeier,LPL Financial,25,13,2,40,
2025-09-06,Stephen Spray,Cincinnati Financial,1,6,2,9,
2025-09-06,Douglas Yearley,Toll Brothers,10,25,5,40,
2025-09-06,Gregory Brown,Motorola Solutions,1,9,0,10,
2025-09-06,Brian Chesky,Airbnb,4,29,7,40,
2025-09-06,Jeffrey Sprecher,Intercontinental Exchange,15,23,2,40,
2025-09-06,Robert Thomson,News Corp,8,30,2,40,
2025-09-06,Scott Boatwright,Chipotle Mexican Grill,8,27,5,40,
2025-09-06,Reshma Kewalramani,Vertex Pharmaceuticals,20,15,5,40,
2025-09-06,Christopher Viehbacher,Biogen,0,24,2,26,
2025-09-06,Malcolm Wilson,GXO Logistics,6,22,0,28,
2025-09-06,Tony Sarsam,SpartanNash,16,22,2,40,
2025-09-06,Michael O‚ÄôSullivan,Burlington Stores,8,28,4,40,
2025-09-06,Teresa Rasmussen,Thrivent Financial for Lutherans,3,2,0,5,
2025-09-06,Eugene Bredow,NVR,0,5,1,6,
2025-09-06,Brian Chambers,Owens Corning,3,10,1,14,
2025-09-06,Rafael Santana,Westinghouse Air Brake Technologies,2,7,1,10,
2025-09-06,John Pfeifer,Oshkosh,4,25,4,33,
2025-09-06,Cameron Bready,Global Payments,8,30,2,40,
2025-09-06,Calvin McDonald,Lululemon athletica,10,29,1,40,
2025-09-06,J Kent Masters,Albemarle Corporation,3,6,0,9,
2025-09-06,Joanna Geraghty,JetBlue Airways,13,20,7,40,
2025-09-06,Robert Steer,Seaboard,1,4,0,5,
2025-09-06,William Newlands,Constellation Brands,0,2,2,4,
2025-09-06,Michael Doss,Graphic Packaging,3,9,1,13,
2025-09-06,Gil West,Hertz,7,23,9,39,
2025-09-06,Malcolm C Roberts,FM Global,2,10,2,14,
2025-09-06,Mick Beekhuizen,Campbell Soup,9,22,0,31,
2025-09-06,Daniel Wall,Expeditors International of Washington,4,4,0,8,
2025-09-06,Gregory Roberts,A-Mark Precious Metals,1,4,1,6,
2025-09-06,Horacio Rozanski,Booz Allen Hamilton,16,19,5,40,
2025-09-06,James Davis,Quest Diagnostics,5,5,0,10,
2025-09-06,Dennis Mathew,Altice,5,28,7,40,
2025-09-06,Stefan Larsson,PVH,10,25,5,40,
2025-09-06,Mark Costa,Eastman Chemical,5,15,4,24,
2025-09-06,Joyce Mullen,Insight Enterprises,5,10,0,15,
2025-09-06,John Turner,Regions Financial,19,19,2,40,
2025-09-06,Julian G Francis,Beacon Roofing Supply,0,1,0,1,
2025-09-06,Blake Moret,Rockwell Automation,12,26,2,40,
2025-09-06,Mike Speetzen,Polaris Inc,3,18,2,23,
2025-09-06,William McDermott,ServiceNow,4,5,0,9,
2025-09-06,Jure Sola,Sanmina,2,11,0,13,
2025-09-06,Bob Flexon,UGI Utilities Inc,0,1,0,1,
2025-09-06,Scott Lauber,WEC Energy,13,6,0,19,
2025-09-06,Jon Rousseau,BrightSpring Health Services,19,20,1,40,
2025-09-06,Todd Schneider,Cintas,15,18,2,35,
2025-09-06,Peter Matt,Commercial Metals,5,3,0,8,
2025-09-06,Robert D Lawler,Continental Resources,1,0,0,1,
2025-09-06,Domenic Dell‚ÄôOsso Jr,Expand Energy,4,1,0,5,
2025-09-06,Jason P Wells,CenterPoint Energy,9,4,1,14,
2025-09-06,H Michael Krimbill,NGL Energy Partners,5,3,0,8,
2025-09-06,Tony Xu,DoorDash,12,21,7,40,
2025-09-06,Clay Williams,NOV,7,20,5,32,
2025-09-06,Kristin Peck,Zoetis,13,19,1,33,
2025-09-06,Mark Smucker,JM Smucker,14,20,6,40,
2025-09-06,Steve Sanghi,Microchip Technology,7,29,4,40,
2025-09-06,Richard Tobin,Dover Corporation,5,3,0,8,
2025-09-06,Kaes Van‚Äôt Hof,Diamondback Energy,19,17,3,39,
2025-09-06,Deon Stander,Avery Dennison,0,13,0,13,
2025-09-06,Vincent Sorgi,PPL,8,10,1,19,
2025-09-06,Hassane El-Khoury,ON Semiconductor,2,17,5,24,
2025-09-06,Arie Kotler,ARKO,5,22,1,28,
2025-09-06,William Monteleone,Par Pacific,1,6,2,9,
2025-09-06,John Christmann IV,APA,5,4,1,10,
2025-09-06,Adaire Fox-Martin,Equinix,14,22,4,40,
2025-09-06,Joseph M Otting,Flagstar Financial,2,6,2,10,
2025-09-06,Mary Dillon,Foot Locker,12,24,4,40,
2025-09-06,James Zallie,Ingredion,4,5,1,10,
2025-09-06,Christopher Peterson,Newell Brands,0,9,1,10,
2025-09-06,Scott Salmirs,ABM Industries,7,7,1,15,
2025-09-06,Christopher Hilger,Securian Financial,0,6,0,6,
2025-09-06,Hamid Moghadam,Prologis,7,28,5,40,
2025-09-06,Stephen Schwarzman,Blackstone,16,20,4,40,
2025-09-06,Robert Greenberg,Skechers USA,5,22,3,30,
2025-09-06,Keith Allman,Masco,4,9,1,14,
2025-09-06,Rusty Rush,Rush Enterprises,16,21,3,40,
2025-09-06,Jennifer Johnson,Franklin Resources,1,7,2,10,
2025-09-06,Gerry P Smith,ODP Business Solutions,0,1,0,1,
2025-09-06,Carl Lindner lll,American Financial,0,0,0,0,
2025-09-06,Mark Kowlzan,Packaging Corp of America,0,9,1,10,
2025-09-06,Thomas Hill,Vulcan Materials,4,6,2,12,
2025-09-06,Milan Galik,Interactive Brokers,7,20,2,29,
2025-09-06,Laura Alber,Williams-Sonoma,12,24,4,40,
2025-09-06,Mario Harik,XPO,8,31,1,40,
2025-09-06,Devin Stockfish,Weyerhaeuser,5,5,0,10,
2025-09-06,Thomas J McInerney,Genworth Financial,1,6,0,7,
2025-09-06,Garrick Rochow,CMS Energy,12,3,1,16,
2025-09-06,Toni Townes-Whitley,Science Applications International,12,23,1,36,
2025-09-06,Rich Handler,Jefferies Financial,12,10,2,24,
2025-09-06,Daniel Heaf,Bath & Body Works,12,26,2,40,
2025-09-06,Andrew Wilson,Electronic Arts,13,18,9,40,
2025-09-06,Sheryl Palmer,Taylor Morrison Home,8,12,1,21,
2025-09-06,Ivan Tornos,Zimmer Biomet,8,30,2,40,
2025-09-06,Linda Rendle,Clorox,2,34,2,38,
2025-09-06,Matthew Pine,Xylem Inc,1,8,1,10,
2025-09-06,Heather Lavallee,Voya Financial,6,11,2,19,
2025-09-06,Daniel Florness,Fastenal,4,5,1,10,
2025-09-06,Albert Nahmad,Watsco,2,7,0,9,
2025-09-06,Carl Eschenbach,Workday,13,18,9,40,
2025-09-06,Craig Smiddy,Old Republic International,3,5,1,9,
2025-09-06,Frank C Sullivan,RPM International,4,8,0,12,
2025-09-06,Matthew Missad,UFP Industries,7,3,0,10,
2025-09-06,Martin J Lyons,Ameren,2,3,1,6,
2025-09-06,Adam W Miller,Knight Swift Transportation,0,2,1,3,
2025-09-06,Rodney Sacks,Monster Beverage,11,27,1,39,
2025-09-06,Gary Guthart,Intuitive Surgical,14,23,3,40,
2025-09-06,Charles Liang,Super Micro Computer,33,6,1,40,
2025-09-06,Christopher Caldwell,Concentrix,3,5,0,8,
2025-09-06,Gordon J Hardie,O-I Glass,0,4,0,4,
2025-09-06,David Gibbs,Yum Brands,3,37,0,40,
2025-09-06,Steve Henry,Domtar,5,5,0,10,
2025-09-06,Chuck Treadway,CommScope,8,20,3,31,
2025-09-06,Rob Vitale,Post Holdings,1,11,5,17,
2025-09-06,Steven J Moskowitz,Crown Castle,2,5,3,10,
2025-09-06,Emmanuel Ligner,Avantor,2,11,1,14,
2025-09-06,Stuart Bradie,KBR,14,16,4,34,
2025-09-06,Carrie Wheeler,Opendoor Technologies,12,25,3,40,
2025-09-06,Russell Becker,APi Group,4,4,1,9,
2025-09-06,Toby Rice,EQT,24,13,3,40,
2025-09-06,Jesse Arenivas,EnLink Midstream,7,9,0,16,
2025-09-06,Nikesh Arora,Palo Alto Networks,6,25,9,40,
2025-09-06,Steven Bandrowczak,Xerox,1,8,1,10,
2025-09-06,Vicente Reynal,Ingersoll Rand,7,26,0,33,
2025-09-06,William T Dillard II,Dillards,4,4,2,10,
2025-09-06,C Howard Nye,Martin Marietta Materials,2,5,3,10,
2025-09-06,Giordano Albertazzi,Vertiv,16,20,4,40,
2025-09-06,Stephane Bancel,Moderna,9,20,10,39,
2025-09-06,Nate R Jorgensen,Boise Cascade,0,0,0,0,
2025-09-06,Jack Sinclair,Sprouts Farmers Market,14,25,1,40,
2025-09-06,Padraig McDonnell,Agilent Technologies,12,14,0,26,
2025-09-06,Kenneth T Lane,Olin,0,0,0,0,
2025-09-06,Randall C Stuewe,Darling Ingredients,27,1,0,28,
2025-09-06,R Howard Coker,Sonoco Products,4,5,1,10,
2025-09-06,John Mengucci,CACI International,20,18,2,40,
2025-09-06,Mark Witkowski,Core & Main,0,8,1,9,
2025-09-06,Lee M Tillman,Marathon Oil,4,4,0,8,
2025-09-06,Mark Hoplamazian,Hyatt Hotels,16,20,4,40,
2025-09-06,David S Chernow,Select Medical,0,8,1,9,
2025-09-06,Brendan M Foley,McCormick & Company,0,8,0,8,
2025-09-06,Joanne Crevoiserat,Tapestry,14,21,5,40,
2025-09-06,John Plant,Howmet Aerospace,6,12,3,21,
2025-09-06,Shankh Mitra,Welltower,17,21,2,40,
2025-09-06,W Anthony Will,CF Industries,3,4,0,7,
2025-09-06,David A Zapico,Ametek,3,17,0,20,
2025-09-06,Kevin Stein,TransDigm,10,8,3,21,
2025-09-06,Craig Billings,Wynn Resorts,13,25,2,40,
2025-09-06,William J Way,Southwestern Energy,1,0,0,1,
2025-09-06,Giel Rutten,Amkor Technology,2,9,1,12,
2025-09-06,Paul Sarvadi,Insperity,4,4,1,9,
2025-09-06,Donald Zurbay,Patterson Companies Inc,1,4,0,5,
2025-09-06,Rob Sharps,T Rowe Price,12,22,5,39,
2025-09-06,Patrice Louvet,Ralph Lauren,14,16,10,40,
2025-09-06,Jeffrey Mezger,KB Home,2,31,7,40,
2025-09-06,David M Foulkes,Brunswick,1,7,0,8,
2025-09-06,M Keith Waddell,Robert Half,2,9,1,12,
2025-09-06,Jay Snowden,PENN Entertainment,18,19,3,40,
2025-09-06,George Kurian,NetApp,15,22,3,40,
2025-09-06,Kevin Ali,Organon,9,20,1,30,
2025-09-06,Joel D Anderson,Petco Health and Wellness,3,8,0,11,
2025-09-06,Louis V Pinkham,Regal Rexnord,0,0,0,0,
2025-09-06,Jay Geldmacher,Resideo Technologies,9,6,1,16,
2025-09-06,Marcus Lemonis,Camping World,5,24,11,40,
2025-09-06,Peter R Huntsman,Huntsman,7,11,4,22,
2025-09-06,Hillary Super,Victorias Secret,11,5,8,24,
2025-09-06,Michelle Gass,Levi Strauss,13,23,3,39,
2025-09-06,Neil Hunn,Roper Technologies,3,20,0,23,
2025-09-06,Steven P Lawrence,Academy Sports and Outdoors,1,1,0,2,
2025-09-06,Phillippe Lord,Meritage Homes,8,15,0,23,
2025-09-06,David C Dauch,American Axle & Manufacturing,5,6,2,13,
2025-09-06,Olumide Soroye,Fortive,1,8,0,9,
2025-09-06,Adena Friedman,Nasdaq,15,21,4,40,
2025-09-06,Tim Gokey,Broadridge Financial Solutions,3,11,1,15,
2025-09-06,Patrick M Shanahan,Spirit AeroSystems,1,9,0,10,
2025-09-06,Robert Kyncl,Warner Music Group,9,30,1,40,
2025-09-06,Denise Dignam,Chemours,2,18,3,23,
2025-09-06,Jim DeVries,ADT,10,6,1,17,
2025-09-06,Bernard Zovighian,Edwards Lifesciences,7,6,2,15,
2025-09-06,Mark E Seaton,First American Financial,1,9,0,10,
2025-09-06,John C Roche,Hanover Insurance Group,8,19,1,28,
2025-09-06,Adam J Greenlee,Silgan,0,4,0,4,
2025-09-06,Jayne Hrdlicka,Endeavor Group,0,1,0,1,
2025-09-06,Robert Fauber,Moodys Corporation,0,5,0,5,
2025-09-06,Thomas E Jorden,Coterra Energy,8,0,0,8,
2025-09-06,Eugene A Hall,Gartner,1,9,0,10,
2025-09-06,Kevin Plank,Under Armour,7,29,4,40,
2025-09-06,James W Lanning,Ingles Markets,3,3,0,6,
2025-09-06,Matthew T Farrell,Church & Dwight,7,7,0,14,
2025-09-06,Kevin M Freeman,Old Dominion Freight Line,0,0,0,0,
2025-09-06,Joe Shoen,U-Haul,14,22,4,40,
2025-09-06,Mark Bertolini,Oscar Health,12,19,9,40,
2025-09-06,Jayshree Ullal,Arista Networks,22,17,1,40,
2025-09-06,Sassine Ghazi,Synopsys,9,28,3,40,
2025-09-06,Jochen Zeitz,Harley-Davidson,6,24,10,40,
2025-09-06,Nick Jeffery,Frontier Communications,10,25,2,37,
2025-09-06,Thomas Edward McCormick,Primoris Services,0,4,0,4,
2025-09-06,D Christian Koch,Carlisle Companies,1,4,1,6,
2025-09-06,David E Simon,Simon Property Group,2,5,3,10,
2025-09-06,Stephen Bratspies,Hanesbrands,3,11,1,15,
2025-09-06,Ryan M. Schneider,Anywhere Real Estate Inc,0,2,0,2,
2025-09-06,George Bobb III,Teledyne Technologies,1,4,1,6,
2025-09-06,Terrence A Duffy,CME Group,6,9,1,16,
2025-09-06,Rami Rahim,Juniper Networks,10,28,2,40,
2025-09-06,Sue Nabi,Coty,17,17,6,40,
2025-09-06,Peter D Arvan,Pool Corporation,2,7,0,9,
2025-09-06,David Campbell,Evergy,13,8,0,21,
2025-09-06,Matthew J Murphy,Marvell Technology,5,4,1,10,
2025-09-06,Lloyd Yates,NiSource,6,4,0,10,
2025-09-06,William C Stone,SS&C Technologies,2,6,0,8,
2025-09-06,Mark Rourke,Schneider National,10,19,1,30,
2025-09-06,Andrew Anagnost,Autodesk,9,24,7,40,
2025-09-06,Dustin Semach,Sealed Air Corporation,0,9,0,9,
2025-09-06,William L Meaney,Iron Mountain,2,18,0,20,
2025-09-06,Andy P Power,Digital Realty Trust,0,0,0,0,
2025-09-06,Satish Dhanasekaran,Keysight Technologies,2,11,0,13,
2025-09-06,Frank M Svoboda,Globe Life,3,4,3,10,
2025-09-06,Carey A Smith,Parsons Corporation,1,3,0,4,
2025-09-06,Ynon Kreiz,Mattel,7,26,7,40,
2025-09-06,Karen S Haller,Southwest Gas,3,6,0,9,
2025-09-06,Terrance Williams,TruStage,4,6,1,11,
2025-09-06,Eric W Gerstenberg,Clean Harbors,4,2,1,7,
2025-09-06,Gunner Smith,Cornerstone Building Brands,1,8,0,9,
2025-09-06,Gerben W Bakker,Hubbell,1,4,0,5,
2025-09-06,Dave Davis,Spirit Airlines,5,23,3,31,
2025-09-06,Michael J Smith,Lamb Weston,0,7,3,10,
2025-09-06,Strauss Zelnick,Take-Two Interactive Software,14,17,9,40,
2025-09-06,John C Turner Jr,GMS,2,8,0,10,
2025-09-06,David M O'Malley,Penn Mutual Life Insurance,1,3,0,4,
2025-09-06,Frank A Lonegro,Landstar System,3,3,0,6,
2025-09-06,James F Risoleo,Host Hotels & Resorts,6,16,0,22,
2025-09-06,Ken Xie,Fortinet,13,20,7,40,
2025-09-06,Doug Shulman,OneMain,3,7,0,10,
2025-09-06,Ryan Cohen,GameStop,11,21,8,40,
2025-09-06,Mark W Begor,Equifax,3,12,0,15,
2025-09-06,Jay L Schottenstein,American Eagle Outfitters,12,16,1,29,
2025-09-06,Curtis C Farmer,Comerica,4,9,0,13,
2025-09-06,Ole Rosgaard,Greif,3,17,1,21,
2025-09-06,Brian E Lane,Comfort Systems USA,9,0,0,9,
2025-09-06,Robert M Buck,TopBuild,0,5,1,6,
2025-09-06,Ralph Andretta,Bread Financial,3,9,0,12,
2025-09-06,Jim Anderson,Coherent,6,34,0,40,
2025-09-06,Walter C. D. Carlson,Telephone & Data Systems,0,2,0,2,
2025-09-06,Ronald Kruszewski,Stifel Financial,7,5,0,12,
2025-09-06,Richard Hayne,Urban Outfitters,11,21,8,40,
2025-09-06,Simon Meester,Terex,3,7,0,10,
2025-09-06,Edward J Lehner,Ryerson Holding,0,2,1,3,
2025-09-06,Nicholas T Pinchuk,Snap-on,3,5,0,8,
2025-09-06,Ryals McMullian,Flowers Foods,5,28,3,36,
2025-09-06,D Bryan Jordan,First Horizon,4,8,1,13,
2025-09-06,John B Gibson,Paychex,3,6,0,9,
2025-09-06,Chris Cocks,Hasbro,13,18,9,40,
2025-09-06,Pete McPartland,Sentry Insurance Group,0,2,0,2,
2025-09-06,Michael Arougheti,Ares Management,17,22,1,40,
2025-09-06,Alok Maskara,Lennox International,5,4,1,10,
2025-09-06,James C Grech,Peabody Energy,3,0,0,3,
2025-09-06,Joseph P Lacher Jr,Kemper,4,18,4,26,
2025-09-06,Perry A Sook,Nexstar Media Group,7,29,1,37,
2025-09-06,Wade Davis,TelevisaUnivision,14,25,1,40,
2025-09-06,Scott L Thompson,Tempur Sealy International,0,7,0,7,
2025-09-06,Mike Simonds,TriNet Group,0,9,0,9,
2025-09-06,B Andrew Rose,Worthington Enterprises,1,2,0,3,
2025-09-06,Bruce L Caswell,Maximus,5,4,0,9,
2025-09-06,Robert L Reffkin,Compass,1,6,0,7,
2025-09-06,Mark Eubanks,Brinks Company,1,2,1,4,
2025-09-06,Peter Quigley,Kelly Services inc,2,8,0,10,
2025-09-06,David L Yowan,Navient,2,3,0,5,
2025-09-06,Mary E Kipp,Puget Sound Energy,4,0,2,6,
2025-09-06,Adam Aron,AMC Entertainment,18,14,8,40,
2025-09-06,Mark J Tarr,Encompass Health,2,6,1,9,
2025-09-06,Liam K Griffin,Skyworks Solutions,1,6,1,8,
2025-09-06,Richard G Kyle,Timken,6,18,1,25,
2025-09-06,Ron Gusek,Liberty Energy,20,1,0,21,
2025-09-06,John E Geller Jr,Marriott Vacations Worldwide,6,5,0,11,
2025-09-06,Karl G. Glassman,Leggett & Platt,0,4,0,4,
2025-09-06,Bruce K Thorn,Big Lots,3,5,2,10,
2025-09-06,Jonathan H Weis,Weis Markets,11,28,0,39,
2025-09-06,Jeffrey B Guldner,Pinnacle West Capital,1,4,0,5,
2025-09-06,Arkadiy Dobkin,EPAM Systems,11,17,1,29,
2025-09-06,Paul M Rady,Antero Resources,4,8,0,12,
2025-09-06,Michael Spanos,Bloomin Brands,1,9,1,11,
2025-09-06,Nicole A Kivisto,MDU Resources Group,1,4,0,5,
2025-09-06,Gerald L Morgan,Texas Roadhouse,3,3,4,10,
2025-09-06,Gabriel Tirador,Mercury General,4,4,2,10,
2025-09-06,Nicholas I Fink,Fortune Brands Innovations,4,5,0,9,
2025-09-06,Paul E Burdiss,Zions Bancorp,1,1,0,2,
2025-09-06,William J Christensen,JELD-WEN Holding,4,5,0,9,
2025-09-06,Evan Spiegel,Snap Inc,18,19,3,40,
2025-09-06,Bill Burns,Zebra Technologies,7,25,1,33,
2025-09-06,Steven Sell,Agilon Health,1,7,2,10,
2025-09-06,Richard M Olson,Toro Company,1,16,0,17,
2025-09-06,Eric S Yuan,Zoom Video Communications,6,6,0,12,
2025-09-06,Dan L Batrack,Tetra Tech,2,3,1,6,
2025-09-06,Joseph D Russell Jr,Public Storage,0,8,0,8,
2025-09-06,Jacob Thaysen,Illumina inc,5,7,0,12,
2025-09-06,Debra A Cafaro,Ventas inc,7,5,0,12,
2025-09-06,Pierre R Brondeau,FMC Corporation,1,4,1,6,
2025-09-06,Judy R McReynolds,ArcBest,6,15,1,22,
2025-09-06,Russell J Weiner,Dominos Pizza inc,0,0,0,0,
2025-09-06,Theodore S Hanson,ASGN,0,1,0,1,
2025-09-06,RJ Scaringe,Rivian Automotive,10,26,4,40,
2025-09-06,Jeffrey N Simmons,Elanco Animal Health,2,5,1,8,
2025-09-06,Tim O Shaughnessy,Graham Holdings Company,3,6,0,9,
2025-09-06,Thomas V Taylor,Floor & Decor,1,1,2,4,
2025-09-06,Neil A Schrimsher,Applied Industrial Technologies,5,25,1,31,
2025-09-06,Robert E Price,PriceSmart,4,6,0,10,
2025-09-06,John David Risher,Lyft,3,4,1,8,
2025-09-06,Gary B Smith,Ciena,4,8,0,12,
2025-09-06,Joey Levin,IAC,6,30,1,37,
2025-09-06,Jim Jacobs,Country Financial,7,3,2,12,
2025-09-06,Devin B McGranahan,Western Union,1,6,0,7,
2025-09-06,R Scott Rowe,Flowserve,5,4,1,10,
2025-09-06,Kenneth A Vecchione,Western Alliance Bancorp,0,0,1,1,
2025-09-06,John C Rademacher,Option Care Health,10,1,0,11,
2025-09-06,Doug Black,SiteOne Landscape Supply,2,22,2,26,
2025-09-06,Oliver G Brewer III,Topgolf Callaway Brands,1,0,0,1,
2025-09-06,Glenn Sanford,eXp World,15,22,3,40,
2025-09-06,Fran Horowitz,Abercrombie & Fitch,15,18,7,40,
2025-09-06,Kevin Akers,Atmos Energy,7,2,1,10,
2025-09-06,Alessandro Maselli,Catalent,4,11,2,17,
2025-09-06,J Powell Brown,Brown & Brown,11,22,7,40,
2025-09-06,Aman Bhutani,GoDaddy,17,21,2,40,
2025-09-06,John C. Griffith,American Water Works,0,3,0,3,
2025-09-06,John J Marchioni,Selective Insurance Group,4,12,4,20,
2025-09-06,Lawson E Whiting,Brown-Forman,1,7,2,10,
2025-09-06,Dave Peacock,Advantage Solutions,20,8,0,28,
2025-09-06,Mick Farrell,ResMed,16,22,1,39,
2025-09-06,Kamal Hathi,Splunk,1,5,0,6,
2025-09-06,Todd Kelsey,Plexus,2,7,0,9,
2025-09-06,Phillip D Yeager,Hub Group,3,6,0,9,
2025-09-06,Steven B Hedlund,Lincoln Electric,5,10,0,15,
2025-09-06,Timothy C Oliver,NCR Atleos,0,1,0,1,
2025-09-06,Bruce Fleming,Calumet,2,7,0,9,
2025-09-06,Daniel S. Peyovich,Dycom Industries,1,4,0,5,
2025-09-06,Avner M Applbaum,Valmont Industries,0,9,0,9,
2025-09-06,Kimberly A Fields,ATI inc,5,10,0,15,
2025-09-06,Khozema Z Shipchandler,Twilio,0,2,0,2,
2025-09-06,Gary C Bhojwani,CNO Financial Group,2,6,1,9,
2025-09-06,William Andrew Hendricks Jr,Patterson-UTI Energy,0,0,0,0,
2025-09-06,Kevin D Hochman,Brinker International,1,4,1,6,
2025-09-06,James C Foster,Charles River Laboratories International,2,8,1,11,
2025-09-06,Rajiv K Prasad,Hyster-Yale,2,5,0,7,
2025-09-06,Eric T Steigerwalt,Brighthouse Financial,1,2,0,3,
2025-09-06,Thomas L Ryan,Service Corp International,6,4,0,10,
2025-09-06,Charles M Nifong Jr,CrossAmerica Partners,0,0,0,0,
2025-09-06,Anirudh Devgan,Cadence,10,25,3,38,
2025-09-06,Andi Owen,MillerKnoll,15,17,8,40,
2025-09-06,Sumit Roy,Realty Income,14,20,2,36,
2025-09-06,Timothy John Fitzgerald,Middleby,0,0,0,0,
2025-09-06,Robert H Schottenstein,M/I Homes,1,10,0,11,
2025-09-06,Stephen P MacMillan,Hologic,1,8,0,9,
2025-09-06,Lisa M Barton,Alliant Energy,4,0,0,4,
2025-09-06,Aaron P Jagdfeld,Generac,1,6,0,7,
2025-09-06,Erik Gershwind,MSC Industrial Direct,3,5,2,10,
2025-09-06,Varun Krishna,Rocket Companies,7,32,1,40,
2025-09-06,Fahmi Karam,Upbound Group,5,4,0,9,
2025-09-06,NADominic Ng,East West Bancorp,0,0,0,0,
2025-09-06,Mark Wang,Hilton Grand Vacations,38,2,0,40,
2025-09-06,Robert J Sheedy Jr,Grocery Outlet Holding,0,0,0,0,
2025-09-06,Simon D Campion,Dentsply Sirona,0,4,0,4,
2025-09-06,Jeremy Wensinger,V2X,7,9,0,16,
2025-09-06,Andrew Rees,Crocs,15,15,10,40,
2025-09-06,David M Maura,Spectrum Brands,6,1,0,7,
2025-09-06,Sachin S Lawande,Visteon,0,0,0,0,
2025-09-06,Neil M Ashe,Acuity Inc,0,1,0,1,
2025-09-06,Lorie L Tekorius,Greenbrier,2,8,0,10,
2025-09-06,John R Ciulla,Webster Financial,5,5,0,10,
2025-09-06,Sean D Keohane,Cabot Corporation,4,3,0,7,
2025-09-06,Drew M Wilkerson,RXO inc,0,0,0,0,
2025-09-06,Daniel E Brown,Chord Energy,1,1,0,2,
2025-09-06,Javier D Ferrer Fernandez,Popular inc,0,0,0,0,
2025-09-06,Olivier Rabiller,Garrett Motion inc,4,9,0,13,
2025-09-06,Ronald N Tutor,Tutor Perini Corporation,3,6,0,9,
2025-09-06,Jeff Liaw,Copart,4,5,1,10,
2025-09-06,Aman Narang,Toast inc,3,6,2,11,
2025-09-06,Joseph M Hogan,Align Technology,2,5,0,7,
2025-09-06,Kevin J Wheeler,A O Smith,0,16,1,17,
2025-09-06,Christopher A Cartwright,TransUnion,2,0,2,4,
2025-09-06,James Kelly,NCR Voyix,2,12,1,15,
2025-09-06,Tom Leighton,Akamai Technologies,14,15,6,35,
2025-09-06,Robert G Painter,Trimble,8,2,0,10,
2025-09-06,Tony Helton,Medical Mutual of Ohio,2,4,1,7,
2025-09-06,Caroline S Grace,AMN Healthcare Services,0,0,0,0,
2025-09-06,Patrick Kaltenbach,Mettler-Toledo International,3,5,0,8,
2025-09-06,Michael L Baur,ScanSource,0,3,0,3,
2025-09-06,Jason Lippert,LCI Industries,1,11,0,12,
2025-09-06,Fredric J Tomczyk,Cboe Global Markets,1,7,0,8,
2025-09-06,Octavio Marquez,Diebold Nixdorf,5,10,1,16,
2025-09-06,Sivasankaran Somasundaram,ChampionX,8,2,0,10,
2025-09-06,Ronald F Clarke,Corpay,0,1,0,1,
2025-09-06,Robert W Pittman,iHeartMedia,5,3,0,8,
2025-09-06,Patrick Zalupski,Dream Finders Homes,22,16,2,40,
2025-09-06,Keith E Smith,Boyd Gaming,1,6,1,8,
2025-09-06,Mehran Assadi,NLV Financial,1,1,0,2,
2025-09-06,Barry R Port,Ensign Group,3,4,2,9,
2025-09-06,Denise A Paulonis,Sally Beauty,1,2,0,3,
2025-09-06,Clifford A Skelton,Conduent,0,1,0,1,
2025-09-06,Jean-Michel Ribieras,Sylvamo,2,7,0,9,
2025-09-06,Douglas F Bauer,Tri Pointe Homes,0,5,0,5,
2025-09-06,Shawn O'Connell,EnerSys,2,5,0,7,
2025-09-06,Bill Meury,Incyte,7,15,0,22,
2025-09-06,Dale Francescon,Century Communities,3,9,3,15,
2025-09-06,Michael Nierenberg,Rithm Capital,10,28,2,40,
2025-09-06,Michael J Brown,Euronet Worldwide,2,8,0,10,
2025-09-06,Scott Seu,Hawaiian Electric Industries,5,17,3,25,
2025-09-06,Jason D Robins,DraftKings,5,2,0,7,
2025-09-06,Jonathan J Mazelsky,IDEXX Laboratories,1,2,1,4,
2025-09-06,Richard S Swartz,MYR Group,0,2,0,2,
2025-09-06,Stefano Caroti,Deckers Outdoor,1,8,1,10,
2025-09-06,Kevin R Sayer,DexCom,3,3,0,6,
2025-09-06,John T C Lee,MKS Instruments,3,9,1,13,
2025-09-06,Edward B Pitoniak,VICI Properties,1,8,0,9,
2025-09-06,Albert White III,Cooper Cos,0,0,0,0,
2025-09-06,Barry L Biffle,Frontier Airlines,1,5,6,12,
2025-09-06,Robert A Bruggeworth,Qorvo,5,4,0,9,
2025-09-06,Winnie Park,Five Below,8,28,4,40,
2025-09-06,Steven Oakland,TreeHouse Foods,3,14,0,17,
2025-09-06,James S Hagedorn,Scotts Miracle-Gro,1,0,0,1,
2025-09-06,Michael Cannon-Brookes,Atlassian,16,24,0,40,
2025-09-06,Bertrand Loy,Entegris,3,12,1,16,
2025-09-06,William E Waltz,Atkore,2,8,0,10,
2025-09-06,Celeste B Mastin,H B Fuller,1,3,0,4,
2025-09-06,Kyle T Larkin,Granite Construction,1,7,0,8,
2025-09-06,Michael J Happe,Winnebago Industries,1,2,0,3,
2025-09-06,Steven H Gunby,FTI Consulting,5,10,0,15,
2025-09-06,Stephan B Tanda,AptarGroup,0,4,3,7,
2025-09-06,Timothy P Boyle,Columbia Sportswear,3,4,2,9,
2025-09-06,Anthony J Wood,Roku,5,3,1,9,
2025-09-06,M Christopher Doyle,Civitas Resources,1,2,0,3,
2025-09-06,Andy Eidson,Alpha Metallurgical Resources,1,6,1,8,
2025-09-06,Andy L Nemeth,Patrick Industries,4,1,0,5,
2025-09-06,Roger W Jenkins,Murphy Oil,4,16,0,20,
2025-09-06,Kevin S Blair,Synovus Financial,6,3,1,10,
2025-09-06,Julie Felss Masino,Cracker Barrel Old Country Store,6,20,14,40,
2025-09-06,David M Overton,Cheesecake Factory,1,9,0,10,
2025-09-06,Nick DeIuliis,CNX Resources,7,4,0,11,
2025-09-06,Christopher Pappas,Chefs Warehouse,4,10,1,15,
2025-09-06,Tod Carpenter,Donaldson Company,2,7,0,9,
2025-09-06,Gregory L Christopher,Mueller Industries,2,6,0,8,
2025-09-06,Rob Saltiel,MRC Global,7,12,2,21,
2025-09-06,Jillian C Evanko,Chart Industries,3,6,0,9,
2025-09-06,Dave Guilmette,Alight Solutions,3,7,0,10,
2025-09-06,Joel Smejkal,Vishay Intertechnology,4,5,1,10,
2025-09-06,Dennis Degner,Range Resources,3,8,0,11,
2025-09-06,Ira D Robbins,Valley National Bancorp,1,2,0,3,
2025-09-06,Bernard Kim,Match Group,15,19,6,40,
2025-09-06,Vincent Pilette,Gen Digital,2,14,0,16,
2025-09-06,Timothy S Crane,Wintrust Financial,2,7,0,9,
2025-09-06,Pat Roche,Moog inc,4,11,2,17,
2025-09-06,Mark R Widmar,First Solar,2,8,1,11,
2025-09-06,Niko Lahanas,Central Garden & Pet,1,12,0,13,
2025-09-06,Chris Osowski,Green Plains inc,8,13,1,22,
2025-09-06,Derek J Leathers,Werner Enterprises,2,7,0,9,
2025-09-06,Adam Foroughi,AppLovin,10,26,4,40,
2025-09-06,Luca Savi,ITT,3,8,0,11,
2025-09-06,Lawrence H Silber,Herc Rentals,0,0,0,0,
2025-09-06,Hilton H Howell Jr,Gray Television,7,21,1,29,
2025-09-06,Eric D Ashleman,IDEX,0,9,1,10,
2025-09-06,Owen D Thomas,Boston Properties,3,7,0,10,
2025-09-06,Kurt Wolf,Pitney Bowes,7,19,2,28,
2025-09-06,Sara E Armbruster,Steelcase,2,0,0,2,
2025-09-06,Charles D. Young,Sun Communities,2,5,0,7,
2025-09-06,Suzanne Foster,AdaptHealth,5,7,1,13,
2025-09-06,Grant E Sims,Genesis Energy,2,2,0,4,
2025-09-06,Laura Prieskorn,Jackson Financial,3,5,2,10,
2025-09-06,Rick L Wessel,FirstCash,4,5,1,10,
2025-09-06,Sherman Miller,Cal-Maine Foods,11,29,0,40,
2025-09-06,Paul A Lang,Arch Resources,5,3,1,9,
2025-09-06,Ashish K Khandpur,Avient,2,6,0,8,
2025-09-06,Shyam K Reddy,BlueLinx,1,7,0,8,
2025-09-06,Christopher S Ripley,Sinclair,1,7,0,8,
2025-09-06,Stacy Kymes,BOK Financial,8,6,0,14,
2025-09-06,James H Walter,Permian Resources,0,1,0,1,
2025-09-06,Jason Murray,PACS Group,5,14,2,21,
2025-09-06,Brian Armstrong,Coinbase Global,11,23,6,40,
2025-09-06,Oscar K Brown,Western Midstream Partners,1,3,0,4,
2025-09-06,Nicholas R Lower,Federated Mutual Insurance,0,1,0,1,
2025-09-06,Morris Goldfarb,G-III Apparel Group,9,25,6,40,
2025-09-06,Mark D Morelli,Vontier,0,4,0,4,
2025-09-06,Matthew J Cox,Matson inc,0,6,0,6,
2025-09-06,David W Grzebinski,Kirby Corporation,1,3,0,4,
2025-09-06,Keith A Harvey,Kaiser Aluminum,3,4,2,9,
2025-09-06,Eric Nyman,Vista Outdoor,4,11,1,16,
2025-09-06,Doug Howe,Designer Brands,4,20,0,24,
2025-09-06,Jerry E Gahlhoff Jr,Rollins inc,0,2,0,2,
2025-09-06,D Scott Barbour,Advanced Drainage Systems,2,2,0,4,
2025-09-06,Sean Gamble,Cinemark,18,21,1,40,
2025-09-06,George Kurtz,CrowdStrike,17,20,3,40,
2025-09-06,Bill Ready,Pinterest,25,15,0,40,
2025-09-06,Fidji Simo,Instacart,10,29,1,40,
2025-09-06,Kimberly K Ryan,Hillenbrand,3,5,0,8,
2025-09-06,David S Graziosi,Allison Transmission,1,17,3,21,
2025-09-06,Gary G Friedman,Restoration Hardware,1,4,0,5,
2025-09-06,Lucinda M Baier,Brookdale Senior Living,3,5,0,8,
2025-09-06,Brian J Blaser,QuidelOrtho,1,8,0,9,
2025-09-06,E Jean Savage,Trinity Industries,1,8,1,10,
2025-09-06,Liam J Kelly,Teleflex,1,4,1,6,
2025-09-06,Laurans A Mendelson,HEICO,8,18,1,27,
2025-09-06,Frank H Laukien,Bruker,1,9,0,10,
2025-09-06,Harvey M Schwartz,Carlyle Group,5,14,0,19,
2025-09-06,Mark S LaVigne,Energizer,2,0,0,2,
2025-09-06,Joel Quadracci,Quad/Graphics,12,23,5,40,
2025-09-06,Amar Maletira,Rackspace Technology,6,12,2,20,
2025-09-06,Udit Batra,Waters Corporation,10,26,1,37,
2025-09-06,Eric M Green,West Pharmaceutical Services,1,9,0,10,
2025-09-06,Doug Palladini,Carters inc,2,2,2,6,
2025-09-06,G Mike Mikan,NeueHealth,4,2,0,6,
2025-09-06,Russell ChipChilds,SkyWest,0,0,0,0,
2025-09-06,Christopher H Hunter,Acadia Healthcare,0,1,0,1,
2025-09-06,Prahlad Singh,Revvity,2,7,0,9,
2025-09-06,Maria M Pope,Portland General Electric,1,1,0,2,
2025-09-06,Charles Chip Blankenship,Woodward inc,0,1,0,1,
2025-09-06,Mike Steib,TEGNA,14,20,1,35,
2025-09-06,Kurt J Ekert,Sabre Corporation,0,1,0,1,
2025-09-06,Matt Wilson,Light & Wonder,17,19,4,40,
2025-09-06,Rob Katz,Vail Resorts,4,12,24,40,
2025-09-06,Schnitzer Steel Industries,Radius Recycling,9,25,6,40,
2025-09-06,David A Spector,PennyMac Financial Services,3,1,0,4,
2025-09-06,Frederick J Holzgrefe III,Saia inc,1,1,0,2,
2025-09-06,Mark J Parrell,Equity Residential,4,6,0,10,
2025-09-06,John W Lindsay,Helmerich & Payne,0,4,0,4,
2025-09-06,Gary D Burnison,Korn Ferry,4,15,0,19,
2025-09-06,Timothy J McGrath,PC Connection Inc,1,2,0,3,
2025-09-06,Lynn M Bamford,Curtiss-Wright,12,8,0,20,
2025-09-06,Jonathan W Witter,Sallie Mae,0,1,0,1,
2025-09-06,Jeff Benck,Benchmark Electronics,9,8,0,17,
2025-09-06,Charles H Giancarlo,Pure Storage,0,3,0,3,
2025-09-06,Brian R Gray,Knife River Corporation,0,1,0,1,
2025-09-06,Jay Schmidt,Caleres inc,2,5,2,9,
2025-09-06,Dale Asplund,BrightView Holdings,0,5,0,5,
2025-09-06,Jeffrey S Edwards,Cooper-Standard,0,5,0,5,
2025-09-06,Glenn J Williams,Primerica,5,3,2,10,
2025-09-06,Francois Locoh-Donou,F5,8,22,2,32,
2025-09-06,Joseph Wm Foran,Matador Resources,7,11,0,18,
2025-09-06,Sridhar Ramaswamy,Snowflake inc,10,26,4,40,
2025-09-06,Mark D Dankberg,Viasat,2,4,3,9,
2025-09-06,Francisco J Leon,California Resources,1,4,1,6,
2025-09-06,Peter Stern,Peloton,19,17,4,40,
2025-09-06,David Baszucki,Roblox,10,21,9,40,
2025-09-06,Jeffrey W Edwards,Installed Building Products,0,2,0,2,
2025-09-06,Clark Lauritzen,First National of Nebraska,1,7,0,8,
2025-09-06,Carlos Alberini,Guess inc,12,27,1,40,
2025-09-06,Shyam P Kambeyanda,ESAB,3,4,0,7,
2025-09-06,Edmund Shallcross III,Amica Mutual Insurance,1,5,0,6,
2025-09-06,Benjamin W Schall,AvalonBay Communities,1,6,1,8,
2025-09-06,Allan C Thygesen,DocuSign,3,7,0,10,
2025-09-06,Bryan J Knutson,Titan Machinery,1,3,1,5,
2025-09-06,Heath Sampson,ModivCare,7,2,0,9,
2025-09-06,Ara K Hovnanian,Hovnanian Enterprises,1,16,1,18,
2025-09-06,Joshua G Silverman,Etsy,2,2,0,4,
2025-09-06,Kevin Roycraft,Adams Resources & Energy,5,4,1,10,
2025-09-06,J Eric Evans,Surgery Partners,1,2,0,3,
2025-09-06,Clint E Stein,Columbia Banking System,1,7,0,8,
2025-09-06,Lee M Shavel,Verisk Analytics,3,7,0,10,
2025-09-06,Dave Banyard Jr,MasterBrand,0,0,0,0,
2025-09-06,Peter R Ingram,Hawaiian Airlines inc,1,0,0,1,
2025-09-06,Kristin A Dolan,AMC Networks,3,2,0,5,
2025-09-06,Brendan T Cavanagh,SBA Communications,1,2,0,3,
2025-09-06,George F Chappelle Jr,Americold Realty Trust,1,3,0,4,
2025-09-06,Thomas E Gottwald,NewMarket Corporation,2,7,0,9,
2025-09-06,Thomas J Baltimore Jr,Park Hotels & Resorts,4,30,0,34,
2025-09-06,Peter M Moglia,Alexandria Real Estate Equities,2,6,0,8,
2025-09-06,Ronald J Kramer,Griffon Corporation,1,6,0,7,
2025-09-06,John L Plueger,Air Lease,2,13,0,15,
2025-09-06,Jennifer F Scanlon,UL Solutions,1,4,0,5,
2025-09-06,Greg Smith,Teradyne,2,9,2,13,
2025-09-06,Sean Trauschke,OGE Energy,19,5,0,24,
2025-09-06,Norman D Schwartz,Bio-Rad Laboratories,0,1,1,2,
2025-09-06,Scott Doyle,Spire inc,4,5,1,10,
2025-09-06,Michael E Reed,Gannett,0,5,2,7,
2025-09-06,Cindy J Miller,Stericycle,2,5,1,8,
2025-09-06,Phillip D Green,Cullen Frost Bankers,1,5,3,9,
2025-09-06,Joseph D Margolis,Extra Space Storage,0,9,1,10,
2025-09-06,Mark A Skonieczny,REV Group,6,3,1,10,
2025-09-06,Ladd Wilks,ProFrac Holding,4,2,0,6,
2025-09-06,Sundaram Nagarajan,Nordson,0,10,1,11,
2025-09-06,Anne P Noonan,Summit Materials,0,0,0,0,
2025-09-06,Lori Flees,Valvoline inc,4,5,1,10,
2025-09-06,Scott H Baxter,Kontoor Brands,2,2,0,4,
2025-09-06,Tim Larson,Skyline Champion,7,0,0,7,
2025-09-06,Chuck Divita,Teladoc Health,10,20,5,35,
2025-09-06,W Bradley Southern,Louisiana-Pacific Corporation,0,0,0,0,
2025-09-06,George C Freeman III,Universal Corporation,3,5,0,8,
2025-09-06,James A Brock,Consol Energy,2,0,0,2,
2025-09-06,Robert Antokol,Playtika Holding,0,8,1,9,
2025-09-06,Joe Craft,Alliance Resource Partners,7,9,2,18,
2025-09-06,Paul Keel,Envista,1,7,1,9,
2025-09-06,Jared Isaacman,Shift4 Payments,6,28,6,40,
2025-09-06,Mark Mac McFarland,Talen Energy,3,1,1,5,
2025-09-06,Tony R Thene,Carpenter Technology,2,9,0,11,
2025-09-06,Melissa D Smith,WEX,1,7,1,9,
2025-09-06,James Jim C Ryan III,Old National Bancorp,1,0,0,1,
2025-09-06,Peter J Federico,AGNC Investment,1,0,0,1,
2025-09-06,Brent L Yeagy,Wabash National,0,0,0,0,
2025-09-06,Henry A Fernandez,MSCI,3,14,0,17,
2025-09-06,Mark Penn,Stagwell,14,22,3,39,
2025-09-06,Julie Schertell,Mativ,3,9,0,12,
2025-09-06,Ashish Chand,Belden,3,6,1,10,
2025-09-06,Greg Anderson,Allegiant Travel Company,5,8,0,13,
2025-09-06,Drew Houston,Dropbox,14,19,7,40,
2025-09-06,Kevin T Conroy,Exact Sciences,1,6,2,9,
2025-09-06,Rex D Geveden,BWX Technologies,4,7,0,11,
2025-09-06,Scott R Wells,Clear Channel Outdoor Hldgs,0,0,0,0,
2025-09-06,Paul Bay,Ingram Micro,10,25,5,40,
2025-09-07,Doug McMillon,Walmart,16,17,7,40,
2025-09-07,Andrew Jassy,Amazon,4,31,5,40,
2025-09-07,Tim Cook,Apple,13,23,4,40,
2025-09-07,Stephen Hemsley,UnitedHealth,8,27,5,40,
2025-09-07,Warren Buffett,Berkshire Hathaway,9,20,11,40,
2025-09-07,David Joyner,CVS Health,7,28,5,40,
2025-09-07,Darren Woods,Exxon Mobil,9,25,5,39,
2025-09-07,Sundar Pichai,Alphabet,18,15,7,40,
2025-09-07,Brian Tyler,McKesson,5,15,6,26,
2025-09-07,Robert Mauch,Cencora,3,7,0,10,
2025-09-07,Ron Vachris,Costco,7,31,2,40,
2025-09-07,Jamie Dimon,JPMorgan Chase,12,18,10,40,
2025-09-07,Satya Nadella,Microsoft,16,21,3,40,
2025-09-07,Jason Hollar,Cardinal Health,14,22,4,40,
2025-09-07,Mike Wirth,Chevron,16,17,7,40,
2025-09-07,David Cordani,Cigna,21,15,4,40,
2025-09-07,Jim Farley,Ford Motor,14,19,7,40,
2025-09-07,Brian Moynihan,Bank of America,7,28,5,40,
2025-09-07,Mary Barra,General Motors,13,21,6,40,
2025-09-07,Gail Boudreaux,Elevance Health,16,17,7,40,
2025-09-07,Jane Fraser,Citigroup,13,21,6,40,
2025-09-07,Sarah London,Centene,14,17,9,40,
2025-09-07,Ted Decker,Home Depot,14,22,4,40,
2025-09-07,Maryann Mannen,Marathon Petroleum,6,15,1,22,
2025-09-07,Ron Sargent,Kroger,5,22,13,40,
2025-09-07,Mark Lashier,Phillips 66,11,19,8,38,
2025-09-07,Priscilla Almodovar,Fannie Mae,10,15,15,40,
2025-09-07,Tim Wentworth,Walgreens,8,23,9,40,
2025-09-07,Lane Riggs,Valero Energy,13,8,0,21,
2025-09-07,Mark Zuckerberg,Meta,6,26,8,40,
2025-09-07,Hans Vestberg,Verizon,15,20,5,40,
2025-09-07,John Stankey,AT&T,11,24,5,40,
2025-09-07,Brian Roberts,Comcast,10,27,3,40,
2025-09-07,Charles Scharf,Wells Fargo,26,7,7,40,
2025-09-07,David Solomon,Goldman Sachs,10,22,8,40,
2025-09-07,Michael Hutchins,Freddie Mac,3,10,4,17,
2025-09-07,Michael Fiddelke,Target,8,25,7,40,
2025-09-07,Jim Rechtin,Humana,19,16,5,40,
2025-09-07,Jon Farney,State Farm Insurance,1,15,3,19,
2025-09-07,Elon Musk,Tesla,7,29,4,40,
2025-09-07,Ted Pick,Morgan Stanley,15,21,4,40,
2025-09-07,Joaquin Duato,Johnson & Johnson,11,25,4,40,
2025-09-07,Juan Luciano,Archer Daniels Midland,3,20,17,40,
2025-09-07,Ramon Laguarta,PepsiCo,8,27,5,40,
2025-09-07,Carol Tom√©,UPS,5,23,12,40,
2025-09-07,Rajesh Subramaniam,FedEx,10,26,0,36,
2025-09-07,Bob Iger,Walt Disney,8,29,3,40,
2025-09-07,Michael Dell,Dell Technologies,11,26,3,40,
2025-09-07,Marvin Ellison,Lowes,15,23,1,39,
2025-09-07,Jon Moeller,Procter & Gamble,4,28,8,40,
2025-09-07,Thomas Long,Energy Transfer,7,0,2,9,
2025-09-07,Kelly Ortberg,Boeing,11,23,6,40,
2025-09-07,Susan Morris,Albertsons,13,24,3,40,
2025-09-07,Kevin Hourican,Sysco,8,28,4,40,
2025-09-07,Christopher Calio,RTX,7,11,0,18,
2025-09-07,Larry Culp,General Electric,10,27,3,40,
2025-09-07,James Taiclet,Lockheed Martin,13,19,8,40,
2025-09-07,Stephen Squeri,American Express,16,22,2,40,
2025-09-07,Joe Creed,Caterpillar,11,27,2,40,
2025-09-07,Michel Khalaf,MetLife,11,18,1,30,
2025-09-07,Samuel Hazen,HCA Healthcare,8,7,0,15,
2025-09-07,Tricia Griffith,Progressive Insurance,9,26,5,40,
2025-09-07,Arvind Krishna,IBM,13,21,6,40,
2025-09-07,John May,Deere,9,22,9,40,
2025-09-07,Jensen Huang,Nvidia,11,24,5,40,
2025-09-07,Philip Smith,StoneX,0,11,1,12,
2025-09-07,Robert M Davis,Merck,3,20,0,23,
2025-09-07,Ryan Lance,ConocoPhillips,13,22,5,40,
2025-09-07,Albert Bourla,Pfizer,25,10,5,40,
2025-09-07,Ed Bastian,Delta Air Lines,11,20,9,40,
2025-09-07,Patrick Zammit,TD Synnex,9,14,0,23,
2025-09-07,Kevin Murphy,Publix Super Markets,10,21,1,32,
2025-09-07,Thomas J Wilson,Allstate,1,7,1,9,
2025-09-07,Chuck Robbins,Cisco Systems,15,22,3,40,
2025-09-07,Kirt Walker,Nationwide Insurance,4,6,0,10,
2025-09-07,Christopher Winfrey,Charter Communications,4,16,5,25,
2025-09-07,Bob Michael,AbbVie,0,0,0,0,
2025-09-07,Craig DeSanto,New York Life Insurance,3,18,0,21,
2025-09-07,Lip-Bu Tan,Intel,9,19,12,40,
2025-09-07,Ernie Herrman,TJX,15,23,2,40,
2025-09-07,Andrew Sullivan,Prudential Financial,11,21,0,32,
2025-09-07,Enrique Lores,Hewlett Packard,11,18,6,35,
2025-09-07,Scott Kirby,United Airlines,35,3,2,40,
2025-09-07,George Holm,Performance Food,8,22,2,32,
2025-09-07,Donnie King,Tyson Foods,9,26,5,40,
2025-09-07,Robert Isom,American Airlines,8,25,7,40,
2025-09-07,Timothy M Sweeney,Liberty Mutual Insurance,12,0,0,12,
2025-09-07,Elliott Hill,Nike,7,32,1,40,
2025-09-07,Safra Catz,Oracle,12,20,8,40,
2025-09-07,AJ Jim Teague,Enterprise Products Partners,7,14,0,21,
2025-09-07,Richard Fairbank,Capital One,15,23,2,40,
2025-09-07,Wilfred Chiang,Plains GP,1,1,0,2,
2025-09-07,Michael Kasbar,World Kinect,2,10,0,12,
2025-09-07,Peter Zaffino,American International Group,9,27,4,40,
2025-09-07,James Quincey,The Coca-Cola Company,10,28,2,40,
2025-09-07,Thasunda Brown Duckett,TIAA,21,19,0,40,
2025-09-07,Jay Debertin,CHS,6,11,4,21,
2025-09-07,Chris Boerner,Bristol-Myers Squibb,11,23,6,40,
2025-09-07,Corie Barry,Best Buy,39,1,0,40,
2025-09-07,Marc Casper,Thermo Fisher Scientific,13,25,2,40,
2025-09-07,Roger Crandall,Mass Mutual,2,8,0,10,
2025-09-07,Juan Andrade,USAA,5,17,0,22,
2025-09-07,Phebe Novakovic,General Dynamics,27,10,3,40,
2025-09-07,Alan Schnitzer,Travelers Insurance,3,5,2,10,
2025-09-07,David Zaslav,Warner Bros Discovery,3,25,12,40,
2025-09-07,Gunjan Kedia,US Bancorp,14,24,2,40,
2025-09-07,Robert Ford,Abbott Laboratories,13,22,5,40,
2025-09-07,Kathy Warden,Northrop Grumman,13,23,4,40,
2025-09-07,Tim Gerend,Northwestern Mutual,13,26,1,40,
2025-09-07,Todd Vasos,Dollar General,8,26,6,40,
2025-09-07,Matthew Lucey,PBF Energy,5,3,1,9,
2025-09-07,Dara Khosrowshahi,Uber,11,22,7,40,
2025-09-07,Vimal Kapur,Honeywell,11,29,0,40,
2025-09-07,Dirk Van de Put,Mondelez,9,28,3,40,
2025-09-07,Brian Niccol,Starbucks,15,24,1,40,
2025-09-07,Cristiano Amon,Qualcomm,12,26,2,40,
2025-09-07,Hock Tan,Broadcom,13,25,2,40,
2025-09-07,David Flitman,US Foods,3,7,0,10,
2025-09-07,Paul Romanowski,DR Horton,5,16,5,26,
2025-09-07,Jacek Olczak,Philip Morris,14,23,3,40,
2025-09-07,Preston Feight,Paccar,7,25,1,33,
2025-09-07,Marc Benioff,Salesforce,7,22,11,40,
2025-09-07,Leon Topalian,Nucor,14,23,3,40,
2025-09-07,Michael Dastoor,Jabil,1,6,0,7,
2025-09-07,Jonathan Jaffe,Lennar,0,8,2,10,
2025-09-07,David Ricks,Eli Lilly,10,19,11,40,
2025-09-07,Joe Zubretsky,Molina Healthcare,7,5,4,16,
2025-09-07,Jennifer Rumsey,Cummins,7,27,6,40,
2025-09-07,Robin Vince,Bank of New York Mellon,20,18,2,40,
2025-09-07,Ted Sarandos,Netflix,13,24,3,40,
2025-09-07,William H Rogers Jr,Truist Financial,3,6,0,9,
2025-09-07,Sean Kerins,Arrow Electronics,2,12,0,14,
2025-09-07,William M Brown,3M,2,8,0,10,
2025-09-07,Ryan McInerney,Visa,13,23,4,40,
2025-09-07,Marc Rowan,Apollo Global Management,15,20,5,40,
2025-09-07,Tim Go,HF Sinclair,6,3,0,9,
2025-09-07,Robert Sulentic,CBRE Group,1,7,1,9,
2025-09-07,William Demchak,PNC Financial Services,16,19,5,40,
2025-09-07,Bryan DeBoer,Lithia Motors,10,29,1,40,
2025-09-07,William Nash,CarMax,4,4,2,10,
2025-09-07,Brian Robbins,Paramount Global,8,30,1,39,
2025-09-07,Michael Creedon,Dollar Tree,5,32,3,40,
2025-09-07,Sandy Douglas,United Natural Foods,34,5,1,40,
2025-09-07,Alex Chriss,PayPal,14,23,3,40,
2025-09-07,Roger Penske,Penske Automotive,18,21,1,40,
2025-09-07,Antonio Neri,Hewlett Packard Enterprise,10,23,7,40,
2025-09-07,Harry Sideris,Duke Energy,35,5,0,40,
2025-09-07,Vicki Hollub,Occidental Petroleum,21,16,3,40,
2025-09-07,Lawrence Coben,NRG Energy,5,3,0,8,
2025-09-07,Robert Bradway,Amgen,10,28,2,40,
2025-09-07,John Ketchum,NextEra Energy,23,17,0,40,
2025-09-07,Rainer Blair,Danaher,7,17,2,26,
2025-09-07,Daniel O'Day,Gilead Sciences,20,18,2,40,
2025-09-07,Michael Manley,AutoNation,3,6,1,10,
2025-09-07,Carlos Abrams-Rivera,Kraft Heinz,4,33,3,40,
2025-09-07,Philip Gallagher,Avnet,1,5,0,6,
2025-09-07,Gary Dickerson,Applied Materials,6,23,11,40,
2025-09-07,Bob Jordan,Southwest Airlines,10,23,7,40,
2025-09-07,Rick Wurster,Charles Schwab,14,21,4,39,
2025-09-07,Lorenzo Simonelli,Baker Hughes,16,20,4,40,
2025-09-07,Chris Kempczinski,McDonalds,12,22,6,40,
2025-09-07,Christopher Womack,Southern Company,3,7,0,10,
2025-09-07,Michael Miebach,Mastercard,10,27,3,40,
2025-09-07,Joseph Dominguez,Constellation Energy,13,11,1,25,
2025-09-07,Christopher Swift,The Hartford,17,19,4,40,
2025-09-07,Patricia Poppe,PG&E,8,15,2,25,
2025-09-07,Bom Kim,Coupang,13,26,1,40,
2025-09-07,Ezra Yacob,EOG Resources,24,14,2,40,
2025-09-07,Jim Vena,Union Pacific,21,19,0,40,
2025-09-07,Matt Schroeder,Rite Aid,4,34,2,40,
2025-09-07,Tony Spring,Macys,9,25,6,40,
2025-09-07,Anthony Capuano,Marriott International,13,25,2,40,
2025-09-07,Raymond E Scott,Lear Corporation,5,5,0,10,
2025-09-07,William Stengel II,Genuine Parts,0,4,0,4,
2025-09-07,Heidi Petz,Sherwin-Williams,10,27,3,40,
2025-09-07,Jeff Miller,Halliburton,13,21,6,40,
2025-09-07,Kathleen Quirk,Freeport-McMoRan,14,18,2,34,
2025-09-07,Michael Rapino,Live Nation Entertainment,14,23,3,40,
2025-09-07,John Doyle,Marsh & McLennan,11,8,0,19,
2025-09-07,Lisa Su,Advanced Micro Devices,18,19,3,40,
2025-09-07,Frank Holding,First Citizens BancShares,9,14,2,25,
2025-09-07,John Engel,WESCO International,5,12,1,18,
2025-09-07,David Gitlin,Carrier Global,15,23,2,40,
2025-09-07,Lourenco Goncalves,Cleveland-Cliffs,5,19,16,40,
2025-09-07,Calvin G Butler Jr,Exelon,6,4,0,10,
2025-09-07,Joseph Bae,KKR,20,18,2,40,
2025-09-07,Christine Leahy,CDW,0,8,2,10,
2025-09-07,Glenn Fogel,Booking Holdings,10,23,7,40,
2025-09-07,Brian Doubles,Synchrony Financial,5,8,1,14,
2025-09-07,Earl Austin,Quanta Services,2,6,2,10,
2025-09-07,Christian Ulbrich,Jones Lang LaSalle,8,16,0,24,
2025-09-07,Saumya Sutaria,Tenet Healthcare,5,3,1,9,
2025-09-07,William Gifford,Altria,3,4,2,9,
2025-09-07,Kevin Lobo,Stryker,12,25,3,40,
2025-09-07,Michael Hsu,Kimberly-Clark,5,7,1,13,
2025-09-07,Jack Fusco,Cheniere Energy,18,18,4,40,
2025-09-07,James Conroy,Ross Stores,4,12,0,16,
2025-09-07,Anthony Smurfit,Smurfit Westrock,4,6,0,10,
2025-09-07,Jeffrey Harmening,General Mills,3,16,5,24,
2025-09-07,Mark Stewart,Goodyear Tire & Rubber,3,36,1,40,
2025-09-07,Bob Eddy,BJs Wholesale Club,3,19,3,25,
2025-09-07,Peter Arduini,GE HealthCare Technologies,5,11,0,16,
2025-09-07,Noel Wallace,Colgate-Palmolive,10,24,2,36,
2025-09-07,Marc Bitzer,Whirlpool,12,14,14,40,
2025-09-07,Chris Kubasik,L3Harris Technologies,6,13,1,20,
2025-09-07,Shantanu Narayen,Adobe,18,20,1,39,
2025-09-07,Thomas Polen,Becton Dickinson,5,5,0,10,
2025-09-07,Richard P Dealy,Pioneer Natural Resources,5,4,0,9,
2025-09-07,Ravi Kumar S,Cognizant Technology Solutions,13,23,4,40,
2025-09-07,Andrew Clyde,Murphy USA,11,28,1,40,
2025-09-07,Mike Lyons,Fiserv,4,12,1,17,
2025-09-07,Jennifer Parmentier,Parker-Hannifin,2,11,0,13,
2025-09-07,William Fehrman,American Electric Power,4,6,0,10,
2025-09-07,Andrew Silvernail,International Paper,4,23,0,27,
2025-09-07,Jonas Prising,ManpowerGroup,7,21,2,30,
2025-09-07,John Zillmer,Aramark,6,13,2,21,
2025-09-07,Mark Millett,Steel Dynamics,19,2,0,21,
2025-09-07,Dan Amos,Aflac,14,17,9,40,
2025-09-07,Tony Cheng,Reinsurance Group of America,3,9,2,14,
2025-09-07,Karsanbhai,Emerson Electric,7,15,3,25,
2025-09-07,Ronald P O'Hanley,State Street,4,16,0,20,
2025-09-07,Timothy Knavish,PPG Industries,1,1,0,2,
2025-09-07,David Burritt,United States Steel,8,20,12,40,
2025-09-07,Maria Black,Automatic Data Processing,5,3,0,8,
2025-09-07,Daryl Kenningham,Group 1 Automotive,8,30,2,40,
2025-09-07,Robert Blue,Dominion Energy,27,12,1,40,
2025-09-07,Larry Fink,BlackRock,7,24,9,40,
2025-09-07,Pierce Norton II,Oneok,5,3,1,9,
2025-09-07,David Bozeman,CH Robinson Worldwide,2,8,0,10,
2025-09-07,Haviv Ilan,Texas Instruments,12,25,3,40,
2025-09-07,Michael Bender,Kohls,2,24,14,40,
2025-09-07,Philip Daniele III,AutoZone,0,2,0,2,
2025-09-07,Timothy Archer,Lam Research,2,7,1,10,
2025-09-07,Charles Magro,Corteva,4,3,1,8,
2025-09-07,Rick Lanoha,Peter Kiewit Sons',0,2,0,2,
2025-09-07,Peter Jackson,Builders FirstSource,5,11,1,17,
2025-09-07,Martin Schroeter,Kyndryl,10,28,1,39,
2025-09-07,Hamid Akhavan,EchoStar,5,26,9,40,
2025-09-07,Bill Westrate,American Family Insurance,10,17,2,29,
2025-09-07,Avigal Soreq,Delek US,4,8,5,17,
2025-09-07,Beth Ford,Land O'Lakes,18,22,0,40,
2025-09-07,Walker Martin,Sempra,0,2,0,2,
2025-09-07,Eric Slifka,Global Partners,12,22,6,40,
2025-09-07,DG Macpherson,WW Grainger,2,7,1,10,
2025-09-07,Bob Pragada,Jacobs Solutions,6,9,0,15,
2025-09-07,Pedro Pizarro,Edison International,16,8,16,40,
2025-09-07,William Hornbuckle,MGM Resorts International,9,24,1,34,
2025-09-07,Andrew McMahon,Guardian Life insurance,6,11,0,17,
2025-09-07,Christopher O'Herlihy,Illinois Tool Works,3,5,1,9,
2025-09-07,James Cracchiolo,Ameriprise Financial,2,23,2,27,
2025-09-07,Ryan Marshall,PulteGroup,10,14,11,35,
2025-09-07,Matthew Meloy,Targa Resources,4,6,0,10,
2025-09-07,Michael Rhodes,Ally Financial,9,26,5,40,
2025-09-07,Joseph Fadool,BorgWarner,4,10,0,14,
2025-09-07,St√©phane de La Faverie,Est√©e Lauder,9,27,4,40,
2025-09-07,Benjamin Tisch,Loews,3,7,0,10,
2025-09-07,Brad Beckham,O'Reilly Automotive,5,18,1,24,
2025-09-07,Thomas Gayner,Markel Group,2,8,0,10,
2025-09-07,Donald Allan,Stanley Black & Decker,8,31,1,40,
2025-09-07,Sanjay Mehrotra,Micron Technology,18,20,2,40,
2025-09-07,James Breuer,Fluor,1,2,1,4,
2025-09-07,Thomas Bell,Leidos,9,17,2,28,
2025-09-07,Scott Smith,Viatris,7,4,0,11,
2025-09-07,Kimberly Dang,Kinder Morgan,11,1,0,12,
2025-09-07,Christophe Beck,Ecolab,18,22,0,40,
2025-09-07,Brent Shafer,Baxter International,1,10,0,11,
2025-09-07,Clay Gaspar,Devon Energy,22,3,0,25,
2025-09-07,Steven Cahillane,Kellanova,1,8,0,9,
2025-09-07,Raul Nicholas Vargas Ochoa,Farmers Insurance Exchange,0,0,0,0,
2025-09-07,Darren Rebelez,Caseys General Stores,3,6,0,9,
2025-09-07,Ari Bousbib,IQVIA,6,17,0,23,
2025-09-07,Jon Vander Ark,Republic Services,12,19,9,40,
2025-09-07,Timothy Cofer,Keurig Dr Pepper,2,5,0,7,
2025-09-07,Karla Lewis,Reliance Inc,4,6,0,10,
2025-09-07,David Hult,Asbury Automotive Group,9,30,1,40,
2025-09-07,Darryl Button,Pacific Life,1,8,0,9,
2025-09-07,James Burke,Vistra,7,3,0,10,
2025-09-07,John Barrett,Western & Southern Financial,10,28,2,40,
2025-09-07,William Krueger,The Andersons Inc,0,3,0,3,
2025-09-07,Erik Nordstrom,Nordstrom,7,27,5,39,
2025-09-07,John Wren,Omnicom Group,14,20,6,40,
2025-09-07,Stephanie Ferris,Fidelity National Information Services,15,21,4,40,
2025-09-07,Timothy Cawley,Consolidated Edison,5,4,0,9,
2025-09-07,Joseph Hinrichs,CSX,6,11,1,18,
2025-09-07,Troy Rudd,AECOM,8,24,4,36,
2025-09-07,Kathleen Johnson,Lumen Technologies,3,5,1,9,
2025-09-07,Harry Lawton III,Tractor Supply,1,1,0,2,
2025-09-07,Raul Fernandez,DXC Technology,4,24,2,30,
2025-09-07,Eric Hansotia,AGCO,16,23,1,40,
2025-09-07,David Bruton Smith,Sonic Automotive,4,8,9,21,
2025-09-07,Sasan Goodarzi,Intuit,9,27,4,40,
2025-09-07,Matthew Flannery,United Rentals,34,2,0,36,
2025-09-07,Marc Miller,Universal Health Services,4,20,3,27,
2025-09-07,Michael Mahoney,Boston Scientific,11,29,0,40,
2025-09-07,Judith Marks,Otis Worldwide,3,3,0,6,
2025-09-07,Robert Frenzel,Xcel Energy,4,2,1,7,
2025-09-07,Penny Pennington,Edward Jones,8,26,6,40,
2025-09-07,Daniel Fisher,Ball,2,19,6,27,
2025-09-07,Justin Jude,LKQ,4,6,1,11,
2025-09-07,James Blackledge,Mutual of Omaha,2,31,1,34,
2025-09-07,Bruce Bodine,Mosaic,2,8,0,10,
2025-09-07,Scott Donnelly,Textron,8,29,3,40,
2025-09-07,Adam Schechter,Labcorp Holdings,3,4,0,7,
2025-09-07,Deanna Strable-Soethout,Principal Financial,1,6,0,7,
2025-09-07,Leonard Schleifer,Regeneron Pharmaceuticals,6,27,7,40,
2025-09-07,Paul Shoukry,Raymond James Financial,16,23,1,40,
2025-09-07,Lauren Hobart,Dicks Sporting Goods,12,24,4,40,
2025-09-07,Jamie Whisnant,Auto-Owners Insurance,0,2,0,2,
2025-09-07,Ariane Gorin,Expedia,8,31,1,40,
2025-09-07,Shelley Simpson,JB Hunt Transport Services,9,28,3,40,
2025-09-07,Ren√© Jones,M&T Bank,12,23,5,40,
2025-09-07,Gerardo Norcia,DTE Energy,6,3,0,9,
2025-09-07,Andr√©s Gluski,AES,16,22,0,38,
2025-09-07,Timothy Spence,Fifth Third Bancorp,5,4,1,10,
2025-09-07,Eduardo Menezes,Air Products & Chemicals,3,6,1,10,
2025-09-07,Wendell Weeks,Corning,15,23,2,40,
2025-09-07,Anthony Guzzi,EMCOR Group,4,3,1,8,
2025-09-07,Adam Norwitt,Amphenol,3,17,0,20,
2025-09-07,Jean-Marc Gilson,Westlake Corporation,2,4,0,6,
2025-09-07,Lori Koch,DuPont,7,18,0,25,
2025-09-07,Derek Chang,Liberty Media,38,2,0,40,
2025-09-07,Martina Cheung,S&P Global,11,27,0,38,
2025-09-07,Tim Hingtgen,Community Health Systems,11,27,2,40,
2025-09-07,Brian Tierney,FirstEnergy,6,21,3,30,
2025-09-07,Rick McKenney,Unum Group,5,4,0,9,
2025-09-07,Stanley Bergman,Henry Schein,12,27,1,40,
2025-09-07,Tiang Yew Tan,Western Digital,0,4,0,4,
2025-09-07,Vincent Roche,Analog Devices,13,23,4,40,
2025-09-07,Sean Connolly,Conagra Brands,7,31,2,40,
2025-09-07,Bruce Van Saun,Citizens Financial Group,15,25,0,40,
2025-09-07,Mark George,Norfolk Southern,19,18,3,40,
2025-09-07,Andrew Marsh,Entergy,3,5,0,8,
2025-09-07,Robert Berkley,WR Berkley,9,27,4,40,
2025-09-07,Javier Rodriguez,DaVita,14,14,1,29,
2025-09-07,Michael O'Grady,Northern Trust,27,7,1,35,
2025-09-07,James Snee,Hormel Foods,2,26,1,29,
2025-09-07,Timothy J Donahue,Crown Holdings,2,10,0,12,
2025-09-07,Joseph Ferraro,Avis Budget,3,5,1,9,
2025-09-07,Niraj Shah,Wayfair,9,23,8,40,
2025-09-07,Jos√© Mas,MasTec,6,14,1,21,
2025-09-07,Joseph Nolan,Eversource Energy,6,3,1,10,
2025-09-07,Thomas Palmer,Newmont,5,5,0,10,
2025-09-07,Robert Sanchez,Ryder System,10,10,1,21,
2025-09-07,Michael Nolan,Fidelity National Financial,4,0,0,4,
2025-09-07,Gavin Hattersley,Molson Coors Beverage,5,29,6,40,
2025-09-07,Thomas Reeg,Caesars Entertainment,5,6,0,11,
2025-09-07,Ellen Cooper,Lincoln National,3,7,0,10,
2025-09-07,Bracken Darrell,VF Corporation,10,27,3,40,
2025-09-07,Erik Fyrwald,International Flavors & Fragrances,6,9,3,18,
2025-09-07,Christopher Kastner,Huntington Ingalls Industries,3,5,0,8,
2025-09-07,Shane O'Kelly,Advance Auto Parts,13,24,3,40,
2025-09-07,Ralph LaRossa,Public Service Enterprise Group,11,17,0,28,
2025-09-07,Kecia Steelman,Ulta Beauty,34,5,1,40,
2025-09-07,Michele Buck,Hershey,6,32,2,40,
2025-09-07,Sumit Singh,Chewy,12,24,4,40,
2025-09-07,Steven Vondran,American Tower,4,6,0,10,
2025-09-07,Jeffrey Lorberbaum,Mohawk Industries,11,6,1,18,
2025-09-07,Keith Demmings,Assurant,4,7,0,11,
2025-09-07,Robert Martin,Thor Industries,4,5,1,10,
2025-09-07,Kathleen Mazzarella,Graybar Electric,1,7,1,9,
2025-09-07,Joey Wat,Yum China,12,26,2,40,
2025-09-07,Scott Richardson,Celanese,9,24,4,37,
2025-09-07,David Rawlinson II,QVC,7,14,2,23,
2025-09-07,Alan Armstrong,Williams,26,10,4,40,
2025-09-07,Philippe Krakowsky,Interpublic Group,12,25,3,40,
2025-09-07,Brendan McCracken,Ovintiv,6,5,0,11,
2025-09-07,Andrew Teno,Icahn Enterprises,5,5,0,10,
2025-09-07,Stephen Steinour,Huntington Bancshares,3,7,0,10,
2025-09-07,Timothy NeCastro,Erie Insurance,3,6,1,10,
2025-09-07,Ernest Garcia III,Carvana,24,12,4,40,
2025-09-07,R Bruce McDonald,Dana Incorporated,3,8,1,12,
2025-09-07,William Oplinger,Alcoa Corporation,2,8,0,10,
2025-09-07,Mark Pearson,Equitable,9,7,0,16,
2025-09-07,Richard Wallace,KLA,4,6,0,10,
2025-09-07,Ricardo Cardenas,Darden Restaurants,4,3,1,8,
2025-09-07,Mikael Bratt,Autoliv,5,8,2,15,
2025-09-07,Benito Minicucci,Alaska Air,3,3,1,7,
2025-09-07,Christopher Gorman,KeyCorp,5,5,0,10,
2025-09-07,Robert Goldstein,Las Vegas Sands,5,30,5,40,
2025-09-07,Edward Pesicka,Owens & Minor,3,32,3,38,
2025-09-07,Christopher Nassetta,Hilton Worldwide,7,16,2,25,
2025-09-07,Jamie Iannone,Ebay,17,20,3,40,
2025-09-07,Patrick Gallagher,Arthur J Gallagher,7,31,2,40,
2025-09-07,Rich Steinmeier,LPL Financial,25,13,2,40,
2025-09-07,Stephen Spray,Cincinnati Financial,1,7,1,9,
2025-09-07,Douglas Yearley,Toll Brothers,11,24,5,40,
2025-09-07,Gregory Brown,Motorola Solutions,1,9,0,10,
2025-09-07,Brian Chesky,Airbnb,3,29,8,40,
2025-09-07,Jeffrey Sprecher,Intercontinental Exchange,17,22,1,40,
2025-09-07,Robert Thomson,News Corp,6,31,3,40,
2025-09-07,Scott Boatwright,Chipotle Mexican Grill,8,27,5,40,
2025-09-07,Reshma Kewalramani,Vertex Pharmaceuticals,21,14,5,40,
2025-09-07,Christopher Viehbacher,Biogen,0,24,2,26,
2025-09-07,Malcolm Wilson,GXO Logistics,6,21,0,27,
2025-09-07,Tony Sarsam,SpartanNash,18,20,2,40,
2025-09-07,Michael O‚ÄôSullivan,Burlington Stores,10,26,4,40,
2025-09-07,Teresa Rasmussen,Thrivent Financial for Lutherans,4,1,0,5,
2025-09-07,Eugene Bredow,NVR,0,4,1,5,
2025-09-07,Brian Chambers,Owens Corning,3,11,0,14,
2025-09-07,Rafael Santana,Westinghouse Air Brake Technologies,3,7,1,11,
2025-09-07,John Pfeifer,Oshkosh,4,25,4,33,
2025-09-07,Cameron Bready,Global Payments,8,30,2,40,
2025-09-07,Calvin McDonald,Lululemon athletica,8,30,2,40,
2025-09-07,J Kent Masters,Albemarle Corporation,3,6,0,9,
2025-09-07,Joanna Geraghty,JetBlue Airways,13,20,7,40,
2025-09-07,Robert Steer,Seaboard,1,4,0,5,
2025-09-07,William Newlands,Constellation Brands,0,2,2,4,
2025-09-07,Michael Doss,Graphic Packaging,3,9,1,13,
2025-09-07,Gil West,Hertz,7,25,8,40,
2025-09-07,Malcolm C Roberts,FM Global,2,10,2,14,
2025-09-07,Mick Beekhuizen,Campbell Soup,8,23,0,31,
2025-09-07,Daniel Wall,Expeditors International of Washington,2,5,0,7,
2025-09-07,Gregory Roberts,A-Mark Precious Metals,1,4,1,6,
2025-09-07,Horacio Rozanski,Booz Allen Hamilton,16,19,5,40,
2025-09-07,James Davis,Quest Diagnostics,5,5,0,10,
2025-09-07,Dennis Mathew,Altice,5,26,8,39,
2025-09-07,Stefan Larsson,PVH,10,25,5,40,
2025-09-07,Mark Costa,Eastman Chemical,5,15,4,24,
2025-09-07,Joyce Mullen,Insight Enterprises,5,10,0,15,
2025-09-07,John Turner,Regions Financial,20,18,2,40,
2025-09-07,Julian G Francis,Beacon Roofing Supply,0,1,0,1,
2025-09-07,Blake Moret,Rockwell Automation,11,27,2,40,
2025-09-07,Mike Speetzen,Polaris Inc,3,18,2,23,
2025-09-07,William McDermott,ServiceNow,4,5,0,9,
2025-09-07,Jure Sola,Sanmina,2,11,0,13,
2025-09-07,Bob Flexon,UGI Utilities Inc,0,1,0,1,
2025-09-07,Scott Lauber,WEC Energy,14,6,0,20,
2025-09-07,Jon Rousseau,BrightSpring Health Services,20,19,1,40,
2025-09-07,Todd Schneider,Cintas,15,18,2,35,
2025-09-07,Peter Matt,Commercial Metals,5,4,0,9,
2025-09-07,Robert D Lawler,Continental Resources,1,0,0,1,
2025-09-07,Domenic Dell‚ÄôOsso Jr,Expand Energy,4,1,0,5,
2025-09-07,Jason P Wells,CenterPoint Energy,9,4,1,14,
2025-09-07,H Michael Krimbill,NGL Energy Partners,5,2,0,7,
2025-09-07,Tony Xu,DoorDash,11,22,7,40,
2025-09-07,Clay Williams,NOV,7,20,5,32,
2025-09-07,Kristin Peck,Zoetis,14,19,1,34,
2025-09-07,Mark Smucker,JM Smucker,14,20,6,40,
2025-09-07,Steve Sanghi,Microchip Technology,8,28,4,40,
2025-09-07,Richard Tobin,Dover Corporation,6,3,0,9,
2025-09-07,Kaes Van‚Äôt Hof,Diamondback Energy,20,16,3,39,
2025-09-07,Deon Stander,Avery Dennison,0,13,0,13,
2025-09-07,Vincent Sorgi,PPL,8,10,1,19,
2025-09-07,Hassane El-Khoury,ON Semiconductor,1,19,4,24,
2025-09-07,Arie Kotler,ARKO,6,24,0,30,
2025-09-07,William Monteleone,Par Pacific,1,6,2,9,
2025-09-07,John Christmann IV,APA,5,4,1,10,
2025-09-07,Adaire Fox-Martin,Equinix,16,20,4,40,
2025-09-07,Joseph M Otting,Flagstar Financial,2,6,2,10,
2025-09-07,Mary Dillon,Foot Locker,11,25,4,40,
2025-09-07,James Zallie,Ingredion,4,5,1,10,
2025-09-07,Christopher Peterson,Newell Brands,0,9,1,10,
2025-09-07,Scott Salmirs,ABM Industries,7,7,1,15,
2025-09-07,Christopher Hilger,Securian Financial,0,6,0,6,
2025-09-07,Hamid Moghadam,Prologis,8,27,5,40,
2025-09-07,Stephen Schwarzman,Blackstone,17,19,4,40,
2025-09-07,Robert Greenberg,Skechers USA,5,22,3,30,
2025-09-07,Keith Allman,Masco,4,9,1,14,
2025-09-07,Rusty Rush,Rush Enterprises,15,22,3,40,
2025-09-07,Jennifer Johnson,Franklin Resources,1,7,2,10,
2025-09-07,Gerry P Smith,ODP Business Solutions,0,1,0,1,
2025-09-07,Carl Lindner lll,American Financial,0,0,0,0,
2025-09-07,Mark Kowlzan,Packaging Corp of America,0,9,1,10,
2025-09-07,Thomas Hill,Vulcan Materials,4,6,2,12,
2025-09-07,Milan Galik,Interactive Brokers,7,21,2,30,
2025-09-07,Laura Alber,Williams-Sonoma,13,23,4,40,
2025-09-07,Mario Harik,XPO,8,31,1,40,
2025-09-07,Devin Stockfish,Weyerhaeuser,5,5,0,10,
2025-09-07,Thomas J McInerney,Genworth Financial,1,6,0,7,
2025-09-07,Garrick Rochow,CMS Energy,12,3,1,16,
2025-09-07,Toni Townes-Whitley,Science Applications International,12,22,1,35,
2025-09-07,Rich Handler,Jefferies Financial,12,10,2,24,
2025-09-07,Daniel Heaf,Bath & Body Works,12,26,2,40,
2025-09-07,Andrew Wilson,Electronic Arts,13,18,9,40,
2025-09-07,Sheryl Palmer,Taylor Morrison Home,8,12,1,21,
2025-09-07,Ivan Tornos,Zimmer Biomet,8,30,2,40,
2025-09-07,Linda Rendle,Clorox,2,35,2,39,
2025-09-07,Matthew Pine,Xylem Inc,1,8,1,10,
2025-09-07,Heather Lavallee,Voya Financial,7,10,2,19,
2025-09-07,Daniel Florness,Fastenal,4,4,2,10,
2025-09-07,Albert Nahmad,Watsco,2,7,0,9,
2025-09-07,Carl Eschenbach,Workday,12,19,9,40,
2025-09-07,Craig Smiddy,Old Republic International,4,5,1,10,
2025-09-07,Frank C Sullivan,RPM International,4,8,0,12,
2025-09-07,Matthew Missad,UFP Industries,7,3,0,10,
2025-09-07,Martin J Lyons,Ameren,2,3,1,6,
2025-09-07,Adam W Miller,Knight Swift Transportation,0,2,1,3,
2025-09-07,Rodney Sacks,Monster Beverage,10,28,1,39,
2025-09-07,Gary Guthart,Intuitive Surgical,13,23,4,40,
2025-09-07,Charles Liang,Super Micro Computer,34,5,1,40,
2025-09-07,Christopher Caldwell,Concentrix,5,5,0,10,
2025-09-07,Gordon J Hardie,O-I Glass,0,5,0,5,
2025-09-07,David Gibbs,Yum Brands,2,38,0,40,
2025-09-07,Steve Henry,Domtar,5,5,0,10,
2025-09-07,Chuck Treadway,CommScope,8,19,3,30,
2025-09-07,Rob Vitale,Post Holdings,1,11,5,17,
2025-09-07,Steven J Moskowitz,Crown Castle,2,5,3,10,
2025-09-07,Emmanuel Ligner,Avantor,3,11,1,15,
2025-09-07,Stuart Bradie,KBR,14,16,4,34,
2025-09-07,Carrie Wheeler,Opendoor Technologies,11,26,3,40,
2025-09-07,Russell Becker,APi Group,3,5,1,9,
2025-09-07,Toby Rice,EQT,23,14,3,40,
2025-09-07,Jesse Arenivas,EnLink Midstream,7,8,0,15,
2025-09-07,Nikesh Arora,Palo Alto Networks,5,25,10,40,
2025-09-07,Steven Bandrowczak,Xerox,1,8,1,10,
2025-09-07,Vicente Reynal,Ingersoll Rand,6,26,0,32,
2025-09-07,William T Dillard II,Dillards,3,5,2,10,
2025-09-07,C Howard Nye,Martin Marietta Materials,1,5,4,10,
2025-09-07,Giordano Albertazzi,Vertiv,15,20,5,40,
2025-09-07,Stephane Bancel,Moderna,10,19,11,40,
2025-09-07,Nate R Jorgensen,Boise Cascade,0,0,0,0,
2025-09-07,Jack Sinclair,Sprouts Farmers Market,15,24,1,40,
2025-09-07,Padraig McDonnell,Agilent Technologies,12,13,0,25,
2025-09-07,Kenneth T Lane,Olin,0,0,0,0,
2025-09-07,Randall C Stuewe,Darling Ingredients,27,1,0,28,
2025-09-07,R Howard Coker,Sonoco Products,4,5,1,10,
2025-09-07,John Mengucci,CACI International,20,18,2,40,
2025-09-07,Mark Witkowski,Core & Main,0,8,1,9,
2025-09-07,Lee M Tillman,Marathon Oil,4,4,0,8,
2025-09-07,Mark Hoplamazian,Hyatt Hotels,14,21,5,40,
2025-09-07,David S Chernow,Select Medical,0,9,0,9,
2025-09-07,Brendan M Foley,McCormick & Company,0,8,0,8,
2025-09-07,Joanne Crevoiserat,Tapestry,14,22,4,40,
2025-09-07,John Plant,Howmet Aerospace,6,13,3,22,
2025-09-07,Shankh Mitra,Welltower,17,21,2,40,
2025-09-07,W Anthony Will,CF Industries,3,3,0,6,
2025-09-07,David A Zapico,Ametek,3,17,0,20,
2025-09-07,Kevin Stein,TransDigm,10,9,2,21,
2025-09-07,Craig Billings,Wynn Resorts,12,25,3,40,
2025-09-07,William J Way,Southwestern Energy,1,0,0,1,
2025-09-07,Giel Rutten,Amkor Technology,3,8,1,12,
2025-09-07,Paul Sarvadi,Insperity,4,5,0,9,
2025-09-07,Donald Zurbay,Patterson Companies Inc,1,5,0,6,
2025-09-07,Rob Sharps,T Rowe Price,11,24,5,40,
2025-09-07,Patrice Louvet,Ralph Lauren,15,16,9,40,
2025-09-07,Jeffrey Mezger,KB Home,2,31,7,40,
2025-09-07,David M Foulkes,Brunswick,1,7,0,8,
2025-09-07,M Keith Waddell,Robert Half,2,8,1,11,
2025-09-07,Jay Snowden,PENN Entertainment,18,19,3,40,
2025-09-07,George Kurian,NetApp,16,21,3,40,
2025-09-07,Kevin Ali,Organon,9,20,2,31,
2025-09-07,Joel D Anderson,Petco Health and Wellness,3,8,0,11,
2025-09-07,Louis V Pinkham,Regal Rexnord,0,0,0,0,
2025-09-07,Jay Geldmacher,Resideo Technologies,9,6,1,16,
2025-09-07,Marcus Lemonis,Camping World,7,25,8,40,
2025-09-07,Peter R Huntsman,Huntsman,7,12,4,23,
2025-09-07,Hillary Super,Victorias Secret,11,4,8,23,
2025-09-07,Michelle Gass,Levi Strauss,11,25,3,39,
2025-09-07,Neil Hunn,Roper Technologies,3,21,0,24,
2025-09-07,Steven P Lawrence,Academy Sports and Outdoors,1,1,0,2,
2025-09-07,Phillippe Lord,Meritage Homes,8,15,0,23,
2025-09-07,David C Dauch,American Axle & Manufacturing,5,6,2,13,
2025-09-07,Olumide Soroye,Fortive,1,9,0,10,
2025-09-07,Adena Friedman,Nasdaq,14,22,4,40,
2025-09-07,Tim Gokey,Broadridge Financial Solutions,3,12,1,16,
2025-09-07,Patrick M Shanahan,Spirit AeroSystems,1,9,0,10,
2025-09-07,Robert Kyncl,Warner Music Group,9,29,2,40,
2025-09-07,Denise Dignam,Chemours,2,19,2,23,
2025-09-07,Jim DeVries,ADT,10,6,1,17,
2025-09-07,Bernard Zovighian,Edwards Lifesciences,6,7,2,15,
2025-09-07,Mark E Seaton,First American Financial,1,9,0,10,
2025-09-07,John C Roche,Hanover Insurance Group,8,19,1,28,
2025-09-07,Adam J Greenlee,Silgan,0,4,0,4,
2025-09-07,Jayne Hrdlicka,Endeavor Group,0,1,0,1,
2025-09-07,Robert Fauber,Moodys Corporation,0,5,0,5,
2025-09-07,Thomas E Jorden,Coterra Energy,9,0,0,9,
2025-09-07,Eugene A Hall,Gartner,1,9,0,10,
2025-09-07,Kevin Plank,Under Armour,8,28,4,40,
2025-09-07,James W Lanning,Ingles Markets,3,3,0,6,
2025-09-07,Matthew T Farrell,Church & Dwight,7,7,0,14,
2025-09-07,Kevin M Freeman,Old Dominion Freight Line,0,0,0,0,
2025-09-07,Joe Shoen,U-Haul,14,21,4,39,
2025-09-07,Mark Bertolini,Oscar Health,13,19,8,40,
2025-09-07,Jayshree Ullal,Arista Networks,21,17,2,40,
2025-09-07,Sassine Ghazi,Synopsys,10,27,3,40,
2025-09-07,Jochen Zeitz,Harley-Davidson,7,23,10,40,
2025-09-07,Nick Jeffery,Frontier Communications,10,26,1,37,
2025-09-07,Thomas Edward McCormick,Primoris Services,0,4,0,4,
2025-09-07,D Christian Koch,Carlisle Companies,1,2,1,4,
2025-09-07,David E Simon,Simon Property Group,3,4,3,10,
2025-09-07,Stephen Bratspies,Hanesbrands,3,11,1,15,
2025-09-07,Ryan M. Schneider,Anywhere Real Estate Inc,0,2,0,2,
2025-09-07,George Bobb III,Teledyne Technologies,1,4,1,6,
2025-09-07,Terrence A Duffy,CME Group,6,9,1,16,
2025-09-07,Rami Rahim,Juniper Networks,11,27,2,40,
2025-09-07,Sue Nabi,Coty,16,17,7,40,
2025-09-07,Peter D Arvan,Pool Corporation,2,7,0,9,
2025-09-07,David Campbell,Evergy,13,9,0,22,
2025-09-07,Matthew J Murphy,Marvell Technology,5,4,1,10,
2025-09-07,Lloyd Yates,NiSource,5,4,0,9,
2025-09-07,William C Stone,SS&C Technologies,2,6,0,8,
2025-09-07,Mark Rourke,Schneider National,10,19,1,30,
2025-09-07,Andrew Anagnost,Autodesk,9,24,7,40,
2025-09-07,Dustin Semach,Sealed Air Corporation,0,9,0,9,
2025-09-07,William L Meaney,Iron Mountain,3,18,0,21,
2025-09-07,Andy P Power,Digital Realty Trust,0,0,0,0,
2025-09-07,Satish Dhanasekaran,Keysight Technologies,2,10,0,12,
2025-09-07,Frank M Svoboda,Globe Life,3,4,3,10,
2025-09-07,Carey A Smith,Parsons Corporation,1,3,0,4,
2025-09-07,Ynon Kreiz,Mattel,7,26,7,40,
2025-09-07,Karen S Haller,Southwest Gas,3,6,0,9,
2025-09-07,Terrance Williams,TruStage,4,6,1,11,
2025-09-07,Eric W Gerstenberg,Clean Harbors,4,2,1,7,
2025-09-07,Gunner Smith,Cornerstone Building Brands,1,8,0,9,
2025-09-07,Gerben W Bakker,Hubbell,1,4,0,5,
2025-09-07,Dave Davis,Spirit Airlines,8,27,5,40,
2025-09-07,Michael J Smith,Lamb Weston,0,6,3,9,
2025-09-07,Strauss Zelnick,Take-Two Interactive Software,13,19,8,40,
2025-09-07,John C Turner Jr,GMS,2,7,0,9,
2025-09-07,David M O'Malley,Penn Mutual Life Insurance,1,3,0,4,
2025-09-07,Frank A Lonegro,Landstar System,2,4,0,6,
2025-09-07,James F Risoleo,Host Hotels & Resorts,6,16,0,22,
2025-09-07,Ken Xie,Fortinet,11,21,8,40,
2025-09-07,Doug Shulman,OneMain,3,6,0,9,
2025-09-07,Ryan Cohen,GameStop,12,22,6,40,
2025-09-07,Mark W Begor,Equifax,3,13,0,16,
2025-09-07,Jay L Schottenstein,American Eagle Outfitters,4,12,0,16,
2025-09-07,Curtis C Farmer,Comerica,4,9,0,13,
2025-09-07,Ole Rosgaard,Greif,3,17,1,21,
2025-09-07,Brian E Lane,Comfort Systems USA,10,0,0,10,
2025-09-07,Robert M Buck,TopBuild,0,5,1,6,
2025-09-07,Ralph Andretta,Bread Financial,3,9,0,12,
2025-09-07,Jim Anderson,Coherent,6,33,1,40,
2025-09-07,Walter C. D. Carlson,Telephone & Data Systems,0,2,0,2,
2025-09-07,Ronald Kruszewski,Stifel Financial,7,4,0,11,
2025-09-07,Richard Hayne,Urban Outfitters,12,21,7,40,
2025-09-07,Simon Meester,Terex,3,7,0,10,
2025-09-07,Edward J Lehner,Ryerson Holding,0,2,1,3,
2025-09-07,Nicholas T Pinchuk,Snap-on,2,6,0,8,
2025-09-07,Ryals McMullian,Flowers Foods,5,29,3,37,
2025-09-07,D Bryan Jordan,First Horizon,4,8,1,13,
2025-09-07,John B Gibson,Paychex,3,6,0,9,
2025-09-07,Chris Cocks,Hasbro,12,19,9,40,
2025-09-07,Pete McPartland,Sentry Insurance Group,0,2,0,2,
2025-09-07,Michael Arougheti,Ares Management,16,23,1,40,
2025-09-07,Alok Maskara,Lennox International,5,4,1,10,
2025-09-07,James C Grech,Peabody Energy,3,0,0,3,
2025-09-07,Joseph P Lacher Jr,Kemper,4,19,4,27,
2025-09-07,Perry A Sook,Nexstar Media Group,8,29,1,38,
2025-09-07,Wade Davis,TelevisaUnivision,13,25,2,40,
2025-09-07,Scott L Thompson,Tempur Sealy International,0,6,0,6,
2025-09-07,Mike Simonds,TriNet Group,0,9,0,9,
2025-09-07,B Andrew Rose,Worthington Enterprises,1,1,0,2,
2025-09-07,Bruce L Caswell,Maximus,5,5,0,10,
2025-09-07,Robert L Reffkin,Compass,1,7,0,8,
2025-09-07,Mark Eubanks,Brinks Company,1,2,1,4,
2025-09-07,Peter Quigley,Kelly Services inc,2,8,0,10,
2025-09-07,David L Yowan,Navient,3,3,0,6,
2025-09-07,Mary E Kipp,Puget Sound Energy,4,1,2,7,
2025-09-07,Adam Aron,AMC Entertainment,16,18,6,40,
2025-09-07,Mark J Tarr,Encompass Health,2,6,1,9,
2025-09-07,Liam K Griffin,Skyworks Solutions,1,7,1,9,
2025-09-07,Richard G Kyle,Timken,5,17,1,23,
2025-09-07,Ron Gusek,Liberty Energy,20,1,0,21,
2025-09-07,John E Geller Jr,Marriott Vacations Worldwide,6,5,0,11,
2025-09-07,Karl G. Glassman,Leggett & Platt,0,4,0,4,
2025-09-07,Bruce K Thorn,Big Lots,3,5,2,10,
2025-09-07,Jonathan H Weis,Weis Markets,10,29,0,39,
2025-09-07,Jeffrey B Guldner,Pinnacle West Capital,1,3,0,4,
2025-09-07,Arkadiy Dobkin,EPAM Systems,10,17,1,28,
2025-09-07,Paul M Rady,Antero Resources,4,8,0,12,
2025-09-07,Michael Spanos,Bloomin Brands,1,9,1,11,
2025-09-07,Nicole A Kivisto,MDU Resources Group,2,4,0,6,
2025-09-07,Gerald L Morgan,Texas Roadhouse,3,3,4,10,
2025-09-07,Gabriel Tirador,Mercury General,4,4,2,10,
2025-09-07,Nicholas I Fink,Fortune Brands Innovations,7,3,0,10,
2025-09-07,Paul E Burdiss,Zions Bancorp,1,1,0,2,
2025-09-07,William J Christensen,JELD-WEN Holding,4,5,0,9,
2025-09-07,Evan Spiegel,Snap Inc,19,18,3,40,
2025-09-07,Bill Burns,Zebra Technologies,7,24,1,32,
2025-09-07,Steven Sell,Agilon Health,1,9,2,12,
2025-09-07,Richard M Olson,Toro Company,1,14,0,15,
2025-09-07,Eric S Yuan,Zoom Video Communications,6,6,0,12,
2025-09-07,Dan L Batrack,Tetra Tech,2,3,1,6,
2025-09-07,Joseph D Russell Jr,Public Storage,0,8,0,8,
2025-09-07,Jacob Thaysen,Illumina inc,4,8,0,12,
2025-09-07,Debra A Cafaro,Ventas inc,7,5,0,12,
2025-09-07,Pierre R Brondeau,FMC Corporation,1,5,0,6,
2025-09-07,Judy R McReynolds,ArcBest,6,15,1,22,
2025-09-07,Russell J Weiner,Dominos Pizza inc,0,0,0,0,
2025-09-07,Theodore S Hanson,ASGN,0,1,0,1,
2025-09-07,RJ Scaringe,Rivian Automotive,9,27,4,40,
2025-09-07,Jeffrey N Simmons,Elanco Animal Health,2,5,1,8,
2025-09-07,Tim O Shaughnessy,Graham Holdings Company,2,7,0,9,
2025-09-07,Thomas V Taylor,Floor & Decor,1,1,2,4,
2025-09-07,Neil A Schrimsher,Applied Industrial Technologies,5,26,1,32,
2025-09-07,Robert E Price,PriceSmart,4,6,0,10,
2025-09-07,John David Risher,Lyft,4,2,1,7,
2025-09-07,Gary B Smith,Ciena,4,7,0,11,
2025-09-07,Joey Levin,IAC,7,31,1,39,
2025-09-07,Jim Jacobs,Country Financial,7,3,2,12,
2025-09-07,Devin B McGranahan,Western Union,1,5,0,6,
2025-09-07,R Scott Rowe,Flowserve,5,4,1,10,
2025-09-07,Kenneth A Vecchione,Western Alliance Bancorp,0,0,1,1,
2025-09-07,John C Rademacher,Option Care Health,10,1,0,11,
2025-09-07,Doug Black,SiteOne Landscape Supply,2,20,2,24,
2025-09-07,Oliver G Brewer III,Topgolf Callaway Brands,1,0,0,1,
2025-09-07,Glenn Sanford,eXp World,15,21,4,40,
2025-09-07,Fran Horowitz,Abercrombie & Fitch,15,19,6,40,
2025-09-07,Kevin Akers,Atmos Energy,8,2,0,10,
2025-09-07,Alessandro Maselli,Catalent,4,11,2,17,
2025-09-07,J Powell Brown,Brown & Brown,11,22,7,40,
2025-09-07,Aman Bhutani,GoDaddy,18,19,2,39,
2025-09-07,John C. Griffith,American Water Works,0,4,0,4,
2025-09-07,John J Marchioni,Selective Insurance Group,4,12,4,20,
2025-09-07,Lawson E Whiting,Brown-Forman,1,7,2,10,
2025-09-07,Dave Peacock,Advantage Solutions,21,8,0,29,
2025-09-07,Mick Farrell,ResMed,16,22,1,39,
2025-09-07,Kamal Hathi,Splunk,1,6,0,7,
2025-09-07,Todd Kelsey,Plexus,2,7,0,9,
2025-09-07,Phillip D Yeager,Hub Group,4,5,0,9,
2025-09-07,Steven B Hedlund,Lincoln Electric,5,10,0,15,
2025-09-07,Timothy C Oliver,NCR Atleos,0,1,0,1,
2025-09-07,Bruce Fleming,Calumet,2,7,0,9,
2025-09-07,Daniel S. Peyovich,Dycom Industries,0,4,0,4,
2025-09-07,Avner M Applbaum,Valmont Industries,0,8,0,8,
2025-09-07,Kimberly A Fields,ATI inc,4,9,0,13,
2025-09-07,Khozema Z Shipchandler,Twilio,0,2,0,2,
2025-09-07,Gary C Bhojwani,CNO Financial Group,1,6,1,8,
2025-09-07,William Andrew Hendricks Jr,Patterson-UTI Energy,0,0,0,0,
2025-09-07,Kevin D Hochman,Brinker International,1,4,1,6,
2025-09-07,James C Foster,Charles River Laboratories International,2,9,0,11,
2025-09-07,Rajiv K Prasad,Hyster-Yale,2,5,0,7,
2025-09-07,Eric T Steigerwalt,Brighthouse Financial,1,2,0,3,
2025-09-07,Thomas L Ryan,Service Corp International,6,4,0,10,
2025-09-07,Charles M Nifong Jr,CrossAmerica Partners,0,0,0,0,
2025-09-07,Anirudh Devgan,Cadence,12,24,3,39,
2025-09-07,Andi Owen,MillerKnoll,16,16,8,40,
2025-09-07,Sumit Roy,Realty Income,14,20,2,36,
2025-09-07,Timothy John Fitzgerald,Middleby,0,0,0,0,
2025-09-07,Robert H Schottenstein,M/I Homes,1,10,0,11,
2025-09-07,Stephen P MacMillan,Hologic,1,8,1,10,
2025-09-07,Lisa M Barton,Alliant Energy,4,0,0,4,
2025-09-07,Aaron P Jagdfeld,Generac,1,5,1,7,
2025-09-07,Erik Gershwind,MSC Industrial Direct,3,5,2,10,
2025-09-07,Varun Krishna,Rocket Companies,8,31,1,40,
2025-09-07,Fahmi Karam,Upbound Group,5,4,0,9,
2025-09-07,NADominic Ng,East West Bancorp,0,0,0,0,
2025-09-07,Mark Wang,Hilton Grand Vacations,38,2,0,40,
2025-09-07,Robert J Sheedy Jr,Grocery Outlet Holding,0,0,0,0,
2025-09-07,Simon D Campion,Dentsply Sirona,0,3,0,3,
2025-09-07,Jeremy Wensinger,V2X,6,9,0,15,
2025-09-07,Andrew Rees,Crocs,15,15,10,40,
2025-09-07,David M Maura,Spectrum Brands,6,1,0,7,
2025-09-07,Sachin S Lawande,Visteon,0,0,0,0,
2025-09-07,Neil M Ashe,Acuity Inc,0,1,0,1,
2025-09-07,Lorie L Tekorius,Greenbrier,2,8,0,10,
2025-09-07,John R Ciulla,Webster Financial,5,5,0,10,
2025-09-07,Sean D Keohane,Cabot Corporation,3,4,0,7,
2025-09-07,Drew M Wilkerson,RXO inc,0,0,0,0,
2025-09-07,Daniel E Brown,Chord Energy,1,1,0,2,
2025-09-07,Javier D Ferrer Fernandez,Popular inc,0,0,0,0,
2025-09-07,Olivier Rabiller,Garrett Motion inc,4,8,0,12,
2025-09-07,Ronald N Tutor,Tutor Perini Corporation,3,6,0,9,
2025-09-07,Jeff Liaw,Copart,4,4,1,9,
2025-09-07,Aman Narang,Toast inc,3,6,2,11,
2025-09-07,Joseph M Hogan,Align Technology,2,5,0,7,
2025-09-07,Kevin J Wheeler,A O Smith,0,16,1,17,
2025-09-07,Christopher A Cartwright,TransUnion,2,0,2,4,
2025-09-07,James Kelly,NCR Voyix,2,12,1,15,
2025-09-07,Tom Leighton,Akamai Technologies,15,14,6,35,
2025-09-07,Robert G Painter,Trimble,7,2,0,9,
2025-09-07,Tony Helton,Medical Mutual of Ohio,3,4,1,8,
2025-09-07,Caroline S Grace,AMN Healthcare Services,0,0,0,0,
2025-09-07,Patrick Kaltenbach,Mettler-Toledo International,3,5,0,8,
2025-09-07,Michael L Baur,ScanSource,0,3,0,3,
2025-09-07,Jason Lippert,LCI Industries,1,11,0,12,
2025-09-07,Fredric J Tomczyk,Cboe Global Markets,1,7,0,8,
2025-09-07,Octavio Marquez,Diebold Nixdorf,5,10,1,16,
2025-09-07,Sivasankaran Somasundaram,ChampionX,7,2,0,9,
2025-09-07,Ronald F Clarke,Corpay,0,1,0,1,
2025-09-07,Robert W Pittman,iHeartMedia,5,3,0,8,
2025-09-07,Patrick Zalupski,Dream Finders Homes,22,16,2,40,
2025-09-07,Keith E Smith,Boyd Gaming,0,6,1,7,
2025-09-07,Mehran Assadi,NLV Financial,1,1,0,2,
2025-09-07,Barry R Port,Ensign Group,3,4,2,9,
2025-09-07,Denise A Paulonis,Sally Beauty,1,2,0,3,
2025-09-07,Clifford A Skelton,Conduent,0,1,0,1,
2025-09-07,Jean-Michel Ribieras,Sylvamo,2,6,0,8,
2025-09-07,Douglas F Bauer,Tri Pointe Homes,0,6,0,6,
2025-09-07,Shawn O'Connell,EnerSys,2,5,0,7,
2025-09-07,Bill Meury,Incyte,8,14,0,22,
2025-09-07,Dale Francescon,Century Communities,3,10,3,16,
2025-09-07,Michael Nierenberg,Rithm Capital,10,28,2,40,
2025-09-07,Michael J Brown,Euronet Worldwide,2,8,0,10,
2025-09-07,Scott Seu,Hawaiian Electric Industries,5,17,3,25,
2025-09-07,Jason D Robins,DraftKings,5,3,0,8,
2025-09-07,Jonathan J Mazelsky,IDEXX Laboratories,1,1,1,3,
2025-09-07,Richard S Swartz,MYR Group,0,2,0,2,
2025-09-07,Stefano Caroti,Deckers Outdoor,2,7,1,10,
2025-09-07,Kevin R Sayer,DexCom,3,4,0,7,
2025-09-07,John T C Lee,MKS Instruments,4,9,1,14,
2025-09-07,Edward B Pitoniak,VICI Properties,1,8,0,9,
2025-09-07,Albert White III,Cooper Cos,0,0,0,0,
2025-09-07,Barry L Biffle,Frontier Airlines,1,6,6,13,
2025-09-07,Robert A Bruggeworth,Qorvo,6,4,0,10,
2025-09-07,Winnie Park,Five Below,8,29,3,40,
2025-09-07,Steven Oakland,TreeHouse Foods,4,14,0,18,
2025-09-07,James S Hagedorn,Scotts Miracle-Gro,1,0,0,1,
2025-09-07,Michael Cannon-Brookes,Atlassian,12,26,1,39,
2025-09-07,Bertrand Loy,Entegris,3,12,1,16,
2025-09-07,William E Waltz,Atkore,2,7,0,9,
2025-09-07,Celeste B Mastin,H B Fuller,1,3,0,4,
2025-09-07,Kyle T Larkin,Granite Construction,1,7,0,8,
2025-09-07,Michael J Happe,Winnebago Industries,1,3,0,4,
2025-09-07,Steven H Gunby,FTI Consulting,5,10,0,15,
2025-09-07,Stephan B Tanda,AptarGroup,0,5,2,7,
2025-09-07,Timothy P Boyle,Columbia Sportswear,3,3,2,8,
2025-09-07,Anthony J Wood,Roku,4,3,1,8,
2025-09-07,M Christopher Doyle,Civitas Resources,1,2,0,3,
2025-09-07,Andy Eidson,Alpha Metallurgical Resources,1,6,1,8,
2025-09-07,Andy L Nemeth,Patrick Industries,4,2,0,6,
2025-09-07,Roger W Jenkins,Murphy Oil,4,17,0,21,
2025-09-07,Kevin S Blair,Synovus Financial,6,2,1,9,
2025-09-07,Julie Felss Masino,Cracker Barrel Old Country Store,0,0,0,0,
2025-09-07,David M Overton,Cheesecake Factory,1,9,0,10,
2025-09-07,Nick DeIuliis,CNX Resources,7,3,0,10,
2025-09-07,Christopher Pappas,Chefs Warehouse,4,9,1,14,
2025-09-07,Tod Carpenter,Donaldson Company,2,8,0,10,
2025-09-07,Gregory L Christopher,Mueller Industries,2,5,0,7,
2025-09-07,Rob Saltiel,MRC Global,6,11,2,19,
2025-09-07,Jillian C Evanko,Chart Industries,3,7,0,10,
2025-09-07,Dave Guilmette,Alight Solutions,3,7,0,10,
2025-09-07,Joel Smejkal,Vishay Intertechnology,4,4,1,9,
2025-09-07,Dennis Degner,Range Resources,3,8,0,11,
2025-09-07,Ira D Robbins,Valley National Bancorp,1,2,0,3,
2025-09-07,Bernard Kim,Match Group,14,19,7,40,
2025-09-07,Vincent Pilette,Gen Digital,2,13,0,15,
2025-09-07,Timothy S Crane,Wintrust Financial,2,8,0,10,
2025-09-07,Pat Roche,Moog inc,4,11,2,17,
2025-09-07,Mark R Widmar,First Solar,2,9,1,12,
2025-09-07,Niko Lahanas,Central Garden & Pet,2,12,0,14,
2025-09-07,Chris Osowski,Green Plains inc,7,12,1,20,
2025-09-07,Derek J Leathers,Werner Enterprises,2,7,0,9,
2025-09-07,Adam Foroughi,AppLovin,10,25,5,40,
2025-09-07,Luca Savi,ITT,0,0,0,0,
2025-09-07,Lawrence H Silber,Herc Rentals,0,0,0,0,
2025-09-07,Hilton H Howell Jr,Gray Television,7,21,1,29,
2025-09-07,Eric D Ashleman,IDEX,0,9,1,10,
2025-09-07,Owen D Thomas,Boston Properties,3,7,0,10,
2025-09-07,Kurt Wolf,Pitney Bowes,5,18,3,26,
2025-09-07,Sara E Armbruster,Steelcase,2,0,0,2,
2025-09-07,Charles D. Young,Sun Communities,2,5,0,7,
2025-09-07,Suzanne Foster,AdaptHealth,5,8,1,14,
2025-09-07,Grant E Sims,Genesis Energy,1,2,0,3,
2025-09-07,Laura Prieskorn,Jackson Financial,2,6,2,10,
2025-09-07,Rick L Wessel,FirstCash,4,5,1,10,
2025-09-07,Sherman Miller,Cal-Maine Foods,10,30,0,40,
2025-09-07,Paul A Lang,Arch Resources,5,3,1,9,
2025-09-07,Ashish K Khandpur,Avient,2,6,0,8,
2025-09-07,Shyam K Reddy,BlueLinx,1,7,0,8,
2025-09-07,Christopher S Ripley,Sinclair,1,8,0,9,
2025-09-07,Stacy Kymes,BOK Financial,8,6,0,14,
2025-09-07,James H Walter,Permian Resources,0,1,0,1,
2025-09-07,Jason Murray,PACS Group,5,14,2,21,
2025-09-07,Brian Armstrong,Coinbase Global,11,23,6,40,
2025-09-07,Oscar K Brown,Western Midstream Partners,1,3,0,4,
2025-09-07,Nicholas R Lower,Federated Mutual Insurance,0,1,0,1,
2025-09-07,Morris Goldfarb,G-III Apparel Group,9,25,6,40,
2025-09-07,Mark D Morelli,Vontier,0,4,0,4,
2025-09-07,Matthew J Cox,Matson inc,1,6,0,7,
2025-09-07,David W Grzebinski,Kirby Corporation,1,3,0,4,
2025-09-07,Keith A Harvey,Kaiser Aluminum,3,4,2,9,
2025-09-07,Eric Nyman,Vista Outdoor,4,11,1,16,
2025-09-07,Doug Howe,Designer Brands,5,19,0,24,
2025-09-07,Jerry E Gahlhoff Jr,Rollins inc,0,2,0,2,
2025-09-07,D Scott Barbour,Advanced Drainage Systems,2,2,0,4,
2025-09-07,Sean Gamble,Cinemark,18,20,2,40,
2025-09-07,George Kurtz,CrowdStrike,17,20,3,40,
2025-09-07,Bill Ready,Pinterest,25,15,0,40,
2025-09-07,Fidji Simo,Instacart,10,29,1,40,
2025-09-07,Kimberly K Ryan,Hillenbrand,3,6,0,9,
2025-09-07,David S Graziosi,Allison Transmission,1,17,3,21,
2025-09-07,Gary G Friedman,Restoration Hardware,1,5,0,6,
2025-09-07,Lucinda M Baier,Brookdale Senior Living,4,4,0,8,
2025-09-07,Brian J Blaser,QuidelOrtho,0,10,0,10,
2025-09-07,E Jean Savage,Trinity Industries,1,8,1,10,
2025-09-07,Liam J Kelly,Teleflex,1,5,1,7,
2025-09-07,Laurans A Mendelson,HEICO,8,20,1,29,
2025-09-07,Frank H Laukien,Bruker,1,8,0,9,
2025-09-07,Harvey M Schwartz,Carlyle Group,5,14,0,19,
2025-09-07,Mark S LaVigne,Energizer,3,1,0,4,
2025-09-07,Joel Quadracci,Quad/Graphics,12,23,5,40,
2025-09-07,Amar Maletira,Rackspace Technology,5,12,2,19,
2025-09-07,Udit Batra,Waters Corporation,10,25,1,36,
2025-09-07,Eric M Green,West Pharmaceutical Services,3,7,0,10,
2025-09-07,Doug Palladini,Carters inc,2,2,2,6,
2025-09-07,G Mike Mikan,NeueHealth,4,2,0,6,
2025-09-07,Russell ChipChilds,SkyWest,0,0,0,0,
2025-09-07,Christopher H Hunter,Acadia Healthcare,0,2,0,2,
2025-09-07,Prahlad Singh,Revvity,2,8,0,10,
2025-09-07,Maria M Pope,Portland General Electric,1,1,0,2,
2025-09-07,Charles Chip Blankenship,Woodward inc,0,1,0,1,
2025-09-07,Mike Steib,TEGNA,15,20,1,36,
2025-09-07,Kurt J Ekert,Sabre Corporation,0,1,0,1,
2025-09-07,Matt Wilson,Light & Wonder,17,19,4,40,
2025-09-07,Rob Katz,Vail Resorts,4,13,23,40,
2025-09-07,Schnitzer Steel Industries,Radius Recycling,9,25,6,40,
2025-09-07,David A Spector,PennyMac Financial Services,3,1,0,4,
2025-09-07,Frederick J Holzgrefe III,Saia inc,1,1,0,2,
2025-09-07,Mark J Parrell,Equity Residential,4,7,0,11,
2025-09-07,John W Lindsay,Helmerich & Payne,0,4,0,4,
2025-09-07,Gary D Burnison,Korn Ferry,4,11,0,15,
2025-09-07,Timothy J McGrath,PC Connection Inc,1,3,0,4,
2025-09-07,Lynn M Bamford,Curtiss-Wright,12,8,0,20,
2025-09-07,Jonathan W Witter,Sallie Mae,0,1,0,1,
2025-09-07,Jeff Benck,Benchmark Electronics,10,8,0,18,
2025-09-07,Charles H Giancarlo,Pure Storage,0,4,0,4,
2025-09-07,Brian R Gray,Knife River Corporation,0,1,0,1,
2025-09-07,Jay Schmidt,Caleres inc,3,5,2,10,
2025-09-07,Dale Asplund,BrightView Holdings,1,5,0,6,
2025-09-07,Jeffrey S Edwards,Cooper-Standard,0,5,0,5,
2025-09-07,Glenn J Williams,Primerica,6,1,2,9,
2025-09-07,Francois Locoh-Donou,F5,8,23,2,33,
2025-09-07,Joseph Wm Foran,Matador Resources,8,9,0,17,
2025-09-07,Sridhar Ramaswamy,Snowflake inc,7,19,3,29,
2025-09-07,Mark D Dankberg,Viasat,2,4,3,9,
2025-09-07,Francisco J Leon,California Resources,1,4,1,6,
2025-09-07,Peter Stern,Peloton,18,18,4,40,
2025-09-07,David Baszucki,Roblox,10,21,9,40,
2025-09-07,Jeffrey W Edwards,Installed Building Products,0,2,0,2,
2025-09-07,Clark Lauritzen,First National of Nebraska,1,7,0,8,
2025-09-07,Carlos Alberini,Guess inc,13,26,1,40,
2025-09-07,Shyam P Kambeyanda,ESAB,4,3,0,7,
2025-09-07,Edmund Shallcross III,Amica Mutual Insurance,1,5,0,6,
2025-09-07,Benjamin W Schall,AvalonBay Communities,1,5,1,7,
2025-09-07,Allan C Thygesen,DocuSign,2,8,0,10,
2025-09-07,Bryan J Knutson,Titan Machinery,1,3,1,5,
2025-09-07,Heath Sampson,ModivCare,8,2,0,10,
2025-09-07,Ara K Hovnanian,Hovnanian Enterprises,1,16,1,18,
2025-09-07,Joshua G Silverman,Etsy,2,2,0,4,
2025-09-07,Kevin Roycraft,Adams Resources & Energy,5,4,1,10,
2025-09-07,J Eric Evans,Surgery Partners,1,2,0,3,
2025-09-07,Clint E Stein,Columbia Banking System,1,7,0,8,
2025-09-07,Lee M Shavel,Verisk Analytics,3,7,0,10,
2025-09-07,Dave Banyard Jr,MasterBrand,0,0,0,0,
2025-09-07,Peter R Ingram,Hawaiian Airlines inc,1,0,0,1,
2025-09-07,Kristin A Dolan,AMC Networks,3,2,0,5,
2025-09-07,Brendan T Cavanagh,SBA Communications,1,2,0,3,
2025-09-07,George F Chappelle Jr,Americold Realty Trust,1,3,0,4,
2025-09-07,Thomas E Gottwald,NewMarket Corporation,2,8,0,10,
2025-09-07,Thomas J Baltimore Jr,Park Hotels & Resorts,4,32,0,36,
2025-09-07,Peter M Moglia,Alexandria Real Estate Equities,3,5,0,8,
2025-09-07,Ronald J Kramer,Griffon Corporation,1,6,0,7,
2025-09-07,John L Plueger,Air Lease,2,14,0,16,
2025-09-07,Jennifer F Scanlon,UL Solutions,1,3,0,4,
2025-09-07,Greg Smith,Teradyne,2,8,2,12,
2025-09-07,Sean Trauschke,OGE Energy,18,5,0,23,
2025-09-07,Norman D Schwartz,Bio-Rad Laboratories,0,1,1,2,
2025-09-07,Scott Doyle,Spire inc,4,5,1,10,
2025-09-07,Michael E Reed,Gannett,0,5,2,7,
2025-09-07,Cindy J Miller,Stericycle,2,6,1,9,
2025-09-07,Phillip D Green,Cullen Frost Bankers,1,5,3,9,
2025-09-07,Joseph D Margolis,Extra Space Storage,0,9,1,10,
2025-09-07,Mark A Skonieczny,REV Group,7,2,1,10,
2025-09-07,Ladd Wilks,ProFrac Holding,4,2,0,6,
2025-09-07,Sundaram Nagarajan,Nordson,0,8,1,9,
2025-09-07,Anne P Noonan,Summit Materials,0,1,0,1,
2025-09-07,Lori Flees,Valvoline inc,4,5,1,10,
2025-09-07,Scott H Baxter,Kontoor Brands,2,2,0,4,
2025-09-07,Tim Larson,Skyline Champion,7,0,0,7,
2025-09-07,Chuck Divita,Teladoc Health,10,20,5,35,
2025-09-07,W Bradley Southern,Louisiana-Pacific Corporation,0,0,0,0,
2025-09-07,George C Freeman III,Universal Corporation,2,6,0,8,
2025-09-07,James A Brock,Consol Energy,2,0,0,2,
2025-09-07,Robert Antokol,Playtika Holding,1,7,1,9,
2025-09-07,Joe Craft,Alliance Resource Partners,8,8,2,18,
2025-09-07,Paul Keel,Envista,1,7,1,9,
2025-09-07,Jared Isaacman,Shift4 Payments,6,28,6,40,
2025-09-07,Mark Mac McFarland,Talen Energy,3,1,1,5,
2025-09-07,Tony R Thene,Carpenter Technology,1,9,0,10,
2025-09-07,Melissa D Smith,WEX,1,6,1,8,
2025-09-07,James Jim C Ryan III,Old National Bancorp,1,0,0,1,
2025-09-07,Peter J Federico,AGNC Investment,1,0,0,1,
2025-09-07,Brent L Yeagy,Wabash National,0,0,0,0,
2025-09-07,Henry A Fernandez,MSCI,3,15,0,18,
2025-09-07,Mark Penn,Stagwell,14,22,3,39,
2025-09-07,Julie Schertell,Mativ,3,9,0,12,
2025-09-07,Ashish Chand,Belden,3,6,1,10,
2025-09-07,Greg Anderson,Allegiant Travel Company,5,10,0,15,
2025-09-07,Drew Houston,Dropbox,13,20,7,40,
2025-09-07,Kevin T Conroy,Exact Sciences,1,6,2,9,
2025-09-07,Rex D Geveden,BWX Technologies,4,6,0,10,
2025-09-07,Scott R Wells,Clear Channel Outdoor Hldgs,0,0,0,0,
2025-09-07,Paul Bay,Ingram Micro,10,25,5,40,
2025-09-08,Doug McMillon,Walmart,16,18,6,40,
2025-09-08,Andrew Jassy,Amazon,3,32,5,40,
2025-09-08,Tim Cook,Apple,14,22,4,40,
2025-09-08,Stephen Hemsley,UnitedHealth,8,27,5,40,
2025-09-08,Warren Buffett,Berkshire Hathaway,13,18,9,40,
2025-09-08,David Joyner,CVS Health,7,28,5,40,
2025-09-08,Darren Woods,Exxon Mobil,9,24,6,39,
2025-09-08,Sundar Pichai,Alphabet,19,14,7,40,
2025-09-08,Brian Tyler,McKesson,5,15,6,26,
2025-09-08,Robert Mauch,Cencora,3,7,0,10,
2025-09-08,Ron Vachris,Costco,6,32,2,40,
2025-09-08,Jamie Dimon,JPMorgan Chase,11,18,11,40,
2025-09-08,Satya Nadella,Microsoft,17,22,1,40,
2025-09-08,Jason Hollar,Cardinal Health,13,23,4,40,
2025-09-08,Mike Wirth,Chevron,16,16,8,40,
2025-09-08,David Cordani,Cigna,20,16,4,40,
2025-09-08,Jim Farley,Ford Motor,17,17,6,40,
2025-09-08,Brian Moynihan,Bank of America,6,29,5,40,
2025-09-08,Mary Barra,General Motors,12,21,7,40,
2025-09-08,Gail Boudreaux,Elevance Health,16,17,7,40,
2025-09-08,Jane Fraser,Citigroup,11,25,4,40,
2025-09-08,Sarah London,Centene,14,17,9,40,
2025-09-08,Ted Decker,Home Depot,13,24,3,40,
2025-09-08,Maryann Mannen,Marathon Petroleum,6,13,1,20,
2025-09-08,Ron Sargent,Kroger,5,21,14,40,
2025-09-08,Mark Lashier,Phillips 66,12,19,7,38,
2025-09-08,Priscilla Almodovar,Fannie Mae,10,15,15,40,
2025-09-08,Tim Wentworth,Walgreens,8,23,9,40,
2025-09-08,Lane Riggs,Valero Energy,13,7,0,20,
2025-09-08,Mark Zuckerberg,Meta,8,24,8,40,
2025-09-08,Hans Vestberg,Verizon,15,20,5,40,
2025-09-08,John Stankey,AT&T,11,24,5,40,
2025-09-08,Brian Roberts,Comcast,10,28,2,40,
2025-09-08,Charles Scharf,Wells Fargo,28,7,5,40,
2025-09-08,David Solomon,Goldman Sachs,10,21,9,40,
2025-09-08,Michael Hutchins,Freddie Mac,3,10,4,17,
2025-09-08,Michael Fiddelke,Target,9,24,7,40,
2025-09-08,Jim Rechtin,Humana,19,16,5,40,
2025-09-08,Jon Farney,State Farm Insurance,1,15,3,19,
2025-09-08,Elon Musk,Tesla,8,29,3,40,
2025-09-08,Ted Pick,Morgan Stanley,15,21,4,40,
2025-09-08,Joaquin Duato,Johnson & Johnson,10,26,4,40,
2025-09-08,Juan Luciano,Archer Daniels Midland,3,19,18,40,
2025-09-08,Ramon Laguarta,PepsiCo,8,27,5,40,
2025-09-08,Carol Tom√©,UPS,5,23,12,40,
2025-09-08,Rajesh Subramaniam,FedEx,10,26,0,36,
2025-09-08,Bob Iger,Walt Disney,8,30,2,40,
2025-09-08,Michael Dell,Dell Technologies,10,27,3,40,
2025-09-08,Marvin Ellison,Lowes,14,25,0,39,
2025-09-08,Jon Moeller,Procter & Gamble,5,27,8,40,
2025-09-08,Thomas Long,Energy Transfer,7,0,2,9,
2025-09-08,Kelly Ortberg,Boeing,9,25,6,40,
2025-09-08,Susan Morris,Albertsons,13,24,3,40,
2025-09-08,Kevin Hourican,Sysco,8,28,4,40,
2025-09-08,Christopher Calio,RTX,6,12,0,18,
2025-09-08,Larry Culp,General Electric,10,28,2,40,
2025-09-08,James Taiclet,Lockheed Martin,13,19,8,40,
2025-09-08,Stephen Squeri,American Express,16,22,2,40,
2025-09-08,Joe Creed,Caterpillar,11,27,2,40,
2025-09-08,Michel Khalaf,MetLife,12,18,1,31,
2025-09-08,Samuel Hazen,HCA Healthcare,8,7,0,15,
2025-09-08,Tricia Griffith,Progressive Insurance,9,26,5,40,
2025-09-08,Arvind Krishna,IBM,13,21,6,40,
2025-09-08,John May,Deere,9,23,8,40,
2025-09-08,Jensen Huang,Nvidia,3,7,0,10,
2025-09-08,Philip Smith,StoneX,0,11,0,11,
2025-09-08,Robert M Davis,Merck,3,21,0,24,
2025-09-08,Ryan Lance,ConocoPhillips,15,20,5,40,
2025-09-08,Albert Bourla,Pfizer,26,10,4,40,
2025-09-08,Ed Bastian,Delta Air Lines,11,19,10,40,
2025-09-08,Patrick Zammit,TD Synnex,10,14,0,24,
2025-09-08,Kevin Murphy,Publix Super Markets,10,21,1,32,
2025-09-08,Thomas J Wilson,Allstate,1,7,1,9,
2025-09-08,Chuck Robbins,Cisco Systems,14,23,3,40,
2025-09-08,Kirt Walker,Nationwide Insurance,4,6,0,10,
2025-09-08,Christopher Winfrey,Charter Communications,5,16,5,26,
2025-09-08,Bob Michael,AbbVie,0,0,0,0,
2025-09-08,Craig DeSanto,New York Life Insurance,3,18,0,21,
2025-09-08,Lip-Bu Tan,Intel,8,18,14,40,
2025-09-08,Ernie Herrman,TJX,15,23,2,40,
2025-09-08,Andrew Sullivan,Prudential Financial,11,21,0,32,
2025-09-08,Enrique Lores,Hewlett Packard,11,17,6,34,
2025-09-08,Scott Kirby,United Airlines,33,5,2,40,
2025-09-08,George Holm,Performance Food,8,23,2,33,
2025-09-08,Donnie King,Tyson Foods,9,26,5,40,
2025-09-08,Robert Isom,American Airlines,8,24,8,40,
2025-09-08,Timothy M Sweeney,Liberty Mutual Insurance,12,0,0,12,
2025-09-08,Elliott Hill,Nike,11,26,3,40,
2025-09-08,Safra Catz,Oracle,13,19,8,40,
2025-09-08,AJ Jim Teague,Enterprise Products Partners,7,14,0,21,
2025-09-08,Richard Fairbank,Capital One,15,23,2,40,
2025-09-08,Willie Chiang,Plains GP,3,5,1,9,
2025-09-08,Michael Kasbar,World Kinect,2,9,0,11,
2025-09-08,Peter Zaffino,American International Group,9,27,4,40,
2025-09-08,James Quincey,The Coca-Cola Company,11,27,2,40,
2025-09-08,Thasunda Brown Duckett,TIAA,21,19,0,40,
2025-09-08,Jay Debertin,CHS,6,11,4,21,
2025-09-08,Chris Boerner,Bristol-Myers Squibb,10,24,6,40,
2025-09-08,Corie Barry,Best Buy,39,1,0,40,
2025-09-08,Marc Casper,Thermo Fisher Scientific,13,24,3,40,
2025-09-08,Roger Crandall,Mass Mutual,2,8,0,10,
2025-09-08,Juan Andrade,USAA,5,17,0,22,
2025-09-08,Phebe Novakovic,General Dynamics,28,9,3,40,
2025-09-08,Alan Schnitzer,Travelers Insurance,3,5,2,10,
2025-09-08,David Zaslav,Warner Bros Discovery,3,24,13,40,
2025-09-08,Gunjan Kedia,US Bancorp,14,24,2,40,
2025-09-08,Robert Ford,Abbott Laboratories,13,22,5,40,
2025-09-08,Kathy Warden,Northrop Grumman,14,22,4,40,
2025-09-08,Tim Gerend,Northwestern Mutual,13,26,1,40,
2025-09-08,Todd Vasos,Dollar General,6,27,7,40,
2025-09-08,Matthew Lucey,PBF Energy,7,2,1,10,
2025-09-08,Dara Khosrowshahi,Uber,11,23,6,40,
2025-09-08,Vimal Kapur,Honeywell,10,30,0,40,
2025-09-08,Dirk Van de Put,Mondelez,8,29,3,40,
2025-09-08,Brian Niccol,Starbucks,12,25,3,40,
2025-09-08,Cristiano Amon,Qualcomm,12,26,2,40,
2025-09-08,Hock Tan,Broadcom,13,25,2,40,
2025-09-08,David Flitman,US Foods,3,7,0,10,
2025-09-08,Paul Romanowski,DR Horton,5,15,5,25,
2025-09-08,Jacek Olczak,Philip Morris,13,24,3,40,
2025-09-08,Preston Feight,Paccar,10,26,2,38,
2025-09-08,Marc Benioff,Salesforce,9,19,12,40,
2025-09-08,Leon Topalian,Nucor,14,23,3,40,
2025-09-08,Michael Dastoor,Jabil,1,7,0,8,
2025-09-08,Jonathan Jaffe,Lennar,0,8,2,10,
2025-09-08,David Ricks,Eli Lilly,10,19,11,40,
2025-09-08,Joe Zubretsky,Molina Healthcare,6,5,4,15,
2025-09-08,Jennifer Rumsey,Cummins,7,27,6,40,
2025-09-08,Robin Vince,Bank of New York Mellon,20,18,2,40,
2025-09-08,Ted Sarandos,Netflix,12,26,2,40,
2025-09-08,William H Rogers Jr,Truist Financial,2,7,0,9,
2025-09-08,Sean Kerins,Arrow Electronics,2,12,0,14,
2025-09-08,William M Brown,3M,2,8,0,10,
2025-09-08,Ryan McInerney,Visa,12,24,4,40,
2025-09-08,Marc Rowan,Apollo Global Management,0,0,0,0,
2025-09-08,Tim Go,HF Sinclair,6,3,0,9,
2025-09-08,Robert Sulentic,CBRE Group,1,7,1,9,
2025-09-08,William Demchak,PNC Financial Services,16,19,5,40,
2025-09-08,Bryan DeBoer,Lithia Motors,7,32,1,40,
2025-09-08,William Nash,CarMax,4,3,2,9,
2025-09-08,Brian Robbins,Paramount Global,8,31,1,40,
2025-09-08,Michael Creedon,Dollar Tree,5,32,3,40,
2025-09-08,Sandy Douglas,United Natural Foods,34,5,1,40,
2025-09-08,Alex Chriss,PayPal,0,0,0,0,
2025-09-08,Roger Penske,Penske Automotive,18,21,1,40,
2025-09-08,Antonio Neri,Hewlett Packard Enterprise,10,23,7,40,
2025-09-08,Harry Sideris,Duke Energy,36,4,0,40,
2025-09-08,Vicki Hollub,Occidental Petroleum,20,17,3,40,
2025-09-08,Lawrence Coben,NRG Energy,5,3,0,8,
2025-09-08,Robert Bradway,Amgen,11,27,2,40,
2025-09-08,John Ketchum,NextEra Energy,23,17,0,40,
2025-09-08,Rainer Blair,Danaher,6,17,2,25,
2025-09-08,Daniel O'Day,Gilead Sciences,18,19,3,40,
2025-09-08,Michael Manley,AutoNation,3,6,1,10,
2025-09-08,Carlos Abrams-Rivera,Kraft Heinz,5,32,3,40,
2025-09-08,Philip Gallagher,Avnet,0,4,0,4,
2025-09-08,Gary Dickerson,Applied Materials,5,23,12,40,
2025-09-08,Bob Jordan,Southwest Airlines,10,23,7,40,
2025-09-08,Rick Wurster,Charles Schwab,14,21,4,39,
2025-09-08,Lorenzo Simonelli,Baker Hughes,17,19,4,40,
2025-09-08,Chris Kempczinski,McDonalds,10,22,8,40,
2025-09-08,Christopher Womack,Southern Company,3,7,0,10,
2025-09-08,Michael Miebach,Mastercard,12,24,4,40,
2025-09-08,Joseph Dominguez,Constellation Energy,13,11,1,25,
2025-09-08,Christopher Swift,The Hartford,16,19,5,40,
2025-09-08,Patricia Poppe,PG&E,8,15,2,25,
2025-09-08,Bom Kim,Coupang,13,26,1,40,
2025-09-08,Ezra Yacob,EOG Resources,23,15,2,40,
2025-09-08,Jim Vena,Union Pacific,22,18,0,40,
2025-09-08,Matt Schroeder,Rite Aid,4,33,3,40,
2025-09-08,Tony Spring,Macys,10,24,6,40,
2025-09-08,Anthony Capuano,Marriott International,13,25,2,40,
2025-09-08,Raymond E Scott,Lear Corporation,4,6,0,10,
2025-09-08,William Stengel II,Genuine Parts,0,4,0,4,
2025-09-08,Heidi Petz,Sherwin-Williams,10,28,2,40,
2025-09-08,Jeff Miller,Halliburton,11,23,6,40,
2025-09-08,Kathleen Quirk,Freeport-McMoRan,14,18,2,34,
2025-09-08,Michael Rapino,Live Nation Entertainment,14,23,3,40,
2025-09-08,John Doyle,Marsh & McLennan,11,9,1,21,
2025-09-08,Lisa Su,Advanced Micro Devices,17,20,3,40,
2025-09-08,Frank Holding,First Citizens BancShares,9,14,2,25,
2025-09-08,John Engel,WESCO International,5,12,1,18,
2025-09-08,David Gitlin,Carrier Global,15,23,2,40,
2025-09-08,Lourenco Goncalves,Cleveland-Cliffs,6,19,15,40,
2025-09-08,Calvin G Butler Jr,Exelon,6,4,0,10,
2025-09-08,Joseph Bae,KKR,19,19,2,40,
2025-09-08,Christine Leahy,CDW,0,7,2,9,
2025-09-08,Glenn Fogel,Booking Holdings,10,23,7,40,
2025-09-08,Brian Doubles,Synchrony Financial,5,8,1,14,
2025-09-08,Earl Austin,Quanta Services,2,5,2,9,
2025-09-08,Christian Ulbrich,Jones Lang LaSalle,8,16,0,24,
2025-09-08,Saumya Sutaria,Tenet Healthcare,5,3,1,9,
2025-09-08,William Gifford,Altria,3,5,1,9,
2025-09-08,Kevin Lobo,Stryker,11,26,3,40,
2025-09-08,Michael Hsu,Kimberly-Clark,5,7,1,13,
2025-09-08,Jack Fusco,Cheniere Energy,18,18,4,40,
2025-09-08,James Conroy,Ross Stores,4,12,0,16,
2025-09-08,Anthony Smurfit,Smurfit Westrock,4,6,0,10,
2025-09-08,Jeffrey Harmening,General Mills,4,15,5,24,
2025-09-08,Mark Stewart,Goodyear Tire & Rubber,4,36,0,40,
2025-09-08,Bob Eddy,BJs Wholesale Club,3,19,3,25,
2025-09-08,Peter Arduini,GE HealthCare Technologies,5,11,0,16,
2025-09-08,Noel Wallace,Colgate-Palmolive,11,23,2,36,
2025-09-08,Marc Bitzer,Whirlpool,12,14,14,40,
2025-09-08,Chris Kubasik,L3Harris Technologies,7,13,1,21,
2025-09-08,Shantanu Narayen,Adobe,18,20,1,39,
2025-09-08,Thomas Polen,Becton Dickinson,5,5,0,10,
2025-09-08,Richard P Dealy,Pioneer Natural Resources,6,3,0,9,
2025-09-08,Ravi Kumar S,Cognizant Technology Solutions,13,23,4,40,
2025-09-08,Andrew Clyde,Murphy USA,11,28,1,40,
2025-09-08,Mike Lyons,Fiserv,4,12,1,17,
2025-09-08,Jennifer Parmentier,Parker-Hannifin,2,12,0,14,
2025-09-08,William Fehrman,American Electric Power,4,6,0,10,
2025-09-08,Andrew Silvernail,International Paper,4,23,0,27,
2025-09-08,Jonas Prising,ManpowerGroup,7,21,2,30,
2025-09-08,John Zillmer,Aramark,6,12,2,20,
2025-09-08,Mark Millett,Steel Dynamics,19,2,0,21,
2025-09-08,Dan Amos,Aflac,14,17,9,40,
2025-09-08,Tony Cheng,Reinsurance Group of America,3,8,2,13,
2025-09-08,Karsanbhai,Emerson Electric,7,15,3,25,
2025-09-08,Ronald P O'Hanley,State Street,4,15,0,19,
2025-09-08,Timothy Knavish,PPG Industries,1,1,0,2,
2025-09-08,David Burritt,United States Steel,8,20,12,40,
2025-09-08,Maria Black,Automatic Data Processing,5,3,0,8,
2025-09-08,Daryl Kenningham,Group 1 Automotive,7,31,2,40,
2025-09-08,Robert Blue,Dominion Energy,26,13,1,40,
2025-09-08,Larry Fink,BlackRock,7,22,11,40,
2025-09-08,Pierce Norton II,Oneok,5,3,1,9,
2025-09-08,David Bozeman,CH Robinson Worldwide,2,8,0,10,
2025-09-08,Haviv Ilan,Texas Instruments,15,22,3,40,
2025-09-08,Michael Bender,Kohls,0,0,0,0,
2025-09-08,Philip Daniele III,AutoZone,0,2,0,2,
2025-09-08,Timothy Archer,Lam Research,3,6,1,10,
2025-09-08,Charles Magro,Corteva,4,3,1,8,
2025-09-08,Rick Lanoha,Peter Kiewit Sons',0,2,0,2,
2025-09-08,Peter Jackson,Builders FirstSource,5,11,1,17,
2025-09-08,Martin Schroeter,Kyndryl,10,29,0,39,
2025-09-08,Hamid Akhavan,EchoStar,5,26,8,39,
2025-09-08,Bill Westrate,American Family Insurance,10,17,2,29,
2025-09-08,Avigal Soreq,Delek US,4,8,5,17,
2025-09-08,Beth Ford,Land O'Lakes,18,22,0,40,
2025-09-08,Walker Martin,Sempra,0,2,0,2,
2025-09-08,Eric Slifka,Global Partners,12,22,6,40,
2025-09-08,DG Macpherson,WW Grainger,2,7,1,10,
2025-09-08,Bob Pragada,Jacobs Solutions,6,10,0,16,
2025-09-08,Pedro Pizarro,Edison International,16,8,16,40,
2025-09-08,William Hornbuckle,MGM Resorts International,9,24,1,34,
2025-09-08,Andrew McMahon,Guardian Life insurance,6,11,0,17,
2025-09-08,Christopher O'Herlihy,Illinois Tool Works,4,4,1,9,
2025-09-08,James Cracchiolo,Ameriprise Financial,2,23,2,27,
2025-09-08,Ryan Marshall,PulteGroup,9,14,12,35,
2025-09-08,Matthew Meloy,Targa Resources,5,5,0,10,
2025-09-08,Michael Rhodes,Ally Financial,9,26,5,40,
2025-09-08,Joseph Fadool,BorgWarner,4,10,0,14,
2025-09-08,St√©phane de La Faverie,Est√©e Lauder,13,22,5,40,
2025-09-08,Benjamin Tisch,Loews,2,7,0,9,
2025-09-08,Brad Beckham,O'Reilly Automotive,5,17,1,23,
2025-09-08,Thomas Gayner,Markel Group,1,9,0,10,
2025-09-08,Donald Allan,Stanley Black & Decker,8,31,1,40,
2025-09-08,Sanjay Mehrotra,Micron Technology,17,21,2,40,
2025-09-08,James Breuer,Fluor,1,2,1,4,
2025-09-08,Thomas Bell,Leidos,9,17,2,28,
2025-09-08,Scott Smith,Viatris,7,4,0,11,
2025-09-08,Kimberly Dang,Kinder Morgan,11,1,0,12,
2025-09-08,Christophe Beck,Ecolab,18,22,0,40,
2025-09-08,Brent Shafer,Baxter International,1,10,0,11,
2025-09-08,Clay Gaspar,Devon Energy,22,3,0,25,
2025-09-08,Steven Cahillane,Kellanova,1,8,0,9,
2025-09-08,Raul Nicholas Vargas Ochoa,Farmers Insurance Exchange,0,0,0,0,
2025-09-08,Darren Rebelez,Caseys General Stores,3,6,0,9,
2025-09-08,Ari Bousbib,IQVIA,6,17,0,23,
2025-09-08,Jon Vander Ark,Republic Services,12,19,9,40,
2025-09-08,Timothy Cofer,Keurig Dr Pepper,2,6,1,9,
2025-09-08,Karla Lewis,Reliance Inc,3,6,0,9,
2025-09-08,David Hult,Asbury Automotive Group,9,30,1,40,
2025-09-08,Darryl Button,Pacific Life,1,8,0,9,
2025-09-08,James Burke,Vistra,6,3,0,9,
2025-09-08,John Barrett,Western & Southern Financial,10,28,2,40,
2025-09-08,William Krueger,The Andersons Inc,0,4,0,4,
2025-09-08,Erik Nordstrom,Nordstrom,7,29,4,40,
2025-09-08,John Wren,Omnicom Group,13,21,6,40,
2025-09-08,Stephanie Ferris,Fidelity National Information Services,15,22,3,40,
2025-09-08,Timothy Cawley,Consolidated Edison,4,5,0,9,
2025-09-08,Joseph Hinrichs,CSX,6,11,1,18,
2025-09-08,Troy Rudd,AECOM,9,23,4,36,
2025-09-08,Kathleen Johnson,Lumen Technologies,4,5,1,10,
2025-09-08,Harry Lawton III,Tractor Supply,1,1,0,2,
2025-09-08,Raul Fernandez,DXC Technology,4,30,2,36,
2025-09-08,Eric Hansotia,AGCO,16,23,1,40,
2025-09-08,David Bruton Smith,Sonic Automotive,4,8,9,21,
2025-09-08,Sasan Goodarzi,Intuit,9,27,4,40,
2025-09-08,Matthew Flannery,United Rentals,32,2,0,34,
2025-09-08,Marc Miller,Universal Health Services,4,19,3,26,
2025-09-08,Michael Mahoney,Boston Scientific,12,28,0,40,
2025-09-08,Judith Marks,Otis Worldwide,3,3,0,6,
2025-09-08,Robert Frenzel,Xcel Energy,4,2,1,7,
2025-09-08,Penny Pennington,Edward Jones,8,26,6,40,
2025-09-08,Daniel Fisher,Ball,2,22,6,30,
2025-09-08,Justin Jude,LKQ,4,6,1,11,
2025-09-08,James Blackledge,Mutual of Omaha,2,32,1,35,
2025-09-08,Bruce Bodine,Mosaic,2,7,0,9,
2025-09-08,Scott Donnelly,Textron,8,30,2,40,
2025-09-08,Adam Schechter,Labcorp Holdings,3,5,0,8,
2025-09-08,Deanna Strable-Soethout,Principal Financial,1,6,0,7,
2025-09-08,Leonard Schleifer,Regeneron Pharmaceuticals,6,27,7,40,
2025-09-08,Paul Shoukry,Raymond James Financial,16,23,1,40,
2025-09-08,Lauren Hobart,Dicks Sporting Goods,12,24,4,40,
2025-09-08,Jamie Whisnant,Auto-Owners Insurance,0,2,0,2,
2025-09-08,Ariane Gorin,Expedia,8,31,1,40,
2025-09-08,Shelley Simpson,JB Hunt Transport Services,8,28,4,40,
2025-09-08,Ren√© Jones,M&T Bank,12,24,4,40,
2025-09-08,Gerardo Norcia,DTE Energy,3,6,0,9,
2025-09-08,Andr√©s Gluski,AES,13,17,0,30,
2025-09-08,Timothy Spence,Fifth Third Bancorp,5,4,1,10,
2025-09-08,Eduardo Menezes,Air Products & Chemicals,3,6,1,10,
2025-09-08,Wendell Weeks,Corning,15,23,2,40,
2025-09-08,Anthony Guzzi,EMCOR Group,4,2,1,7,
2025-09-08,Adam Norwitt,Amphenol,3,17,0,20,
2025-09-08,Jean-Marc Gilson,Westlake Corporation,2,4,0,6,
2025-09-08,Lori Koch,DuPont,7,17,0,24,
2025-09-08,Derek Chang,Liberty Media,38,2,0,40,
2025-09-08,Martina Cheung,S&P Global,10,27,0,37,
2025-09-08,Tim Hingtgen,Community Health Systems,10,28,2,40,
2025-09-08,Brian Tierney,FirstEnergy,6,21,4,31,
2025-09-08,Rick McKenney,Unum Group,5,4,0,9,
2025-09-08,Stanley Bergman,Henry Schein,12,27,1,40,
2025-09-08,Tiang Yew Tan,Western Digital,0,4,0,4,
2025-09-08,Vincent Roche,Analog Devices,13,22,4,39,
2025-09-08,Sean Connolly,Conagra Brands,7,31,2,40,
2025-09-08,Bruce Van Saun,Citizens Financial Group,15,24,1,40,
2025-09-08,Mark George,Norfolk Southern,18,19,3,40,
2025-09-08,Andrew Marsh,Entergy,3,5,0,8,
2025-09-08,Robert Berkley,WR Berkley,8,27,5,40,
2025-09-08,Javier Rodriguez,DaVita,14,14,1,29,
2025-09-08,Michael O'Grady,Northern Trust,28,7,1,36,
2025-09-08,James Snee,Hormel Foods,2,27,1,30,
2025-09-08,Timothy J Donahue,Crown Holdings,2,10,0,12,
2025-09-08,Joseph Ferraro,Avis Budget,3,5,2,10,
2025-09-08,Niraj Shah,Wayfair,8,24,8,40,
2025-09-08,Jos√© Mas,MasTec,6,14,1,21,
2025-09-08,Joseph Nolan,Eversource Energy,4,4,1,9,
2025-09-08,Thomas Palmer,Newmont,5,5,0,10,
2025-09-08,Robert Sanchez,Ryder System,10,10,1,21,
2025-09-08,Michael Nolan,Fidelity National Financial,4,0,0,4,
2025-09-08,Gavin Hattersley,Molson Coors Beverage,5,29,6,40,
2025-09-08,Thomas Reeg,Caesars Entertainment,5,6,0,11,
2025-09-08,Ellen Cooper,Lincoln National,2,7,0,9,
2025-09-08,Bracken Darrell,VF Corporation,9,28,3,40,
2025-09-08,Erik Fyrwald,International Flavors & Fragrances,7,8,4,19,
2025-09-08,Christopher Kastner,Huntington Ingalls Industries,3,5,0,8,
2025-09-08,Shane O'Kelly,Advance Auto Parts,14,22,4,40,
2025-09-08,Ralph LaRossa,Public Service Enterprise Group,11,17,0,28,
2025-09-08,Kecia Steelman,Ulta Beauty,35,4,1,40,
2025-09-08,Michele Buck,Hershey,6,32,2,40,
2025-09-08,Sumit Singh,Chewy,12,23,5,40,
2025-09-08,Steven Vondran,American Tower,4,6,0,10,
2025-09-08,Jeffrey Lorberbaum,Mohawk Industries,11,6,1,18,
2025-09-08,Keith Demmings,Assurant,4,7,0,11,
2025-09-08,Robert Martin,Thor Industries,4,5,1,10,
2025-09-08,Kathleen Mazzarella,Graybar Electric,1,7,1,9,
2025-09-08,Joey Wat,Yum China,12,26,2,40,
2025-09-08,Scott Richardson,Celanese,9,23,4,36,
2025-09-08,David Rawlinson II,QVC,8,15,2,25,
2025-09-08,Alan Armstrong,Williams,25,11,4,40,
2025-09-08,Philippe Krakowsky,Interpublic Group,12,25,3,40,
2025-09-08,Brendan McCracken,Ovintiv,6,5,0,11,
2025-09-08,Andrew Teno,Icahn Enterprises,5,5,0,10,
2025-09-08,Stephen Steinour,Huntington Bancshares,2,7,0,9,
2025-09-08,Timothy NeCastro,Erie Insurance,3,6,1,10,
2025-09-08,Ernest Garcia III,Carvana,24,12,4,40,
2025-09-08,R Bruce McDonald,Dana Incorporated,3,7,1,11,
2025-09-08,William Oplinger,Alcoa Corporation,1,8,0,9,
2025-09-08,Mark Pearson,Equitable,9,7,0,16,
2025-09-08,Richard Wallace,KLA,4,6,0,10,
2025-09-08,Ricardo Cardenas,Darden Restaurants,4,3,1,8,
2025-09-08,Mikael Bratt,Autoliv,5,8,2,15,
2025-09-08,Benito Minicucci,Alaska Air,3,2,1,6,
2025-09-08,Christopher Gorman,KeyCorp,5,5,0,10,
2025-09-08,Robert Goldstein,Las Vegas Sands,5,30,5,40,
2025-09-08,Edward Pesicka,Owens & Minor,3,31,2,36,
2025-09-08,Christopher Nassetta,Hilton Worldwide,8,16,2,26,
2025-09-08,Jamie Iannone,Ebay,18,18,4,40,
2025-09-08,Patrick Gallagher,Arthur J Gallagher,8,30,2,40,
2025-09-08,Rich Steinmeier,LPL Financial,25,13,2,40,
2025-09-08,Stephen Spray,Cincinnati Financial,1,7,1,9,
2025-09-08,Douglas Yearley,Toll Brothers,11,24,5,40,
2025-09-08,Gregory Brown,Motorola Solutions,1,9,0,10,
2025-09-08,Brian Chesky,Airbnb,4,29,7,40,
2025-09-08,Jeffrey Sprecher,Intercontinental Exchange,15,22,3,40,
2025-09-08,Robert Thomson,News Corp,7,31,2,40,
2025-09-08,Scott Boatwright,Chipotle Mexican Grill,7,28,5,40,
2025-09-08,Reshma Kewalramani,Vertex Pharmaceuticals,20,15,5,40,
2025-09-08,Christopher Viehbacher,Biogen,0,24,2,26,
2025-09-08,Malcolm Wilson,GXO Logistics,6,21,0,27,
2025-09-08,Tony Sarsam,SpartanNash,18,20,2,40,
2025-09-08,Michael O‚ÄôSullivan,Burlington Stores,9,27,4,40,
2025-09-08,Teresa Rasmussen,Thrivent Financial for Lutherans,4,1,0,5,
2025-09-08,Eugene Bredow,NVR,0,4,1,5,
2025-09-08,Brian Chambers,Owens Corning,3,11,0,14,
2025-09-08,Rafael Santana,Westinghouse Air Brake Technologies,3,7,1,11,
2025-09-08,John Pfeifer,Oshkosh,4,25,4,33,
2025-09-08,Cameron Bready,Global Payments,8,29,3,40,
2025-09-08,Calvin McDonald,Lululemon athletica,8,32,0,40,
2025-09-08,J Kent Masters,Albemarle Corporation,4,6,0,10,
2025-09-08,Joanna Geraghty,JetBlue Airways,13,20,7,40,
2025-09-08,Robert Steer,Seaboard,1,4,0,5,
2025-09-08,William Newlands,Constellation Brands,0,2,2,4,
2025-09-08,Michael Doss,Graphic Packaging,4,8,1,13,
2025-09-08,Gil West,Hertz,7,24,9,40,
2025-09-08,Malcolm C Roberts,FM Global,2,10,2,14,
2025-09-08,Mick Beekhuizen,Campbell Soup,8,23,0,31,
2025-09-08,Daniel Wall,Expeditors International of Washington,2,5,0,7,
2025-09-08,Gregory Roberts,A-Mark Precious Metals,1,4,1,6,
2025-09-08,Horacio Rozanski,Booz Allen Hamilton,16,19,5,40,
2025-09-08,James Davis,Quest Diagnostics,5,5,0,10,
2025-09-08,Dennis Mathew,Altice,6,27,7,40,
2025-09-08,Stefan Larsson,PVH,10,25,5,40,
2025-09-08,Mark Costa,Eastman Chemical,5,14,4,23,
2025-09-08,Joyce Mullen,Insight Enterprises,6,11,0,17,
2025-09-08,John Turner,Regions Financial,20,18,2,40,
2025-09-08,Julian G Francis,Beacon Roofing Supply,0,1,0,1,
2025-09-08,Blake Moret,Rockwell Automation,11,27,2,40,
2025-09-08,Mike Speetzen,Polaris Inc,3,18,2,23,
2025-09-08,William McDermott,ServiceNow,3,6,0,9,
2025-09-08,Jure Sola,Sanmina,2,13,0,15,
2025-09-08,Bob Flexon,UGI Utilities Inc,0,1,0,1,
2025-09-08,Scott Lauber,WEC Energy,15,6,0,21,
2025-09-08,Jon Rousseau,BrightSpring Health Services,21,18,1,40,
2025-09-08,Todd Schneider,Cintas,12,18,1,31,
2025-09-08,Peter Matt,Commercial Metals,5,4,0,9,
2025-09-08,Robert D Lawler,Continental Resources,0,0,0,0,
2025-09-08,Domenic Dell‚ÄôOsso Jr,Expand Energy,4,1,0,5,
2025-09-08,Jason P Wells,CenterPoint Energy,9,4,1,14,
2025-09-08,H Michael Krimbill,NGL Energy Partners,6,2,0,8,
2025-09-08,Tony Xu,DoorDash,11,22,7,40,
2025-09-08,Clay Williams,NOV,8,20,5,33,
2025-09-08,Kristin Peck,Zoetis,13,20,1,34,
2025-09-08,Mark Smucker,JM Smucker,14,20,6,40,
2025-09-08,Steve Sanghi,Microchip Technology,8,28,4,40,
2025-09-08,Richard Tobin,Dover Corporation,6,4,0,10,
2025-09-08,Kaes Van‚Äôt Hof,Diamondback Energy,21,15,3,39,
2025-09-08,Deon Stander,Avery Dennison,0,13,0,13,
2025-09-08,Vincent Sorgi,PPL,8,11,1,20,
2025-09-08,Hassane El-Khoury,ON Semiconductor,2,19,5,26,
2025-09-08,Arie Kotler,ARKO,5,24,0,29,
2025-09-08,William Monteleone,Par Pacific,1,6,2,9,
2025-09-08,John Christmann IV,APA,5,5,0,10,
2025-09-08,Adaire Fox-Martin,Equinix,14,22,4,40,
2025-09-08,Joseph M Otting,Flagstar Financial,3,5,2,10,
2025-09-08,Mary Dillon,Foot Locker,10,26,4,40,
2025-09-08,James Zallie,Ingredion,4,4,1,9,
2025-09-08,Christopher Peterson,Newell Brands,0,9,1,10,
2025-09-08,Scott Salmirs,ABM Industries,7,7,1,15,
2025-09-08,Christopher Hilger,Securian Financial,0,6,0,6,
2025-09-08,Hamid Moghadam,Prologis,8,27,5,40,
2025-09-08,Stephen Schwarzman,Blackstone,16,20,4,40,
2025-09-08,Robert Greenberg,Skechers USA,5,22,3,30,
2025-09-08,Keith Allman,Masco,4,9,1,14,
2025-09-08,Rusty Rush,Rush Enterprises,15,22,3,40,
2025-09-08,Jennifer Johnson,Franklin Resources,1,7,2,10,
2025-09-08,Gerry P Smith,ODP Business Solutions,0,1,0,1,
2025-09-08,Carl Lindner lll,American Financial,0,0,0,0,
2025-09-08,Mark Kowlzan,Packaging Corp of America,0,9,1,10,
2025-09-08,Thomas Hill,Vulcan Materials,4,6,2,12,
2025-09-08,Milan Galik,Interactive Brokers,7,20,2,29,
2025-09-08,Laura Alber,Williams-Sonoma,14,22,4,40,
2025-09-08,Mario Harik,XPO,8,31,1,40,
2025-09-08,Devin Stockfish,Weyerhaeuser,5,5,0,10,
2025-09-08,Thomas J McInerney,Genworth Financial,1,6,0,7,
2025-09-08,Garrick Rochow,CMS Energy,12,3,1,16,
2025-09-08,Toni Townes-Whitley,Science Applications International,12,22,1,35,
2025-09-08,Rich Handler,Jefferies Financial,12,11,2,25,
2025-09-08,Daniel Heaf,Bath & Body Works,13,25,2,40,
2025-09-08,Andrew Wilson,Electronic Arts,13,18,9,40,
2025-09-08,Sheryl Palmer,Taylor Morrison Home,8,12,1,21,
2025-09-08,Ivan Tornos,Zimmer Biomet,9,30,1,40,
2025-09-08,Linda Rendle,Clorox,2,35,2,39,
2025-09-08,Matthew Pine,Xylem Inc,1,8,1,10,
2025-09-08,Heather Lavallee,Voya Financial,7,10,2,19,
2025-09-08,Daniel Florness,Fastenal,4,4,2,10,
2025-09-08,Albert Nahmad,Watsco,2,6,0,8,
2025-09-08,Carl Eschenbach,Workday,12,19,9,40,
2025-09-08,Craig Smiddy,Old Republic International,4,5,1,10,
2025-09-08,Frank C Sullivan,RPM International,4,8,0,12,
2025-09-08,Matthew Missad,UFP Industries,7,3,0,10,
2025-09-08,Martin J Lyons,Ameren,2,3,1,6,
2025-09-08,Adam W Miller,Knight Swift Transportation,0,2,1,3,
2025-09-08,Rodney Sacks,Monster Beverage,10,28,1,39,
2025-09-08,Gary Guthart,Intuitive Surgical,12,24,4,40,
2025-09-08,Charles Liang,Super Micro Computer,35,4,1,40,
2025-09-08,Christopher Caldwell,Concentrix,3,5,0,8,
2025-09-08,Gordon J Hardie,O-I Glass,0,5,0,5,
2025-09-08,David Gibbs,Yum Brands,2,38,0,40,
2025-09-08,Steve Henry,Domtar,4,5,0,9,
2025-09-08,Chuck Treadway,CommScope,8,20,3,31,
2025-09-08,Rob Vitale,Post Holdings,1,11,5,17,
2025-09-08,Steven J Moskowitz,Crown Castle,2,5,3,10,
2025-09-08,Emmanuel Ligner,Avantor,3,11,1,15,
2025-09-08,Stuart Bradie,KBR,14,16,4,34,
2025-09-08,Carrie Wheeler,Opendoor Technologies,11,26,3,40,
2025-09-08,Russell Becker,APi Group,3,5,0,8,
2025-09-08,Toby Rice,EQT,24,13,3,40,
2025-09-08,Jesse Arenivas,EnLink Midstream,7,8,0,15,
2025-09-08,Nikesh Arora,Palo Alto Networks,5,27,8,40,
2025-09-08,Steven Bandrowczak,Xerox,1,8,1,10,
2025-09-08,Vicente Reynal,Ingersoll Rand,7,27,0,34,
2025-09-08,William T Dillard II,Dillards,3,4,2,9,
2025-09-08,C Howard Nye,Martin Marietta Materials,1,5,4,10,
2025-09-08,Giordano Albertazzi,Vertiv,16,19,5,40,
2025-09-08,Stephane Bancel,Moderna,11,22,7,40,
2025-09-08,Nate R Jorgensen,Boise Cascade,0,0,0,0,
2025-09-08,Jack Sinclair,Sprouts Farmers Market,15,25,0,40,
2025-09-08,Padraig McDonnell,Agilent Technologies,13,13,0,26,
2025-09-08,Kenneth T Lane,Olin,0,1,0,1,
2025-09-08,Randall C Stuewe,Darling Ingredients,26,1,0,27,
2025-09-08,R Howard Coker,Sonoco Products,2,7,1,10,
2025-09-08,John Mengucci,CACI International,19,19,2,40,
2025-09-08,Mark Witkowski,Core & Main,0,8,1,9,
2025-09-08,Lee M Tillman,Marathon Oil,4,3,0,7,
2025-09-08,Mark Hoplamazian,Hyatt Hotels,15,20,5,40,
2025-09-08,David S Chernow,Select Medical,0,9,0,9,
2025-09-08,Brendan M Foley,McCormick & Company,0,8,0,8,
2025-09-08,Joanne Crevoiserat,Tapestry,13,23,4,40,
2025-09-08,John Plant,Howmet Aerospace,6,12,3,21,
2025-09-08,Shankh Mitra,Welltower,16,22,2,40,
2025-09-08,W Anthony Will,CF Industries,2,3,0,5,
2025-09-08,David A Zapico,Ametek,3,18,0,21,
2025-09-08,Kevin Stein,TransDigm,10,9,2,21,
2025-09-08,Craig Billings,Wynn Resorts,13,25,2,40,
2025-09-08,William J Way,Southwestern Energy,1,1,0,2,
2025-09-08,Giel Rutten,Amkor Technology,3,8,1,12,
2025-09-08,Paul Sarvadi,Insperity,4,5,0,9,
2025-09-08,Donald Zurbay,Patterson Companies Inc,0,5,0,5,
2025-09-08,Rob Sharps,T Rowe Price,10,25,5,40,
2025-09-08,Patrice Louvet,Ralph Lauren,15,16,9,40,
2025-09-08,Jeffrey Mezger,KB Home,2,31,7,40,
2025-09-08,David M Foulkes,Brunswick,1,8,0,9,
2025-09-08,M Keith Waddell,Robert Half,2,8,1,11,
2025-09-08,Jay Snowden,PENN Entertainment,19,18,3,40,
2025-09-08,George Kurian,NetApp,16,21,3,40,
2025-09-08,Kevin Ali,Organon,9,20,2,31,
2025-09-08,Joel D Anderson,Petco Health and Wellness,3,8,0,11,
2025-09-08,Louis V Pinkham,Regal Rexnord,0,0,0,0,
2025-09-08,Jay Geldmacher,Resideo Technologies,8,6,1,15,
2025-09-08,Marcus Lemonis,Camping World,8,21,11,40,
2025-09-08,Peter R Huntsman,Huntsman,7,12,4,23,
2025-09-08,Hillary Super,Victorias Secret,11,4,8,23,
2025-09-08,Michelle Gass,Levi Strauss,12,24,3,39,
2025-09-08,Neil Hunn,Roper Technologies,3,21,0,24,
2025-09-08,Steven P Lawrence,Academy Sports and Outdoors,1,1,0,2,
2025-09-08,Phillippe Lord,Meritage Homes,8,15,0,23,
2025-09-08,David C Dauch,American Axle & Manufacturing,5,6,2,13,
2025-09-08,Olumide Soroye,Fortive,1,9,0,10,
2025-09-08,Adena Friedman,Nasdaq,14,22,4,40,
2025-09-08,Tim Gokey,Broadridge Financial Solutions,3,11,1,15,
2025-09-08,Patrick M Shanahan,Spirit AeroSystems,1,9,0,10,
2025-09-08,Robert Kyncl,Warner Music Group,10,28,2,40,
2025-09-08,Denise Dignam,Chemours,2,19,2,23,
2025-09-08,Jim DeVries,ADT,10,7,1,18,
2025-09-08,Bernard Zovighian,Edwards Lifesciences,6,7,2,15,
2025-09-08,Mark E Seaton,First American Financial,1,9,0,10,
2025-09-08,John C Roche,Hanover Insurance Group,8,19,1,28,
2025-09-08,Adam J Greenlee,Silgan,0,4,0,4,
2025-09-08,Jayne Hrdlicka,Endeavor Group,0,1,0,1,
2025-09-08,Robert Fauber,Moodys Corporation,0,5,0,5,
2025-09-08,Thomas E Jorden,Coterra Energy,9,0,0,9,
2025-09-08,Eugene A Hall,Gartner,1,9,0,10,
2025-09-08,Kevin Plank,Under Armour,8,29,3,40,
2025-09-08,James W Lanning,Ingles Markets,3,3,0,6,
2025-09-08,Matthew T Farrell,Church & Dwight,7,7,0,14,
2025-09-08,Kevin M Freeman,Old Dominion Freight Line,0,0,0,0,
2025-09-08,Joe Shoen,U-Haul,14,21,4,39,
2025-09-08,Mark Bertolini,Oscar Health,13,18,9,40,
2025-09-08,Jayshree Ullal,Arista Networks,20,18,2,40,
2025-09-08,Sassine Ghazi,Synopsys,10,27,3,40,
2025-09-08,Jochen Zeitz,Harley-Davidson,7,23,10,40,
2025-09-08,Nick Jeffery,Frontier Communications,10,26,1,37,
2025-09-08,Thomas Edward McCormick,Primoris Services,0,4,0,4,
2025-09-08,D Christian Koch,Carlisle Companies,1,2,1,4,
2025-09-08,David E Simon,Simon Property Group,3,4,3,10,
2025-09-08,Stephen Bratspies,Hanesbrands,3,11,1,15,
2025-09-08,Ryan M. Schneider,Anywhere Real Estate Inc,0,1,0,1,
2025-09-08,George Bobb III,Teledyne Technologies,1,4,1,6,
2025-09-08,Terrence A Duffy,CME Group,6,8,1,15,
2025-09-08,Rami Rahim,Juniper Networks,11,27,2,40,
2025-09-08,Sue Nabi,Coty,16,17,7,40,
2025-09-08,Peter D Arvan,Pool Corporation,2,7,0,9,
2025-09-08,David Campbell,Evergy,14,9,0,23,
2025-09-08,Matthew J Murphy,Marvell Technology,5,4,1,10,
2025-09-08,Lloyd Yates,NiSource,6,4,0,10,
2025-09-08,William C Stone,SS&C Technologies,2,6,0,8,
2025-09-08,Mark Rourke,Schneider National,10,18,1,29,
2025-09-08,Andrew Anagnost,Autodesk,9,24,7,40,
2025-09-08,Dustin Semach,Sealed Air Corporation,0,9,0,9,
2025-09-08,William L Meaney,Iron Mountain,3,18,0,21,
2025-09-08,Andy P Power,Digital Realty Trust,0,0,0,0,
2025-09-08,Satish Dhanasekaran,Keysight Technologies,2,10,0,12,
2025-09-08,Frank M Svoboda,Globe Life,3,4,3,10,
2025-09-08,Carey A Smith,Parsons Corporation,1,3,0,4,
2025-09-08,Ynon Kreiz,Mattel,7,26,7,40,
2025-09-08,Karen S Haller,Southwest Gas,3,6,0,9,
2025-09-08,Terrance Williams,TruStage,3,6,1,10,
2025-09-08,Eric W Gerstenberg,Clean Harbors,4,2,1,7,
2025-09-08,Gunner Smith,Cornerstone Building Brands,1,8,0,9,
2025-09-08,Gerben W Bakker,Hubbell,1,4,0,5,
2025-09-08,Dave Davis,Spirit Airlines,8,26,3,37,
2025-09-08,Michael J Smith,Lamb Weston,0,6,3,9,
2025-09-08,Strauss Zelnick,Take-Two Interactive Software,13,19,8,40,
2025-09-08,John C Turner Jr,GMS,3,7,0,10,
2025-09-08,David M O'Malley,Penn Mutual Life Insurance,1,3,0,4,
2025-09-08,Frank A Lonegro,Landstar System,2,4,0,6,
2025-09-08,James F Risoleo,Host Hotels & Resorts,6,17,0,23,
2025-09-08,Ken Xie,Fortinet,11,21,8,40,
2025-09-08,Doug Shulman,OneMain,3,6,0,9,
2025-09-08,Ryan Cohen,GameStop,11,22,7,40,
2025-09-08,Mark W Begor,Equifax,3,13,0,16,
2025-09-08,Jay L Schottenstein,American Eagle Outfitters,4,12,0,16,
2025-09-08,Curtis C Farmer,Comerica,5,9,0,14,
2025-09-08,Ole Rosgaard,Greif,3,16,1,20,
2025-09-08,Brian E Lane,Comfort Systems USA,10,0,0,10,
2025-09-08,Robert M Buck,TopBuild,0,5,1,6,
2025-09-08,Ralph Andretta,Bread Financial,3,9,0,12,
2025-09-08,Jim Anderson,Coherent,6,33,1,40,
2025-09-08,Walter C. D. Carlson,Telephone & Data Systems,0,2,0,2,
2025-09-08,Ronald Kruszewski,Stifel Financial,7,4,0,11,
2025-09-08,Richard Hayne,Urban Outfitters,12,21,7,40,
2025-09-08,Simon Meester,Terex,3,7,0,10,
2025-09-08,Edward J Lehner,Ryerson Holding,0,1,1,2,
2025-09-08,Nicholas T Pinchuk,Snap-on,4,5,0,9,
2025-09-08,Ryals McMullian,Flowers Foods,5,30,3,38,
2025-09-08,D Bryan Jordan,First Horizon,3,8,1,12,
2025-09-08,John B Gibson,Paychex,3,6,0,9,
2025-09-08,Chris Cocks,Hasbro,12,19,9,40,
2025-09-08,Pete McPartland,Sentry Insurance Group,0,2,0,2,
2025-09-08,Michael Arougheti,Ares Management,17,21,2,40,
2025-09-08,Alok Maskara,Lennox International,5,3,1,9,
2025-09-08,James C Grech,Peabody Energy,3,0,0,3,
2025-09-08,Joseph P Lacher Jr,Kemper,4,19,4,27,
2025-09-08,Perry A Sook,Nexstar Media Group,8,29,1,38,
2025-09-08,Wade Davis,TelevisaUnivision,14,25,1,40,
2025-09-08,Scott L Thompson,Tempur Sealy International,0,6,0,6,
2025-09-08,Mike Simonds,TriNet Group,0,9,0,9,
2025-09-08,B Andrew Rose,Worthington Enterprises,1,1,0,2,
2025-09-08,Bruce L Caswell,Maximus,5,5,0,10,
2025-09-08,Robert L Reffkin,Compass,1,6,0,7,
2025-09-08,Mark Eubanks,Brinks Company,1,2,1,4,
2025-09-08,Peter Quigley,Kelly Services inc,2,8,0,10,
2025-09-08,David L Yowan,Navient,3,3,0,6,
2025-09-08,Mary E Kipp,Puget Sound Energy,4,1,2,7,
2025-09-08,Adam Aron,AMC Entertainment,17,17,6,40,
2025-09-08,Mark J Tarr,Encompass Health,2,6,1,9,
2025-09-08,Liam K Griffin,Skyworks Solutions,1,7,1,9,
2025-09-08,Richard G Kyle,Timken,4,16,1,21,
2025-09-08,Ron Gusek,Liberty Energy,21,1,0,22,
2025-09-08,John E Geller Jr,Marriott Vacations Worldwide,6,5,0,11,
2025-09-08,Karl G. Glassman,Leggett & Platt,0,4,0,4,
2025-09-08,Bruce K Thorn,Big Lots,3,5,2,10,
2025-09-08,Jonathan H Weis,Weis Markets,10,29,0,39,
2025-09-08,Jeffrey B Guldner,Pinnacle West Capital,1,3,0,4,
2025-09-08,Arkadiy Dobkin,EPAM Systems,10,17,1,28,
2025-09-08,Paul M Rady,Antero Resources,4,8,0,12,
2025-09-08,Michael Spanos,Bloomin Brands,1,8,1,10,
2025-09-08,Nicole A Kivisto,MDU Resources Group,2,3,0,5,
2025-09-08,Gerald L Morgan,Texas Roadhouse,4,2,4,10,
2025-09-08,Gabriel Tirador,Mercury General,4,4,2,10,
2025-09-08,Nicholas I Fink,Fortune Brands Innovations,5,5,0,10,
2025-09-08,Paul E Burdiss,Zions Bancorp,1,1,0,2,
2025-09-08,William J Christensen,JELD-WEN Holding,4,5,0,9,
2025-09-08,Evan Spiegel,Snap Inc,19,18,3,40,
2025-09-08,Bill Burns,Zebra Technologies,6,24,1,31,
2025-09-08,Steven Sell,Agilon Health,1,9,2,12,
2025-09-08,Richard M Olson,Toro Company,1,13,0,14,
2025-09-08,Eric S Yuan,Zoom Video Communications,6,6,0,12,
2025-09-08,Dan L Batrack,Tetra Tech,2,4,1,7,
2025-09-08,Joseph D Russell Jr,Public Storage,0,8,0,8,
2025-09-08,Jacob Thaysen,Illumina inc,5,7,0,12,
2025-09-08,Debra A Cafaro,Ventas inc,8,5,0,13,
2025-09-08,Pierre R Brondeau,FMC Corporation,1,5,0,6,
2025-09-08,Judy R McReynolds,ArcBest,6,15,1,22,
2025-09-08,Russell J Weiner,Dominos Pizza inc,0,0,0,0,
2025-09-08,Theodore S Hanson,ASGN,0,1,0,1,
2025-09-08,RJ Scaringe,Rivian Automotive,10,26,4,40,
2025-09-08,Jeffrey N Simmons,Elanco Animal Health,2,5,1,8,
2025-09-08,Tim O Shaughnessy,Graham Holdings Company,2,8,0,10,
2025-09-08,Thomas V Taylor,Floor & Decor,1,1,2,4,
2025-09-08,Neil A Schrimsher,Applied Industrial Technologies,5,26,1,32,
2025-09-08,Robert E Price,PriceSmart,4,6,0,10,
2025-09-08,John David Risher,Lyft,4,3,1,8,
2025-09-08,Gary B Smith,Ciena,4,7,0,11,
2025-09-08,Joey Levin,IAC,7,31,1,39,
2025-09-08,Jim Jacobs,Country Financial,7,3,2,12,
2025-09-08,Devin B McGranahan,Western Union,1,5,0,6,
2025-09-08,R Scott Rowe,Flowserve,5,4,1,10,
2025-09-08,Kenneth A Vecchione,Western Alliance Bancorp,0,0,1,1,
2025-09-08,John C Rademacher,Option Care Health,9,1,0,10,
2025-09-08,Doug Black,SiteOne Landscape Supply,2,20,2,24,
2025-09-08,Oliver G Brewer III,Topgolf Callaway Brands,1,0,0,1,
2025-09-08,Glenn Sanford,eXp World,15,20,5,40,
2025-09-08,Fran Horowitz,Abercrombie & Fitch,14,20,6,40,
2025-09-08,Kevin Akers,Atmos Energy,8,2,0,10,
2025-09-08,Alessandro Maselli,Catalent,3,11,3,17,
2025-09-08,J Powell Brown,Brown & Brown,11,22,7,40,
2025-09-08,Aman Bhutani,GoDaddy,17,21,2,40,
2025-09-08,John C. Griffith,American Water Works,0,4,0,4,
2025-09-08,John J Marchioni,Selective Insurance Group,4,12,4,20,
2025-09-08,Lawson E Whiting,Brown-Forman,1,7,2,10,
2025-09-08,Dave Peacock,Advantage Solutions,22,8,0,30,
2025-09-08,Mick Farrell,ResMed,16,22,1,39,
2025-09-08,Kamal Hathi,Splunk,2,5,0,7,
2025-09-08,Todd Kelsey,Plexus,2,7,0,9,
2025-09-08,Phillip D Yeager,Hub Group,4,5,0,9,
2025-09-08,Steven B Hedlund,Lincoln Electric,4,9,0,13,
2025-09-08,Timothy C Oliver,NCR Atleos,0,1,0,1,
2025-09-08,Bruce Fleming,Calumet,2,6,0,8,
2025-09-08,Daniel S. Peyovich,Dycom Industries,0,4,0,4,
2025-09-08,Avner M Applbaum,Valmont Industries,0,8,0,8,
2025-09-08,Kimberly A Fields,ATI inc,4,9,0,13,
2025-09-08,Khozema Z Shipchandler,Twilio,0,2,0,2,
2025-09-08,Gary C Bhojwani,CNO Financial Group,1,4,1,6,
2025-09-08,William Andrew Hendricks Jr,Patterson-UTI Energy,0,0,0,0,
2025-09-08,Kevin D Hochman,Brinker International,1,4,1,6,
2025-09-08,James C Foster,Charles River Laboratories International,2,9,0,11,
2025-09-08,Rajiv K Prasad,Hyster-Yale,2,5,0,7,
2025-09-08,Eric T Steigerwalt,Brighthouse Financial,1,2,0,3,
2025-09-08,Thomas L Ryan,Service Corp International,6,4,0,10,
2025-09-08,Charles M Nifong Jr,CrossAmerica Partners,0,0,0,0,
2025-09-08,Anirudh Devgan,Cadence,11,23,3,37,
2025-09-08,Andi Owen,MillerKnoll,16,16,8,40,
2025-09-08,Sumit Roy,Realty Income,14,22,2,38,
2025-09-08,Timothy John Fitzgerald,Middleby,0,0,0,0,
2025-09-08,Robert H Schottenstein,M/I Homes,1,11,0,12,
2025-09-08,Stephen P MacMillan,Hologic,1,8,1,10,
2025-09-08,Lisa M Barton,Alliant Energy,4,0,0,4,
2025-09-08,Aaron P Jagdfeld,Generac,1,5,1,7,
2025-09-08,Erik Gershwind,MSC Industrial Direct,3,5,2,10,
2025-09-08,Varun Krishna,Rocket Companies,8,31,1,40,
2025-09-08,Fahmi Karam,Upbound Group,5,4,0,9,
2025-09-08,NADominic Ng,East West Bancorp,0,0,0,0,
2025-09-08,Mark Wang,Hilton Grand Vacations,38,2,0,40,
2025-09-08,Robert J Sheedy Jr,Grocery Outlet Holding,0,0,0,0,
2025-09-08,Simon D Campion,Dentsply Sirona,0,3,0,3,
2025-09-08,Jeremy Wensinger,V2X,6,9,0,15,
2025-09-08,Andrew Rees,Crocs,14,15,11,40,
2025-09-08,David M Maura,Spectrum Brands,6,1,0,7,
2025-09-08,Sachin S Lawande,Visteon,0,0,0,0,
2025-09-08,Neil M Ashe,Acuity Inc,0,1,0,1,
2025-09-08,Lorie L Tekorius,Greenbrier,1,9,0,10,
2025-09-08,John R Ciulla,Webster Financial,5,5,0,10,
2025-09-08,Sean D Keohane,Cabot Corporation,2,5,0,7,
2025-09-08,Drew M Wilkerson,RXO inc,0,0,0,0,
2025-09-08,Daniel E Brown,Chord Energy,1,1,0,2,
2025-09-08,Javier D Ferrer Fernandez,Popular inc,0,0,0,0,
2025-09-08,Olivier Rabiller,Garrett Motion inc,4,8,0,12,
2025-09-08,Ronald N Tutor,Tutor Perini Corporation,3,6,0,9,
2025-09-08,Jeff Liaw,Copart,4,5,0,9,
2025-09-08,Aman Narang,Toast inc,3,6,2,11,
2025-09-08,Joseph M Hogan,Align Technology,2,5,0,7,
2025-09-08,Kevin J Wheeler,A O Smith,0,17,1,18,
2025-09-08,Christopher A Cartwright,TransUnion,2,0,2,4,
2025-09-08,James Kelly,NCR Voyix,2,12,1,15,
2025-09-08,Tom Leighton,Akamai Technologies,15,14,6,35,
2025-09-08,Robert G Painter,Trimble,7,2,0,9,
2025-09-08,Tony Helton,Medical Mutual of Ohio,3,4,1,8,
2025-09-08,Caroline S Grace,AMN Healthcare Services,0,0,0,0,
2025-09-08,Patrick Kaltenbach,Mettler-Toledo International,3,5,0,8,
2025-09-08,Michael L Baur,ScanSource,0,3,0,3,
2025-09-08,Jason Lippert,LCI Industries,1,11,0,12,
2025-09-08,Fredric J Tomczyk,Cboe Global Markets,1,7,0,8,
2025-09-08,Octavio Marquez,Diebold Nixdorf,5,10,1,16,
2025-09-08,Sivasankaran Somasundaram,ChampionX,7,2,0,9,
2025-09-08,Ronald F Clarke,Corpay,0,1,0,1,
2025-09-08,Robert W Pittman,iHeartMedia,5,4,0,9,
2025-09-08,Patrick Zalupski,Dream Finders Homes,23,15,2,40,
2025-09-08,Keith E Smith,Boyd Gaming,0,6,1,7,
2025-09-08,Mehran Assadi,NLV Financial,1,1,0,2,
2025-09-08,Barry R Port,Ensign Group,3,4,2,9,
2025-09-08,Denise A Paulonis,Sally Beauty,1,2,0,3,
2025-09-08,Clifford A Skelton,Conduent,0,1,0,1,
2025-09-08,Jean-Michel Ribieras,Sylvamo,3,6,0,9,
2025-09-08,Douglas F Bauer,Tri Pointe Homes,0,6,0,6,
2025-09-08,Shawn O'Connell,EnerSys,4,5,0,9,
2025-09-08,Bill Meury,Incyte,8,14,0,22,
2025-09-08,Dale Francescon,Century Communities,2,10,3,15,
2025-09-08,Michael Nierenberg,Rithm Capital,10,28,2,40,
2025-09-08,Michael J Brown,Euronet Worldwide,3,7,0,10,
2025-09-08,Scott Seu,Hawaiian Electric Industries,5,17,2,24,
2025-09-08,Jason D Robins,DraftKings,5,2,0,7,
2025-09-08,Jonathan J Mazelsky,IDEXX Laboratories,1,1,1,3,
2025-09-08,Richard S Swartz,MYR Group,0,2,0,2,
2025-09-08,Stefano Caroti,Deckers Outdoor,1,7,1,9,
2025-09-08,Kevin R Sayer,DexCom,3,3,0,6,
2025-09-08,John T C Lee,MKS Instruments,3,9,1,13,
2025-09-08,Edward B Pitoniak,VICI Properties,1,8,0,9,
2025-09-08,Albert White III,Cooper Cos,0,0,0,0,
2025-09-08,Barry L Biffle,Frontier Airlines,1,6,6,13,
2025-09-08,Robert A Bruggeworth,Qorvo,6,4,0,10,
2025-09-08,Winnie Park,Five Below,9,28,3,40,
2025-09-08,Steven Oakland,TreeHouse Foods,3,13,0,16,
2025-09-08,James S Hagedorn,Scotts Miracle-Gro,1,0,0,1,
2025-09-08,Michael Cannon-Brookes,Atlassian,14,24,1,39,
2025-09-08,Bertrand Loy,Entegris,3,12,1,16,
2025-09-08,William E Waltz,Atkore,2,7,0,9,
2025-09-08,Celeste B Mastin,H B Fuller,1,3,0,4,
2025-09-08,Kyle T Larkin,Granite Construction,0,7,0,7,
2025-09-08,Michael J Happe,Winnebago Industries,1,3,0,4,
2025-09-08,Steven H Gunby,FTI Consulting,5,10,0,15,
2025-09-08,Stephan B Tanda,AptarGroup,0,5,2,7,
2025-09-08,Timothy P Boyle,Columbia Sportswear,3,3,2,8,
2025-09-08,Anthony J Wood,Roku,5,3,1,9,
2025-09-08,M Christopher Doyle,Civitas Resources,1,2,0,3,
2025-09-08,Andy Eidson,Alpha Metallurgical Resources,1,6,2,9,
2025-09-08,Andy L Nemeth,Patrick Industries,4,2,0,6,
2025-09-08,Roger W Jenkins,Murphy Oil,5,16,0,21,
2025-09-08,Kevin S Blair,Synovus Financial,6,2,1,9,
2025-09-08,Julie Felss Masino,Cracker Barrel Old Country Store,8,17,15,40,
2025-09-08,David M Overton,Cheesecake Factory,1,9,0,10,
2025-09-08,Nick DeIuliis,CNX Resources,7,3,0,10,
2025-09-08,Christopher Pappas,Chefs Warehouse,4,9,1,14,
2025-09-08,Tod Carpenter,Donaldson Company,2,7,0,9,
2025-09-08,Gregory L Christopher,Mueller Industries,2,5,0,7,
2025-09-08,Rob Saltiel,MRC Global,6,12,1,19,
2025-09-08,Jillian C Evanko,Chart Industries,3,7,0,10,
2025-09-08,Dave Guilmette,Alight Solutions,3,7,0,10,
2025-09-08,Joel Smejkal,Vishay Intertechnology,4,5,1,10,
2025-09-08,Dennis Degner,Range Resources,3,8,0,11,
2025-09-08,Ira D Robbins,Valley National Bancorp,1,2,0,3,
2025-09-08,Bernard Kim,Match Group,14,19,7,40,
2025-09-08,Vincent Pilette,Gen Digital,2,13,0,15,
2025-09-08,Timothy S Crane,Wintrust Financial,2,8,0,10,
2025-09-08,Pat Roche,Moog inc,4,11,2,17,
2025-09-08,Mark R Widmar,First Solar,2,8,1,11,
2025-09-08,Niko Lahanas,Central Garden & Pet,2,11,0,13,
2025-09-08,Chris Osowski,Green Plains inc,6,11,1,18,
2025-09-08,Derek J Leathers,Werner Enterprises,2,7,0,9,
2025-09-08,Adam Foroughi,AppLovin,11,25,4,40,
2025-09-08,Luca Savi,ITT,2,7,1,10,
2025-09-08,Lawrence H Silber,Herc Rentals,0,0,0,0,
2025-09-08,Hilton H Howell Jr,Gray Television,7,21,1,29,
2025-09-08,Eric D Ashleman,IDEX,0,9,1,10,
2025-09-08,Owen D Thomas,Boston Properties,3,6,0,9,
2025-09-08,Kurt Wolf,Pitney Bowes,6,18,3,27,
2025-09-08,Sara E Armbruster,Steelcase,2,0,0,2,
2025-09-08,Charles D. Young,Sun Communities,2,5,0,7,
2025-09-08,Suzanne Foster,AdaptHealth,5,8,1,14,
2025-09-08,Grant E Sims,Genesis Energy,1,2,0,3,
2025-09-08,Laura Prieskorn,Jackson Financial,2,6,2,10,
2025-09-08,Rick L Wessel,FirstCash,4,5,1,10,
2025-09-08,Sherman Miller,Cal-Maine Foods,11,29,0,40,
2025-09-08,Paul A Lang,Arch Resources,5,3,0,8,
2025-09-08,Ashish K Khandpur,Avient,2,7,0,9,
2025-09-08,Shyam K Reddy,BlueLinx,1,7,0,8,
2025-09-08,Christopher S Ripley,Sinclair,1,8,0,9,
2025-09-08,Stacy Kymes,BOK Financial,8,6,0,14,
2025-09-08,James H Walter,Permian Resources,0,1,0,1,
2025-09-08,Jason Murray,PACS Group,5,14,2,21,
2025-09-08,Brian Armstrong,Coinbase Global,12,22,6,40,
2025-09-08,Oscar K Brown,Western Midstream Partners,1,3,0,4,
2025-09-08,Nicholas R Lower,Federated Mutual Insurance,0,1,0,1,
2025-09-08,Morris Goldfarb,G-III Apparel Group,9,25,6,40,
2025-09-08,Mark D Morelli,Vontier,0,4,0,4,
2025-09-08,Matthew J Cox,Matson inc,1,6,0,7,
2025-09-08,David W Grzebinski,Kirby Corporation,1,3,0,4,
2025-09-08,Keith A Harvey,Kaiser Aluminum,2,4,2,8,
2025-09-08,Eric Nyman,Vista Outdoor,4,11,1,16,
2025-09-08,Doug Howe,Designer Brands,5,19,0,24,
2025-09-08,Jerry E Gahlhoff Jr,Rollins inc,0,2,0,2,
2025-09-08,D Scott Barbour,Advanced Drainage Systems,3,2,0,5,
2025-09-08,Sean Gamble,Cinemark,18,20,2,40,
2025-09-08,George Kurtz,CrowdStrike,15,22,3,40,
2025-09-08,Bill Ready,Pinterest,25,15,0,40,
2025-09-08,Fidji Simo,Instacart,9,30,1,40,
2025-09-08,Kimberly K Ryan,Hillenbrand,3,6,0,9,
2025-09-08,David S Graziosi,Allison Transmission,1,17,3,21,
2025-09-08,Gary G Friedman,Restoration Hardware,1,5,0,6,
2025-09-08,Lucinda M Baier,Brookdale Senior Living,4,4,0,8,
2025-09-08,Brian J Blaser,QuidelOrtho,1,9,0,10,
2025-09-08,E Jean Savage,Trinity Industries,1,8,1,10,
2025-09-08,Liam J Kelly,Teleflex,0,4,1,5,
2025-09-08,Laurans A Mendelson,HEICO,7,19,1,27,
2025-09-08,Frank H Laukien,Bruker,2,8,0,10,
2025-09-08,Harvey M Schwartz,Carlyle Group,5,13,0,18,
2025-09-08,Mark S LaVigne,Energizer,3,1,0,4,
2025-09-08,Joel Quadracci,Quad/Graphics,12,23,5,40,
2025-09-08,Amar Maletira,Rackspace Technology,5,12,2,19,
2025-09-08,Udit Batra,Waters Corporation,10,25,0,35,
2025-09-08,Eric M Green,West Pharmaceutical Services,3,7,0,10,
2025-09-08,Doug Palladini,Carters inc,2,2,2,6,
2025-09-08,G Mike Mikan,NeueHealth,4,2,0,6,
2025-09-08,Russell ChipChilds,SkyWest,0,0,0,0,
2025-09-08,Christopher H Hunter,Acadia Healthcare,0,2,0,2,
2025-09-08,Prahlad Singh,Revvity,2,8,0,10,
2025-09-08,Maria M Pope,Portland General Electric,1,1,0,2,
2025-09-08,Charles Chip Blankenship,Woodward inc,0,1,0,1,
2025-09-08,Mike Steib,TEGNA,15,19,1,35,
2025-09-08,Kurt J Ekert,Sabre Corporation,0,1,0,1,
2025-09-08,Matt Wilson,Light & Wonder,17,19,4,40,
2025-09-08,Rob Katz,Vail Resorts,0,0,0,0,
2025-09-08,Schnitzer Steel Industries,Radius Recycling,7,25,6,38,
2025-09-08,David A Spector,PennyMac Financial Services,3,1,0,4,
2025-09-08,Frederick J Holzgrefe III,Saia inc,1,1,0,2,
2025-09-08,Mark J Parrell,Equity Residential,4,7,0,11,
2025-09-08,John W Lindsay,Helmerich & Payne,0,4,0,4,
2025-09-08,Gary D Burnison,Korn Ferry,4,12,0,16,
2025-09-08,Timothy J McGrath,PC Connection Inc,1,2,0,3,
2025-09-08,Lynn M Bamford,Curtiss-Wright,12,8,0,20,
2025-09-08,Jonathan W Witter,Sallie Mae,0,1,0,1,
2025-09-08,Jeff Benck,Benchmark Electronics,10,9,0,19,
2025-09-08,Charles H Giancarlo,Pure Storage,1,3,0,4,
2025-09-08,Brian R Gray,Knife River Corporation,0,1,0,1,
2025-09-08,Jay Schmidt,Caleres inc,3,5,2,10,
2025-09-08,Dale Asplund,BrightView Holdings,1,6,0,7,
2025-09-08,Jeffrey S Edwards,Cooper-Standard,0,5,0,5,
2025-09-08,Glenn J Williams,Primerica,6,1,2,9,
2025-09-08,Francois Locoh-Donou,F5,8,23,2,33,
2025-09-08,Joseph Wm Foran,Matador Resources,8,9,0,17,
2025-09-08,Sridhar Ramaswamy,Snowflake inc,9,24,4,37,
2025-09-08,Mark D Dankberg,Viasat,2,3,4,9,
2025-09-08,Francisco J Leon,California Resources,1,4,1,6,
2025-09-08,Peter Stern,Peloton,18,18,4,40,
2025-09-08,David Baszucki,Roblox,9,21,10,40,
2025-09-08,Jeffrey W Edwards,Installed Building Products,0,2,0,2,
2025-09-08,Clark Lauritzen,First National of Nebraska,1,7,0,8,
2025-09-08,Carlos Alberini,Guess inc,12,27,1,40,
2025-09-08,Shyam P Kambeyanda,ESAB,4,3,0,7,
2025-09-08,Edmund Shallcross III,Amica Mutual Insurance,1,5,0,6,
2025-09-08,Benjamin W Schall,AvalonBay Communities,1,5,1,7,
2025-09-08,Allan C Thygesen,DocuSign,3,7,0,10,
2025-09-08,Bryan J Knutson,Titan Machinery,1,3,1,5,
2025-09-08,Heath Sampson,ModivCare,8,2,0,10,
2025-09-08,Ara K Hovnanian,Hovnanian Enterprises,1,15,1,17,
2025-09-08,Joshua G Silverman,Etsy,2,3,0,5,
2025-09-08,Kevin Roycraft,Adams Resources & Energy,5,4,1,10,
2025-09-08,J Eric Evans,Surgery Partners,1,2,0,3,
2025-09-08,Clint E Stein,Columbia Banking System,1,7,0,8,
2025-09-08,Lee M Shavel,Verisk Analytics,3,7,0,10,
2025-09-08,Dave Banyard Jr,MasterBrand,0,0,0,0,
2025-09-08,Peter R Ingram,Hawaiian Airlines inc,1,0,0,1,
2025-09-08,Kristin A Dolan,AMC Networks,3,2,0,5,
2025-09-08,Brendan T Cavanagh,SBA Communications,1,2,0,3,
2025-09-08,George F Chappelle Jr,Americold Realty Trust,1,3,0,4,
2025-09-08,Thomas E Gottwald,NewMarket Corporation,2,8,0,10,
2025-09-08,Thomas J Baltimore Jr,Park Hotels & Resorts,4,31,1,36,
2025-09-08,Peter M Moglia,Alexandria Real Estate Equities,3,5,0,8,
2025-09-08,Ronald J Kramer,Griffon Corporation,1,6,0,7,
2025-09-08,John L Plueger,Air Lease,2,12,0,14,
2025-09-08,Jennifer F Scanlon,UL Solutions,1,3,0,4,
2025-09-08,Greg Smith,Teradyne,1,8,2,11,
2025-09-08,Sean Trauschke,OGE Energy,18,5,0,23,
2025-09-08,Norman D Schwartz,Bio-Rad Laboratories,0,0,1,1,
2025-09-08,Scott Doyle,Spire inc,4,5,1,10,
2025-09-08,Michael E Reed,Gannett,0,5,2,7,
2025-09-08,Cindy J Miller,Stericycle,2,6,1,9,
2025-09-08,Phillip D Green,Cullen Frost Bankers,1,5,3,9,
2025-09-08,Joseph D Margolis,Extra Space Storage,0,9,1,10,
2025-09-08,Mark A Skonieczny,REV Group,7,2,1,10,
2025-09-08,Ladd Wilks,ProFrac Holding,4,2,0,6,
2025-09-08,Sundaram Nagarajan,Nordson,0,9,0,9,
2025-09-08,Anne P Noonan,Summit Materials,0,1,0,1,
2025-09-08,Lori Flees,Valvoline inc,4,5,1,10,
2025-09-08,Scott H Baxter,Kontoor Brands,2,2,0,4,
2025-09-08,Tim Larson,Skyline Champion,7,0,0,7,
2025-09-08,Chuck Divita,Teladoc Health,10,20,5,35,
2025-09-08,W Bradley Southern,Louisiana-Pacific Corporation,0,0,0,0,
2025-09-08,George C Freeman III,Universal Corporation,2,6,0,8,
2025-09-08,James A Brock,Consol Energy,1,0,0,1,
2025-09-08,Robert Antokol,Playtika Holding,1,8,1,10,
2025-09-08,Joe Craft,Alliance Resource Partners,8,8,2,18,
2025-09-08,Paul Keel,Envista,1,7,1,9,
2025-09-08,Jared Isaacman,Shift4 Payments,5,29,6,40,
2025-09-08,Mark Mac McFarland,Talen Energy,3,1,1,5,
2025-09-08,Tony R Thene,Carpenter Technology,1,9,0,10,
2025-09-08,Melissa D Smith,WEX,1,6,1,8,
2025-09-08,James Jim C Ryan III,Old National Bancorp,1,0,0,1,
2025-09-08,Peter J Federico,AGNC Investment,1,0,0,1,
2025-09-08,Brent L Yeagy,Wabash National,0,0,0,0,
2025-09-08,Henry A Fernandez,MSCI,3,16,0,19,
2025-09-08,Mark Penn,Stagwell,14,22,3,39,
2025-09-08,Julie Schertell,Mativ,3,9,0,12,
2025-09-08,Ashish Chand,Belden,3,6,1,10,
2025-09-08,Greg Anderson,Allegiant Travel Company,5,9,0,14,
2025-09-08,Drew Houston,Dropbox,13,20,7,40,
2025-09-08,Kevin T Conroy,Exact Sciences,1,6,2,9,
2025-09-08,Rex D Geveden,BWX Technologies,4,6,0,10,
2025-09-08,Scott R Wells,Clear Channel Outdoor Hldgs,0,0,0,0,
2025-09-08,Paul Bay,Ingram Micro,10,25,5,40,
2025-09-09,Doug McMillon,Walmart,16,17,7,40,
2025-09-09,Andrew Jassy,Amazon,4,30,5,39,
2025-09-09,Tim Cook,Apple,6,33,1,40,
2025-09-09,Stephen Hemsley,UnitedHealth,7,27,6,40,
2025-09-09,Warren Buffett,Berkshire Hathaway,13,20,7,40,
2025-09-09,David Joyner,CVS Health,8,28,4,40,
2025-09-09,Darren Woods,Exxon Mobil,10,23,6,39,
2025-09-09,Sundar Pichai,Alphabet,18,17,5,40,
2025-09-09,Brian Tyler,McKesson,5,16,6,27,
2025-09-09,Robert Mauch,Cencora,3,7,0,10,
2025-09-09,Ron Vachris,Costco,7,31,2,40,
2025-09-09,Jamie Dimon,JPMorgan Chase,11,19,10,40,
2025-09-09,Satya Nadella,Microsoft,16,21,3,40,
2025-09-09,Jason Hollar,Cardinal Health,13,23,4,40,
2025-09-09,Mike Wirth,Chevron,16,15,9,40,
2025-09-09,David Cordani,Cigna,21,15,4,40,
2025-09-09,Jim Farley,Ford Motor,17,17,6,40,
2025-09-09,Brian Moynihan,Bank of America,7,29,4,40,
2025-09-09,Mary Barra,General Motors,14,19,7,40,
2025-09-09,Gail Boudreaux,Elevance Health,16,18,6,40,
2025-09-09,Jane Fraser,Citigroup,12,24,4,40,
2025-09-09,Sarah London,Centene,13,18,9,40,
2025-09-09,Ted Decker,Home Depot,15,22,3,40,
2025-09-09,Maryann Mannen,Marathon Petroleum,7,13,1,21,
2025-09-09,Ron Sargent,Kroger,5,22,13,40,
2025-09-09,Mark Lashier,Phillips 66,11,20,7,38,
2025-09-09,Priscilla Almodovar,Fannie Mae,10,15,15,40,
2025-09-09,Tim Wentworth,Walgreens,8,23,9,40,
2025-09-09,Lane Riggs,Valero Energy,14,7,0,21,
2025-09-09,Mark Zuckerberg,Meta,4,22,14,40,
2025-09-09,Hans Vestberg,Verizon,15,20,5,40,
2025-09-09,John Stankey,AT&T,11,24,5,40,
2025-09-09,Brian Roberts,Comcast,10,28,2,40,
2025-09-09,Charles Scharf,Wells Fargo,28,7,5,40,
2025-09-09,David Solomon,Goldman Sachs,8,24,8,40,
2025-09-09,Michael Hutchins,Freddie Mac,2,10,4,16,
2025-09-09,Michael Fiddelke,Target,10,24,6,40,
2025-09-09,Jim Rechtin,Humana,19,16,5,40,
2025-09-09,Jon Farney,State Farm Insurance,1,15,3,19,
2025-09-09,Elon Musk,Tesla,9,29,2,40,
2025-09-09,Ted Pick,Morgan Stanley,16,21,3,40,
2025-09-09,Joaquin Duato,Johnson & Johnson,10,25,5,40,
2025-09-09,Juan Luciano,Archer Daniels Midland,3,20,17,40,
2025-09-09,Ramon Laguarta,PepsiCo,7,28,5,40,
2025-09-09,Carol Tom√©,UPS,5,23,12,40,
2025-09-09,Rajesh Subramaniam,FedEx,10,25,0,35,
2025-09-09,Bob Iger,Walt Disney,7,30,3,40,
2025-09-09,Michael Dell,Dell Technologies,12,23,5,40,
2025-09-09,Marvin Ellison,Lowes,16,23,1,40,
2025-09-09,Jon Moeller,Procter & Gamble,4,29,7,40,
2025-09-09,Thomas Long,Energy Transfer,8,0,1,9,
2025-09-09,Kelly Ortberg,Boeing,9,26,5,40,
2025-09-09,Susan Morris,Albertsons,14,23,3,40,
2025-09-09,Kevin Hourican,Sysco,8,28,4,40,
2025-09-09,Christopher Calio,RTX,6,12,0,18,
2025-09-09,Larry Culp,General Electric,10,27,3,40,
2025-09-09,James Taiclet,Lockheed Martin,15,18,7,40,
2025-09-09,Stephen Squeri,American Express,15,24,1,40,
2025-09-09,Joe Creed,Caterpillar,10,29,1,40,
2025-09-09,Michel Khalaf,MetLife,12,17,1,30,
2025-09-09,Samuel Hazen,HCA Healthcare,8,7,0,15,
2025-09-09,Tricia Griffith,Progressive Insurance,9,26,5,40,
2025-09-09,Arvind Krishna,IBM,13,21,6,40,
2025-09-09,John May,Deere,9,23,8,40,
2025-09-09,Jensen Huang,Nvidia,10,27,3,40,
2025-09-09,Philip Smith,StoneX,0,11,0,11,
2025-09-09,Robert M Davis,Merck,5,19,0,24,
2025-09-09,Ryan Lance,ConocoPhillips,15,21,4,40,
2025-09-09,Albert Bourla,Pfizer,27,9,4,40,
2025-09-09,Ed Bastian,Delta Air Lines,11,20,9,40,
2025-09-09,Patrick Zammit,TD Synnex,10,13,0,23,
2025-09-09,Kevin Murphy,Publix Super Markets,10,21,1,32,
2025-09-09,Thomas J Wilson,Allstate,2,6,1,9,
2025-09-09,Chuck Robbins,Cisco Systems,12,24,4,40,
2025-09-09,Kirt Walker,Nationwide Insurance,4,6,0,10,
2025-09-09,Christopher Winfrey,Charter Communications,4,15,5,24,
2025-09-09,Bob Michael,AbbVie,0,0,0,0,
2025-09-09,Craig DeSanto,New York Life Insurance,3,18,0,21,
2025-09-09,Lip-Bu Tan,Intel,5,26,9,40,
2025-09-09,Ernie Herrman,TJX,17,21,2,40,
2025-09-09,Andrew Sullivan,Prudential Financial,11,21,0,32,
2025-09-09,Enrique Lores,Hewlett Packard,10,18,6,34,
2025-09-09,Scott Kirby,United Airlines,33,4,3,40,
2025-09-09,George Holm,Performance Food,8,23,2,33,
2025-09-09,Donnie King,Tyson Foods,8,26,6,40,
2025-09-09,Robert Isom,American Airlines,6,25,9,40,
2025-09-09,Timothy M Sweeney,Liberty Mutual Insurance,12,0,0,12,
2025-09-09,Elliott Hill,Nike,11,25,4,40,
2025-09-09,Safra Catz,Oracle,13,19,8,40,
2025-09-09,AJ Jim Teague,Enterprise Products Partners,7,14,0,21,
2025-09-09,Richard Fairbank,Capital One,15,23,2,40,
2025-09-09,Willie Chiang,Plains GP,3,6,1,10,
2025-09-09,Michael Kasbar,World Kinect,2,9,0,11,
2025-09-09,Peter Zaffino,American International Group,9,26,5,40,
2025-09-09,James Quincey,The Coca-Cola Company,10,27,3,40,
2025-09-09,Thasunda Brown Duckett,TIAA,21,19,0,40,
2025-09-09,Jay Debertin,CHS,6,10,4,20,
2025-09-09,Chris Boerner,Bristol-Myers Squibb,10,24,6,40,
2025-09-09,Corie Barry,Best Buy,39,1,0,40,
2025-09-09,Marc Casper,Thermo Fisher Scientific,13,23,4,40,
2025-09-09,Roger Crandall,Mass Mutual,2,8,0,10,
2025-09-09,Juan Andrade,USAA,5,18,0,23,
2025-09-09,Phebe Novakovic,General Dynamics,28,9,3,40,
2025-09-09,Alan Schnitzer,Travelers Insurance,3,5,2,10,
2025-09-09,David Zaslav,Warner Bros Discovery,4,24,12,40,
2025-09-09,Gunjan Kedia,US Bancorp,15,23,2,40,
2025-09-09,Robert Ford,Abbott Laboratories,13,22,5,40,
2025-09-09,Kathy Warden,Northrop Grumman,14,22,4,40,
2025-09-09,Tim Gerend,Northwestern Mutual,13,26,1,40,
2025-09-09,Todd Vasos,Dollar General,8,25,7,40,
2025-09-09,Matthew Lucey,PBF Energy,8,2,0,10,
2025-09-09,Dara Khosrowshahi,Uber,12,23,5,40,
2025-09-09,Vimal Kapur,Honeywell,10,30,0,40,
2025-09-09,Dirk Van de Put,Mondelez,10,27,3,40,
2025-09-09,Brian Niccol,Starbucks,9,26,5,40,
2025-09-09,Cristiano Amon,Qualcomm,13,26,1,40,
2025-09-09,Hock Tan,Broadcom,16,22,2,40,
2025-09-09,David Flitman,US Foods,3,7,0,10,
2025-09-09,Paul Romanowski,DR Horton,5,15,5,25,
2025-09-09,Jacek Olczak,Philip Morris,13,24,3,40,
2025-09-09,Preston Feight,Paccar,10,26,1,37,
2025-09-09,Marc Benioff,Salesforce,8,20,12,40,
2025-09-09,Leon Topalian,Nucor,14,24,2,40,
2025-09-09,Michael Dastoor,Jabil,1,7,0,8,
2025-09-09,Jonathan Jaffe,Lennar,0,8,2,10,
2025-09-09,David Ricks,Eli Lilly,10,21,9,40,
2025-09-09,Joe Zubretsky,Molina Healthcare,7,5,4,16,
2025-09-09,Jennifer Rumsey,Cummins,7,27,6,40,
2025-09-09,Robin Vince,Bank of New York Mellon,21,17,2,40,
2025-09-09,Ted Sarandos,Netflix,12,25,3,40,
2025-09-09,William H Rogers Jr,Truist Financial,3,7,0,10,
2025-09-09,Sean Kerins,Arrow Electronics,2,12,0,14,
2025-09-09,William M Brown,3M,1,9,0,10,
2025-09-09,Ryan McInerney,Visa,12,23,5,40,
2025-09-09,Marc Rowan,Apollo Global Management,14,21,5,40,
2025-09-09,Tim Go,HF Sinclair,6,3,0,9,
2025-09-09,Robert Sulentic,CBRE Group,1,6,1,8,
2025-09-09,William Demchak,PNC Financial Services,16,19,5,40,
2025-09-09,Bryan DeBoer,Lithia Motors,4,34,2,40,
2025-09-09,William Nash,CarMax,4,3,2,9,
2025-09-09,Brian Robbins,Paramount Global,8,30,2,40,
2025-09-09,Michael Creedon,Dollar Tree,5,32,3,40,
2025-09-09,Sandy Douglas,United Natural Foods,34,5,1,40,
2025-09-09,Alex Chriss,PayPal,14,23,3,40,
2025-09-09,Roger Penske,Penske Automotive,18,21,1,40,
2025-09-09,Antonio Neri,Hewlett Packard Enterprise,10,22,8,40,
2025-09-09,Harry Sideris,Duke Energy,36,4,0,40,
2025-09-09,Vicki Hollub,Occidental Petroleum,21,15,4,40,
2025-09-09,Lawrence Coben,NRG Energy,5,3,0,8,
2025-09-09,Robert Bradway,Amgen,11,27,2,40,
2025-09-09,John Ketchum,NextEra Energy,23,17,0,40,
2025-09-09,Rainer Blair,Danaher,6,16,2,24,
2025-09-09,Daniel O'Day,Gilead Sciences,17,20,3,40,
2025-09-09,Michael Manley,AutoNation,3,6,1,10,
2025-09-09,Carlos Abrams-Rivera,Kraft Heinz,7,27,6,40,
2025-09-09,Philip Gallagher,Avnet,0,4,0,4,
2025-09-09,Gary Dickerson,Applied Materials,6,21,13,40,
2025-09-09,Bob Jordan,Southwest Airlines,10,23,7,40,
2025-09-09,Rick Wurster,Charles Schwab,14,21,4,39,
2025-09-09,Lorenzo Simonelli,Baker Hughes,16,20,4,40,
2025-09-09,Chris Kempczinski,McDonalds,9,22,9,40,
2025-09-09,Christopher Womack,Southern Company,2,7,0,9,
2025-09-09,Michael Miebach,Mastercard,11,26,3,40,
2025-09-09,Joseph Dominguez,Constellation Energy,14,10,1,25,
2025-09-09,Christopher Swift,The Hartford,16,20,4,40,
2025-09-09,Patricia Poppe,PG&E,8,14,2,24,
2025-09-09,Bom Kim,Coupang,13,26,1,40,
2025-09-09,Ezra Yacob,EOG Resources,24,14,2,40,
2025-09-09,Jim Vena,Union Pacific,21,19,0,40,
2025-09-09,Matt Schroeder,Rite Aid,4,33,3,40,
2025-09-09,Tony Spring,Macys,10,25,5,40,
2025-09-09,Anthony Capuano,Marriott International,13,25,2,40,
2025-09-09,Raymond E Scott,Lear Corporation,5,5,0,10,
2025-09-09,William Stengel II,Genuine Parts,0,4,0,4,
2025-09-09,Heidi Petz,Sherwin-Williams,10,28,2,40,
2025-09-09,Jeff Miller,Halliburton,12,22,6,40,
2025-09-09,Kathleen Quirk,Freeport-McMoRan,14,18,2,34,
2025-09-09,Michael Rapino,Live Nation Entertainment,13,24,3,40,
2025-09-09,John Doyle,Marsh & McLennan,11,7,0,18,
2025-09-09,Lisa Su,Advanced Micro Devices,16,20,4,40,
2025-09-09,Frank Holding,First Citizens BancShares,9,14,2,25,
2025-09-09,John Engel,WESCO International,5,13,1,19,
2025-09-09,David Gitlin,Carrier Global,15,23,2,40,
2025-09-09,Lourenco Goncalves,Cleveland-Cliffs,6,18,16,40,
2025-09-09,Calvin G Butler Jr,Exelon,6,4,0,10,
2025-09-09,Joseph Bae,KKR,18,19,3,40,
2025-09-09,Christine Leahy,CDW,0,7,2,9,
2025-09-09,Glenn Fogel,Booking Holdings,11,23,6,40,
2025-09-09,Brian Doubles,Synchrony Financial,5,7,1,13,
2025-09-09,Earl Austin,Quanta Services,2,5,2,9,
2025-09-09,Christian Ulbrich,Jones Lang LaSalle,7,15,0,22,
2025-09-09,Saumya Sutaria,Tenet Healthcare,5,3,1,9,
2025-09-09,William Gifford,Altria Group,3,6,1,10,
2025-09-09,Kevin Lobo,Stryker,12,25,3,40,
2025-09-09,Michael Hsu,Kimberly-Clark,5,7,1,13,
2025-09-09,Jack Fusco,Cheniere Energy,18,18,4,40,
2025-09-09,James Conroy,Ross Stores,4,12,0,16,
2025-09-09,Anthony Smurfit,Smurfit Westrock,4,6,0,10,
2025-09-09,Jeffrey Harmening,General Mills,3,17,5,25,
2025-09-09,Mark Stewart,Goodyear Tire & Rubber,4,35,1,40,
2025-09-09,Bob Eddy,BJs Wholesale Club,3,19,3,25,
2025-09-09,Peter Arduini,GE HealthCare Technologies,4,11,0,15,
2025-09-09,Noel Wallace,Colgate-Palmolive,9,22,2,33,
2025-09-09,Marc Bitzer,Whirlpool,11,15,14,40,
2025-09-09,Chris Kubasik,L3Harris Technologies,7,13,1,21,
2025-09-09,Shantanu Narayen,Adobe,19,19,1,39,
2025-09-09,Thomas Polen,Becton Dickinson,5,5,0,10,
2025-09-09,Richard P Dealy,Pioneer Natural Resources,6,3,0,9,
2025-09-09,Ravi Kumar S,Cognizant Technology Solutions,11,22,4,37,
2025-09-09,Andrew Clyde,Murphy USA,12,27,1,40,
2025-09-09,Mike Lyons,Fiserv,4,12,0,16,
2025-09-09,Jennifer Parmentier,Parker-Hannifin,2,12,0,14,
2025-09-09,William Fehrman,American Electric Power,4,6,0,10,
2025-09-09,Andrew Silvernail,International Paper,5,22,0,27,
2025-09-09,Jonas Prising,ManpowerGroup,7,21,2,30,
2025-09-09,John Zillmer,Aramark,6,12,2,20,
2025-09-09,Mark Millett,Steel Dynamics,17,2,0,19,
2025-09-09,Dan Amos,Aflac,15,17,8,40,
2025-09-09,Tony Cheng,Reinsurance Group of America,3,8,2,13,
2025-09-09,Karsanbhai,Emerson Electric,7,14,3,24,
2025-09-09,Ronald P O'Hanley,State Street,4,15,0,19,
2025-09-09,Timothy Knavish,PPG Industries,1,1,0,2,
2025-09-09,David Burritt,United States Steel,9,20,11,40,
2025-09-09,Maria Black,Automatic Data Processing,6,3,0,9,
2025-09-09,Daryl Kenningham,Group 1 Automotive,8,30,2,40,
2025-09-09,Robert Blue,Dominion Energy,27,11,2,40,
2025-09-09,Larry Fink,BlackRock,6,24,10,40,
2025-09-09,Pierce Norton II,Oneok,5,3,1,9,
2025-09-09,David Bozeman,CH Robinson Worldwide,2,8,0,10,
2025-09-09,Haviv Ilan,Texas Instruments,15,22,3,40,
2025-09-09,Michael Bender,Kohls,1,25,14,40,
2025-09-09,Philip Daniele III,AutoZone,0,2,0,2,
2025-09-09,Timothy Archer,Lam Research,5,5,0,10,
2025-09-09,Charles Magro,Corteva,5,3,1,9,
2025-09-09,Rick Lanoha,Peter Kiewit Sons',0,1,0,1,
2025-09-09,Peter Jackson,Builders FirstSource,5,11,1,17,
2025-09-09,Martin Schroeter,Kyndryl,10,29,0,39,
2025-09-09,Hamid Akhavan,EchoStar,5,24,11,40,
2025-09-09,Bill Westrate,American Family Insurance,10,17,2,29,
2025-09-09,Avigal Soreq,Delek US,4,8,5,17,
2025-09-09,Beth Ford,Land O'Lakes,17,22,1,40,
2025-09-09,Walker Martin,Sempra,0,1,0,1,
2025-09-09,Eric Slifka,Global Partners,12,22,6,40,
2025-09-09,DG Macpherson,WW Grainger,2,7,1,10,
2025-09-09,Bob Pragada,Jacobs Solutions,6,10,0,16,
2025-09-09,Pedro Pizarro,Edison International,17,7,16,40,
2025-09-09,William Hornbuckle,MGM Resorts International,9,25,1,35,
2025-09-09,Andrew McMahon,Guardian Life insurance,6,10,0,16,
2025-09-09,Christopher O'Herlihy,Illinois Tool Works,3,6,0,9,
2025-09-09,James Cracchiolo,Ameriprise Financial,2,23,2,27,
2025-09-09,Ryan Marshall,PulteGroup,9,15,12,36,
2025-09-09,Matthew Meloy,Targa Resources,5,5,0,10,
2025-09-09,Michael Rhodes,Ally Financial,10,26,4,40,
2025-09-09,Joseph Fadool,BorgWarner,4,10,0,14,
2025-09-09,St√©phane de La Faverie,Est√©e Lauder,10,26,4,40,
2025-09-09,Benjamin Tisch,Loews,2,7,0,9,
2025-09-09,Brad Beckham,O'Reilly Automotive,5,19,1,25,
2025-09-09,Thomas Gayner,Markel Group,1,9,0,10,
2025-09-09,Donald Allan,Stanley Black & Decker,9,30,1,40,
2025-09-09,Sanjay Mehrotra,Micron Technology,17,21,2,40,
2025-09-09,James Breuer,Fluor,1,1,1,3,
2025-09-09,Thomas Bell,Leidos,9,18,2,29,
2025-09-09,Scott Smith,Viatris,6,4,0,10,
2025-09-09,Kimberly Dang,Kinder Morgan,11,1,0,12,
2025-09-09,Christophe Beck,Ecolab,18,22,0,40,
2025-09-09,Brent Shafer,Baxter International,1,10,0,11,
2025-09-09,Clay Gaspar,Devon Energy,22,3,0,25,
2025-09-09,Steven Cahillane,Kellanova,1,7,0,8,
2025-09-09,Raul Nicholas Vargas Ochoa,Farmers Insurance Exchange,0,0,0,0,
2025-09-09,Darren Rebelez,Caseys General Stores,3,5,0,8,
2025-09-09,Ari Bousbib,IQVIA,6,16,1,23,
2025-09-09,Jon Vander Ark,Republic Services,12,20,8,40,
2025-09-09,Timothy Cofer,Keurig Dr Pepper,2,5,1,8,
2025-09-09,Karla Lewis,Reliance Inc,5,4,0,9,
2025-09-09,David Hult,Asbury Automotive Group,9,30,1,40,
2025-09-09,Darryl Button,Pacific Life,1,8,0,9,
2025-09-09,James Burke,Vistra,6,3,0,9,
2025-09-09,John Barrett,Western & Southern Financial,9,29,2,40,
2025-09-09,William Krueger,The Andersons Inc,0,3,0,3,
2025-09-09,Erik Nordstrom,Nordstrom,7,29,4,40,
2025-09-09,John Wren,Omnicom Group,13,21,6,40,
2025-09-09,Stephanie Ferris,Fidelity National Information Services,14,24,2,40,
2025-09-09,Timothy Cawley,Consolidated Edison,4,5,0,9,
2025-09-09,Joseph Hinrichs,CSX,5,11,1,17,
2025-09-09,Troy Rudd,AECOM,9,23,4,36,
2025-09-09,Kathleen Johnson,Lumen Technologies,4,5,1,10,
2025-09-09,Harry Lawton III,Tractor Supply,1,0,0,1,
2025-09-09,Raul Fernandez,DXC Technology,5,30,1,36,
2025-09-09,Eric Hansotia,AGCO,15,24,1,40,
2025-09-09,David Bruton Smith,Sonic Automotive,4,8,9,21,
2025-09-09,Sasan Goodarzi,Intuit,10,26,4,40,
2025-09-09,Matthew Flannery,United Rentals,32,2,0,34,
2025-09-09,Marc Miller,Universal Health Services,4,19,3,26,
2025-09-09,Michael Mahoney,Boston Scientific,12,28,0,40,
2025-09-09,Judith Marks,Otis Worldwide,3,4,0,7,
2025-09-09,Robert Frenzel,Xcel Energy,4,2,1,7,
2025-09-09,Penny Pennington,Edward Jones,8,26,6,40,
2025-09-09,Daniel Fisher,Ball,4,21,6,31,
2025-09-09,Justin Jude,LKQ,4,6,1,11,
2025-09-09,James Blackledge,Mutual of Omaha,1,33,1,35,
2025-09-09,Bruce Bodine,Mosaic,2,7,0,9,
2025-09-09,Scott Donnelly,Textron,9,28,3,40,
2025-09-09,Adam Schechter,Labcorp Holdings,3,5,0,8,
2025-09-09,Deanna Strable-Soethout,Principal Financial,1,6,0,7,
2025-09-09,Leonard Schleifer,Regeneron Pharmaceuticals,6,27,7,40,
2025-09-09,Paul Shoukry,Raymond James Financial,16,23,1,40,
2025-09-09,Lauren Hobart,Dicks Sporting Goods,11,23,4,38,
2025-09-09,Jamie Whisnant,Auto-Owners Insurance,0,2,0,2,
2025-09-09,Ariane Gorin,Expedia,9,30,1,40,
2025-09-09,Shelley Simpson,JB Hunt Transport Services,8,28,4,40,
2025-09-09,Ren√© Jones,M&T Bank,12,23,5,40,
2025-09-09,Gerardo Norcia,DTE Energy,7,2,0,9,
2025-09-09,Andr√©s Gluski,AES,14,23,0,37,
2025-09-09,Timothy Spence,Fifth Third Bancorp,5,3,2,10,
2025-09-09,Eduardo Menezes,Air Products & Chemicals,3,6,1,10,
2025-09-09,Wendell Weeks,Corning,16,22,2,40,
2025-09-09,Anthony Guzzi,EMCOR Group,3,2,1,6,
2025-09-09,Adam Norwitt,Amphenol,3,15,0,18,
2025-09-09,Jean-Marc Gilson,Westlake Corporation,2,3,0,5,
2025-09-09,Lori Koch,DuPont,7,18,0,25,
2025-09-09,Derek Chang,Liberty Media,37,3,0,40,
2025-09-09,Martina Cheung,S&P Global,10,26,0,36,
2025-09-09,Tim Hingtgen,Community Health Systems,11,27,2,40,
2025-09-09,Brian Tierney,FirstEnergy,6,22,3,31,
2025-09-09,Rick McKenney,Unum Group,5,4,0,9,
2025-09-09,Stanley Bergman,Henry Schein,12,27,1,40,
2025-09-09,Tiang Yew Tan,Western Digital,0,1,0,1,
2025-09-09,Vincent Roche,Analog Devices,12,23,4,39,
2025-09-09,Sean Connolly,Conagra Brands,7,31,2,40,
2025-09-09,Bruce Van Saun,Citizens Financial Group,14,25,1,40,
2025-09-09,Mark George,Norfolk Southern,17,19,4,40,
2025-09-09,Andrew Marsh,Entergy,3,5,0,8,
2025-09-09,Robert Berkley,WR Berkley,8,27,5,40,
2025-09-09,Javier Rodriguez,DaVita,14,14,1,29,
2025-09-09,Michael O'Grady,Northern Trust,30,7,1,38,
2025-09-09,James Snee,Hormel Foods,2,27,1,30,
2025-09-09,Timothy J Donahue,Crown Holdings,3,10,0,13,
2025-09-09,Joseph Ferraro,Avis Budget,3,6,1,10,
2025-09-09,Niraj Shah,Wayfair,7,26,7,40,
2025-09-09,Jos√© Mas,MasTec,7,13,1,21,
2025-09-09,Joseph Nolan,Eversource Energy,5,4,1,10,
2025-09-09,Thomas Palmer,Newmont,5,5,0,10,
2025-09-09,Robert Sanchez,Ryder System,9,9,1,19,
2025-09-09,Michael Nolan,Fidelity National Financial,3,0,0,3,
2025-09-09,Gavin Hattersley,Molson Coors Beverage,5,29,6,40,
2025-09-09,Thomas Reeg,Caesars Entertainment,5,5,0,10,
2025-09-09,Ellen Cooper,Lincoln National,2,7,0,9,
2025-09-09,Bracken Darrell,VF Corporation,8,29,3,40,
2025-09-09,Erik Fyrwald,International Flavors & Fragrances,7,7,4,18,
2025-09-09,Christopher Kastner,Huntington Ingalls Industries,3,5,0,8,
2025-09-09,Shane O'Kelly,Advance Auto Parts,14,22,4,40,
2025-09-09,Ralph LaRossa,Public Service Enterprise Group,12,17,0,29,
2025-09-09,Kecia Steelman,Ulta Beauty,35,4,1,40,
2025-09-09,Michele Buck,Hershey,6,32,2,40,
2025-09-09,Sumit Singh,Chewy,12,24,4,40,
2025-09-09,Steven Vondran,American Tower,4,6,0,10,
2025-09-09,Jeffrey Lorberbaum,Mohawk Industries,11,6,1,18,
2025-09-09,Keith Demmings,Assurant,4,7,0,11,
2025-09-09,Robert Martin,Thor Industries,3,6,1,10,
2025-09-09,Kathleen Mazzarella,Graybar Electric,1,6,1,8,
2025-09-09,Joey Wat,Yum China,13,25,2,40,
2025-09-09,Scott Richardson,Celanese,8,22,4,34,
2025-09-09,David Rawlinson II,QVC,8,15,2,25,
2025-09-09,Alan Armstrong,Williams,25,11,4,40,
2025-09-09,Philippe Krakowsky,Interpublic Group,13,24,3,40,
2025-09-09,Brendan McCracken,Ovintiv,6,5,0,11,
2025-09-09,Andrew Teno,Icahn Enterprises,5,5,0,10,
2025-09-09,Stephen Steinour,Huntington Bancshares,2,7,0,9,
2025-09-09,Timothy NeCastro,Erie Insurance,3,6,1,10,
2025-09-09,Ernest Garcia III,Carvana,24,12,4,40,
2025-09-09,R Bruce McDonald,Dana Incorporated,3,7,1,11,
2025-09-09,William Oplinger,Alcoa Corporation,1,8,0,9,
2025-09-09,Mark Pearson,Equitable,9,7,0,16,
2025-09-09,Richard Wallace,KLA,3,5,0,8,
2025-09-09,Ricardo Cardenas,Darden Restaurants,4,4,1,9,
2025-09-09,Mikael Bratt,Autoliv,5,8,2,15,
2025-09-09,Benito Minicucci,Alaska Air,2,3,1,6,
2025-09-09,Christopher Gorman,KeyCorp,5,5,0,10,
2025-09-09,Robert Goldstein,Las Vegas Sands,4,31,5,40,
2025-09-09,Edward Pesicka,Owens & Minor,3,31,2,36,
2025-09-09,Christopher Nassetta,Hilton Worldwide,8,16,2,26,
2025-09-09,Jamie Iannone,Ebay,15,22,3,40,
2025-09-09,Patrick Gallagher,Arthur J Gallagher,8,30,2,40,
2025-09-09,Rich Steinmeier,LPL Financial,25,13,2,40,
2025-09-09,Stephen Spray,Cincinnati Financial,1,7,1,9,
2025-09-09,Douglas Yearley,Toll Brothers,11,24,5,40,
2025-09-09,Gregory Brown,Motorola Solutions,1,9,0,10,
2025-09-09,Brian Chesky,Airbnb,2,31,7,40,
2025-09-09,Jeffrey Sprecher,Intercontinental Exchange,16,21,3,40,
2025-09-09,Robert Thomson,News Corp,6,32,2,40,
2025-09-09,Scott Boatwright,Chipotle Mexican Grill,8,27,5,40,
2025-09-09,Reshma Kewalramani,Vertex Pharmaceuticals,20,15,5,40,
2025-09-09,Christopher Viehbacher,Biogen,0,26,2,28,
2025-09-09,Malcolm Wilson,GXO Logistics,6,21,0,27,
2025-09-09,Tony Sarsam,SpartanNash,18,20,2,40,
2025-09-09,Michael O‚ÄôSullivan,Burlington Stores,9,27,4,40,
2025-09-09,Teresa Rasmussen,Thrivent Financial for Lutherans,3,2,0,5,
2025-09-09,Eugene Bredow,NVR,0,4,1,5,
2025-09-09,Brian Chambers,Owens Corning,3,10,0,13,
2025-09-09,Rafael Santana,Westinghouse Air Brake Technologies,3,7,1,11,
2025-09-09,John Pfeifer,Oshkosh Corporation,3,19,0,22,
2025-09-09,Cameron Bready,Global Payments,8,29,3,40,
2025-09-09,Calvin McDonald,Lululemon athletica,8,31,1,40,
2025-09-09,J Kent Masters,Albemarle Corporation,3,6,0,9,
2025-09-09,Joanna Geraghty,JetBlue Airways,13,19,8,40,
2025-09-09,Robert Steer,Seaboard,1,4,0,5,
2025-09-09,William Newlands,Constellation Brands,0,2,2,4,
2025-09-09,Michael Doss,Graphic Packaging,4,8,1,13,
2025-09-09,Gil West,Hertz,7,25,8,40,
2025-09-09,Malcolm C Roberts,FM Global,2,10,2,14,
2025-09-09,Mick Beekhuizen,Campbell Soup,8,22,0,30,
2025-09-09,Daniel Wall,Expeditors International of Washington,2,4,0,6,
2025-09-09,Gregory Roberts,A-Mark Precious Metals,1,4,1,6,
2025-09-09,Horacio Rozanski,Booz Allen Hamilton,16,19,5,40,
2025-09-09,James Davis,Quest Diagnostics,5,5,0,10,
2025-09-09,Dennis Mathew,Altice,5,28,7,40,
2025-09-09,Stefan Larsson,PVH,10,25,5,40,
2025-09-09,Mark Costa,Eastman Chemical,5,14,4,23,
2025-09-09,Joyce Mullen,Insight Enterprises,6,11,0,17,
2025-09-09,John Turner,Regions Financial,20,18,2,40,
2025-09-09,Julian G Francis,Beacon Roofing Supply,0,1,0,1,
2025-09-09,Blake Moret,Rockwell Automation,11,27,2,40,
2025-09-09,Mike Speetzen,Polaris Inc,3,18,2,23,
2025-09-09,William McDermott,ServiceNow,3,6,0,9,
2025-09-09,Jure Sola,Sanmina,3,12,0,15,
2025-09-09,Bob Flexon,UGI Utilities Inc,0,1,0,1,
2025-09-09,Scott Lauber,WEC Energy,15,6,0,21,
2025-09-09,Jon Rousseau,BrightSpring Health Services,20,19,1,40,
2025-09-09,Todd Schneider,Cintas,12,18,1,31,
2025-09-09,Peter Matt,Commercial Metals,5,4,0,9,
2025-09-09,Robert D Lawler,Continental Resources,0,0,0,0,
2025-09-09,Domenic Dell‚ÄôOsso Jr,Expand Energy,4,0,0,4,
2025-09-09,Jason P Wells,CenterPoint Energy,9,4,1,14,
2025-09-09,H Michael Krimbill,NGL Energy Partners,6,2,0,8,
2025-09-09,Tony Xu,DoorDash,14,19,7,40,
2025-09-09,Clay Williams,NOV,8,21,4,33,
2025-09-09,Kristin Peck,Zoetis,13,20,1,34,
2025-09-09,Mark Smucker,JM Smucker,14,19,7,40,
2025-09-09,Steve Sanghi,Microchip Technology,8,28,4,40,
2025-09-09,Richard Tobin,Dover Corporation,3,4,0,7,
2025-09-09,Kaes Van‚Äôt Hof,Diamondback Energy,21,15,3,39,
2025-09-09,Deon Stander,Avery Dennison,0,13,0,13,
2025-09-09,Vincent Sorgi,PPL,8,10,1,19,
2025-09-09,Hassane El-Khoury,ON Semiconductor,4,19,5,28,
2025-09-09,Arie Kotler,ARKO,5,23,1,29,
2025-09-09,William Monteleone,Par Pacific,1,6,2,9,
2025-09-09,John Christmann IV,APA,6,4,0,10,
2025-09-09,Adaire Fox-Martin,Equinix,14,22,4,40,
2025-09-09,Joseph M Otting,Flagstar Financial,2,6,2,10,
2025-09-09,Mary Dillon,Foot Locker,10,26,4,40,
2025-09-09,James Zallie,Ingredion,3,7,0,10,
2025-09-09,Christopher Peterson,Newell Brands,1,8,1,10,
2025-09-09,Scott Salmirs,ABM Industries,7,6,1,14,
2025-09-09,Christopher Hilger,Securian Financial,0,6,0,6,
2025-09-09,Hamid Moghadam,Prologis,8,27,5,40,
2025-09-09,Stephen Schwarzman,Blackstone,15,21,4,40,
2025-09-09,Robert Greenberg,Skechers USA,5,24,3,32,
2025-09-09,Keith Allman,Masco,4,9,1,14,
2025-09-09,Rusty Rush,Rush Enterprises,15,22,3,40,
2025-09-09,Jennifer Johnson,Franklin Resources,1,7,2,10,
2025-09-09,Gerry P Smith,ODP Business Solutions,0,1,0,1,
2025-09-09,Carl Lindner lll,American Financial,0,0,0,0,
2025-09-09,Mark Kowlzan,Packaging Corp of America,0,9,1,10,
2025-09-09,Thomas Hill,Vulcan Materials,4,6,2,12,
2025-09-09,Milan Galik,Interactive Brokers,6,19,2,27,
2025-09-09,Laura Alber,Williams-Sonoma,14,22,4,40,
2025-09-09,Mario Harik,XPO,7,32,1,40,
2025-09-09,Devin Stockfish,Weyerhaeuser,5,5,0,10,
2025-09-09,Thomas J McInerney,Genworth Financial,0,0,0,0,
2025-09-09,Garrick Rochow,CMS Energy,11,3,1,15,
2025-09-09,Toni Townes-Whitley,Science Applications International,12,21,1,34,
2025-09-09,Rich Handler,Jefferies Financial,12,10,2,24,
2025-09-09,Daniel Heaf,Bath & Body Works,15,23,2,40,
2025-09-09,Andrew Wilson,Electronic Arts,13,18,9,40,
2025-09-09,Sheryl Palmer,Taylor Morrison Home,8,12,1,21,
2025-09-09,Ivan Tornos,Zimmer Biomet,9,29,2,40,
2025-09-09,Linda Rendle,Clorox,2,35,2,39,
2025-09-09,Matthew Pine,Xylem Inc,1,8,1,10,
2025-09-09,Heather Lavallee,Voya Financial,7,11,2,20,
2025-09-09,Daniel Florness,Fastenal,4,4,2,10,
2025-09-09,Albert Nahmad,Watsco,2,7,0,9,
2025-09-09,Carl Eschenbach,Workday,13,18,9,40,
2025-09-09,Craig Smiddy,Old Republic International,1,7,1,9,
2025-09-09,Frank C Sullivan,RPM International,4,8,0,12,
2025-09-09,Matthew Missad,UFP Industries,7,3,0,10,
2025-09-09,Martin J Lyons,Ameren,1,4,1,6,
2025-09-09,Adam W Miller,Knight Swift Transportation,0,2,1,3,
2025-09-09,Rodney Sacks,Monster Beverage,11,27,1,39,
2025-09-09,Gary Guthart,Intuitive Surgical,13,23,4,40,
2025-09-09,Charles Liang,Super Micro Computer,35,4,1,40,
2025-09-09,Christopher Caldwell,Concentrix,3,5,0,8,
2025-09-09,Gordon J Hardie,O-I Glass,0,5,0,5,
2025-09-09,David Gibbs,Yum Brands,2,38,0,40,
2025-09-09,Steve Henry,Domtar,5,5,0,10,
2025-09-09,Chuck Treadway,CommScope,8,21,3,32,
2025-09-09,Rob Vitale,Post Holdings,1,11,5,17,
2025-09-09,Steven J Moskowitz,Crown Castle,2,5,3,10,
2025-09-09,Emmanuel Ligner,Avantor,2,11,1,14,
2025-09-09,Stuart Bradie,KBR,14,16,4,34,
2025-09-09,Carrie Wheeler,Opendoor Technologies,11,25,4,40,
2025-09-09,Russell Becker,APi Group,3,5,0,8,
2025-09-09,Toby Rice,EQT,24,13,3,40,
2025-09-09,Jesse Arenivas,EnLink Midstream,8,8,0,16,
2025-09-09,Nikesh Arora,Palo Alto Networks,6,26,8,40,
2025-09-09,Steven Bandrowczak,Xerox,1,8,1,10,
2025-09-09,Vicente Reynal,Ingersoll Rand,7,27,0,34,
2025-09-09,William T Dillard II,Dillards,3,4,2,9,
2025-09-09,C Howard Nye,Martin Marietta Materials,1,5,4,10,
2025-09-09,Giordano Albertazzi,Vertiv,16,19,4,39,
2025-09-09,Stephane Bancel,Moderna,9,20,11,40,
2025-09-09,Nate R Jorgensen,Boise Cascade,0,0,0,0,
2025-09-09,Jack Sinclair,Sprouts Farmers Market,16,24,0,40,
2025-09-09,Padraig McDonnell,Agilent Technologies,12,12,0,24,
2025-09-09,Kenneth T Lane,Olin,0,1,0,1,
2025-09-09,Randall C Stuewe,Darling Ingredients,25,1,0,26,
2025-09-09,R Howard Coker,Sonoco Products,2,7,1,10,
2025-09-09,John Mengucci,CACI International,20,18,2,40,
2025-09-09,Mark Witkowski,Core & Main,0,12,1,13,
2025-09-09,Lee M Tillman,Marathon Oil,4,3,0,7,
2025-09-09,Mark Hoplamazian,Hyatt Hotels,14,21,5,40,
2025-09-09,David S Chernow,Select Medical,0,9,1,10,
2025-09-09,Brendan M Foley,McCormick & Company,0,8,0,8,
2025-09-09,Joanne Crevoiserat,Tapestry,13,24,3,40,
2025-09-09,John Plant,Howmet Aerospace,5,12,3,20,
2025-09-09,Shankh Mitra,Welltower,15,23,2,40,
2025-09-09,W Anthony Will,CF Industries,2,5,0,7,
2025-09-09,David A Zapico,Ametek,3,17,1,21,
2025-09-09,Kevin Stein,TransDigm,10,9,1,20,
2025-09-09,Craig Billings,Wynn Resorts,11,27,2,40,
2025-09-09,William J Way,Southwestern Energy,1,0,0,1,
2025-09-09,Giel Rutten,Amkor Technology,3,7,1,11,
2025-09-09,Paul Sarvadi,Insperity,4,4,0,8,
2025-09-09,Donald Zurbay,Patterson Companies Inc,1,4,0,5,
2025-09-09,Rob Sharps,T Rowe Price,10,25,5,40,
2025-09-09,Patrice Louvet,Ralph Lauren,15,16,9,40,
2025-09-09,Jeffrey Mezger,KB Home,2,31,7,40,
2025-09-09,David M Foulkes,Brunswick,1,8,0,9,
2025-09-09,M Keith Waddell,Robert Half,2,7,1,10,
2025-09-09,Jay Snowden,PENN Entertainment,19,18,3,40,
2025-09-09,George Kurian,NetApp,15,23,2,40,
2025-09-09,Kevin Ali,Organon,9,17,2,28,
2025-09-09,Joel D Anderson,Petco Health and Wellness,3,8,0,11,
2025-09-09,Louis V Pinkham,Regal Rexnord,0,0,0,0,
2025-09-09,Jay Geldmacher,Resideo Technologies,8,6,0,14,
2025-09-09,Marcus Lemonis,Camping World,10,21,9,40,
2025-09-09,Peter R Huntsman,Huntsman,7,11,3,21,
2025-09-09,Hillary Super,Victorias Secret,11,4,8,23,
2025-09-09,Michelle Gass,Levi Strauss,12,25,2,39,
2025-09-09,Neil Hunn,Roper Technologies,2,21,0,23,
2025-09-09,Steven P Lawrence,Academy Sports and Outdoors,1,1,0,2,
2025-09-09,Phillippe Lord,Meritage Homes,8,15,0,23,
2025-09-09,David C Dauch,American Axle & Manufacturing,5,6,2,13,
2025-09-09,Olumide Soroye,Fortive,1,9,0,10,
2025-09-09,Adena Friedman,Nasdaq,15,20,5,40,
2025-09-09,Tim Gokey,Broadridge Financial Solutions,4,12,1,17,
2025-09-09,Patrick M Shanahan,Spirit AeroSystems,2,8,0,10,
2025-09-09,Robert Kyncl,Warner Music Group,10,28,2,40,
2025-09-09,Denise Dignam,Chemours,2,19,2,23,
2025-09-09,Jim DeVries,ADT,11,6,1,18,
2025-09-09,Bernard Zovighian,Edwards Lifesciences,6,7,2,15,
2025-09-09,Mark E Seaton,First American Financial,1,9,0,10,
2025-09-09,John C Roche,Hanover Insurance Group,8,17,1,26,
2025-09-09,Adam J Greenlee,Silgan,0,4,0,4,
2025-09-09,Jayne Hrdlicka,Endeavor Group,0,1,0,1,
2025-09-09,Robert Fauber,Moodys Corporation,0,6,0,6,
2025-09-09,Thomas E Jorden,Coterra Energy,8,0,0,8,
2025-09-09,Eugene A Hall,Gartner,1,8,0,9,
2025-09-09,Kevin Plank,Under Armour,8,28,4,40,
2025-09-09,James W Lanning,Ingles Markets,3,3,0,6,
2025-09-09,Matthew T Farrell,Church & Dwight,7,7,0,14,
2025-09-09,Kevin M Freeman,Old Dominion Freight Line,0,0,0,0,
2025-09-09,Joe Shoen,U-Haul,15,20,4,39,
2025-09-09,Mark Bertolini,Oscar Health,14,17,9,40,
2025-09-09,Jayshree Ullal,Arista Networks,20,18,2,40,
2025-09-09,Sassine Ghazi,Synopsys,10,27,3,40,
2025-09-09,Jochen Zeitz,Harley-Davidson,7,24,9,40,
2025-09-09,Nick Jeffery,Frontier Communications,10,26,1,37,
2025-09-09,Thomas Edward McCormick,Primoris Services,0,4,0,4,
2025-09-09,D Christian Koch,Carlisle Companies,1,3,0,4,
2025-09-09,David E Simon,Simon Property Group,4,4,2,10,
2025-09-09,Stephen Bratspies,Hanesbrands,3,11,1,15,
2025-09-09,Ryan M. Schneider,Anywhere Real Estate Inc,0,1,0,1,
2025-09-09,George Bobb III,Teledyne Technologies,1,4,0,5,
2025-09-09,Terrence A Duffy,CME Group,6,8,1,15,
2025-09-09,Rami Rahim,Juniper Networks,11,26,3,40,
2025-09-09,Sue Nabi,Coty,16,17,7,40,
2025-09-09,Peter D Arvan,Pool Corporation,2,7,0,9,
2025-09-09,David Campbell,Evergy,14,10,0,24,
2025-09-09,Matthew J Murphy,Marvell Technology,3,6,1,10,
2025-09-09,Lloyd Yates,NiSource,6,4,0,10,
2025-09-09,William C Stone,SS&C Technologies,2,6,0,8,
2025-09-09,Mark Rourke,Schneider National,10,18,1,29,
2025-09-09,Andrew Anagnost,Autodesk,10,23,7,40,
2025-09-09,Dustin Semach,Sealed Air Corporation,0,9,0,9,
2025-09-09,William L Meaney,Iron Mountain,3,18,0,21,
2025-09-09,Andy P Power,Digital Realty Trust,0,0,0,0,
2025-09-09,Satish Dhanasekaran,Keysight Technologies,2,10,0,12,
2025-09-09,Frank M Svoboda,Globe Life,3,4,3,10,
2025-09-09,Carey A Smith,Parsons Corporation,0,2,0,2,
2025-09-09,Ynon Kreiz,Mattel,7,26,7,40,
2025-09-09,Karen S Haller,Southwest Gas,2,7,0,9,
2025-09-09,Terrance Williams,TruStage,3,6,1,10,
2025-09-09,Eric W Gerstenberg,Clean Harbors,4,2,1,7,
2025-09-09,Gunner Smith,Cornerstone Building Brands,1,8,0,9,
2025-09-09,Gerben W Bakker,Hubbell,1,4,0,5,
2025-09-09,Dave Davis,Spirit Airlines,7,24,2,33,
2025-09-09,Michael J Smith,Lamb Weston,0,6,3,9,
2025-09-09,Strauss Zelnick,Take-Two Interactive Software,13,19,8,40,
2025-09-09,John C Turner Jr,GMS,2,7,0,9,
2025-09-09,David M O'Malley,Penn Mutual Life Insurance,1,3,0,4,
2025-09-09,Frank A Lonegro,Landstar System,2,4,0,6,
2025-09-09,James F Risoleo,Host Hotels & Resorts,5,17,0,22,
2025-09-09,Ken Xie,Fortinet,12,21,7,40,
2025-09-09,Doug Shulman,OneMain,4,6,0,10,
2025-09-09,Ryan Cohen,GameStop,13,21,6,40,
2025-09-09,Mark W Begor,Equifax,3,13,0,16,
2025-09-09,Jay L Schottenstein,American Eagle Outfitters,4,12,0,16,
2025-09-09,Curtis C Farmer,Comerica,5,9,0,14,
2025-09-09,Ole Rosgaard,Greif,3,16,1,20,
2025-09-09,Brian E Lane,Comfort Systems USA,9,0,0,9,
2025-09-09,Robert M Buck,TopBuild,0,5,0,5,
2025-09-09,Ralph Andretta,Bread Financial,3,9,0,12,
2025-09-09,Jim Anderson,Coherent,6,34,0,40,
2025-09-09,Walter C. D. Carlson,Telephone & Data Systems,0,3,0,3,
2025-09-09,Ronald Kruszewski,Stifel Financial,7,4,0,11,
2025-09-09,Richard Hayne,Urban Outfitters,12,20,8,40,
2025-09-09,Simon Meester,Terex,3,7,0,10,
2025-09-09,Edward J Lehner,Ryerson Holding,0,2,0,2,
2025-09-09,Nicholas T Pinchuk,Snap-on,3,6,0,9,
2025-09-09,Ryals McMullian,Flowers Foods,5,31,3,39,
2025-09-09,D Bryan Jordan,First Horizon,3,8,1,12,
2025-09-09,John B Gibson,Paychex,3,7,0,10,
2025-09-09,Chris Cocks,Hasbro,13,19,8,40,
2025-09-09,Pete McPartland,Sentry Insurance Group,0,2,0,2,
2025-09-09,Michael Arougheti,Ares Management,15,23,1,39,
2025-09-09,Alok Maskara,Lennox International,5,3,1,9,
2025-09-09,James C Grech,Peabody Energy,3,0,0,3,
2025-09-09,Joseph P Lacher Jr,Kemper,5,19,4,28,
2025-09-09,Perry A Sook,Nexstar Media Group,9,27,1,37,
2025-09-09,Wade Davis,TelevisaUnivision,13,26,1,40,
2025-09-09,Scott L Thompson,Tempur Sealy International,0,6,0,6,
2025-09-09,Mike Simonds,TriNet Group,0,8,0,8,
2025-09-09,B Andrew Rose,Worthington Enterprises,1,1,0,2,
2025-09-09,Bruce L Caswell,Maximus,3,5,0,8,
2025-09-09,Robert L Reffkin,Compass,1,6,0,7,
2025-09-09,Mark Eubanks,Brinks Company,1,2,1,4,
2025-09-09,Peter Quigley,Kelly Services inc,2,7,0,9,
2025-09-09,David L Yowan,Navient,2,2,0,4,
2025-09-09,Mary E Kipp,Puget Sound Energy,4,1,2,7,
2025-09-09,Adam Aron,AMC Entertainment,16,18,6,40,
2025-09-09,Mark J Tarr,Encompass Health,2,6,1,9,
2025-09-09,Liam K Griffin,Skyworks Solutions,1,7,0,8,
2025-09-09,Richard G Kyle,Timken,3,16,1,20,
2025-09-09,Ron Gusek,Liberty Energy,21,1,0,22,
2025-09-09,John E Geller Jr,Marriott Vacations Worldwide,6,5,0,11,
2025-09-09,Karl G. Glassman,Leggett & Platt,0,4,0,4,
2025-09-09,Bruce K Thorn,Big Lots,2,6,2,10,
2025-09-09,Jonathan H Weis,Weis Markets,10,29,0,39,
2025-09-09,Jeffrey B Guldner,Pinnacle West Capital,1,3,0,4,
2025-09-09,Arkadiy Dobkin,EPAM Systems,11,16,1,28,
2025-09-09,Paul M Rady,Antero Resources,4,8,0,12,
2025-09-09,Michael Spanos,Bloomin Brands,1,9,1,11,
2025-09-09,Nicole A Kivisto,MDU Resources Group,2,3,0,5,
2025-09-09,Gerald L Morgan,Texas Roadhouse,4,2,4,10,
2025-09-09,Gabriel Tirador,Mercury General,4,4,2,10,
2025-09-09,Nicholas I Fink,Fortune Brands Innovations,4,6,0,10,
2025-09-09,Paul E Burdiss,Zions Bancorp,1,1,0,2,
2025-09-09,William J Christensen,JELD-WEN Holding,4,5,0,9,
2025-09-09,Evan Spiegel,Snap Inc,21,16,3,40,
2025-09-09,Bill Burns,Zebra Technologies,5,23,1,29,
2025-09-09,Steven Sell,Agilon Health,0,8,0,8,
2025-09-09,Richard M Olson,Toro Company,1,13,0,14,
2025-09-09,Eric S Yuan,Zoom Video Communications,6,7,0,13,
2025-09-09,Dan L Batrack,Tetra Tech,2,4,1,7,
2025-09-09,Joseph D Russell Jr,Public Storage,0,8,0,8,
2025-09-09,Jacob Thaysen,Illumina inc,4,7,0,11,
2025-09-09,Debra A Cafaro,Ventas inc,6,7,0,13,
2025-09-09,Pierre R Brondeau,FMC Corporation,0,5,0,5,
2025-09-09,Judy R McReynolds,ArcBest,6,15,1,22,
2025-09-09,Russell J Weiner,Dominos Pizza inc,0,0,0,0,
2025-09-09,Theodore S Hanson,ASGN,0,1,0,1,
2025-09-09,RJ Scaringe,Rivian Automotive,10,27,3,40,
2025-09-09,Jeffrey N Simmons,Elanco Animal Health,2,5,1,8,
2025-09-09,Tim O Shaughnessy,Graham Holdings Company,2,8,0,10,
2025-09-09,Thomas V Taylor,Floor & Decor,1,2,1,4,
2025-09-09,Neil A Schrimsher,Applied Industrial Technologies,4,26,1,31,
2025-09-09,Robert E Price,PriceSmart,4,6,0,10,
2025-09-09,John David Risher,Lyft,4,3,1,8,
2025-09-09,Gary B Smith,Ciena,3,7,0,10,
2025-09-09,Joey Levin,IAC,7,31,1,39,
2025-09-09,Jim Jacobs,Country Financial,7,3,2,12,
2025-09-09,Devin B McGranahan,Western Union,1,5,0,6,
2025-09-09,R Scott Rowe,Flowserve,5,4,1,10,
2025-09-09,Kenneth A Vecchione,Western Alliance Bancorp,0,0,1,1,
2025-09-09,John C Rademacher,Option Care Health,9,1,0,10,
2025-09-09,Doug Black,SiteOne Landscape Supply,2,19,2,23,
2025-09-09,Oliver G Brewer III,Topgolf Callaway Brands,1,0,0,1,
2025-09-09,Glenn Sanford,eXp World,15,20,5,40,
2025-09-09,Fran Horowitz,Abercrombie & Fitch,13,20,7,40,
2025-09-09,Kevin Akers,Atmos Energy,8,2,0,10,
2025-09-09,Alessandro Maselli,Catalent,3,12,3,18,
2025-09-09,J Powell Brown,Brown & Brown,13,20,7,40,
2025-09-09,Aman Bhutani,GoDaddy,17,21,2,40,
2025-09-09,John C. Griffith,American Water Works,0,4,0,4,
2025-09-09,John J Marchioni,Selective Insurance Group,4,11,3,18,
2025-09-09,Lawson E Whiting,Brown-Forman,1,7,1,9,
2025-09-09,Dave Peacock,Advantage Solutions,22,8,0,30,
2025-09-09,Mick Farrell,ResMed,16,22,2,40,
2025-09-09,Kamal Hathi,Splunk,2,4,0,6,
2025-09-09,Todd Kelsey,Plexus,2,7,0,9,
2025-09-09,Phillip D Yeager,Hub Group,4,5,0,9,
2025-09-09,Steven B Hedlund,Lincoln Electric,4,7,0,11,
2025-09-09,Timothy C Oliver,NCR Atleos,0,1,0,1,
2025-09-09,Bruce Fleming,Calumet,2,6,0,8,
2025-09-09,Daniel S. Peyovich,Dycom Industries,0,3,0,3,
2025-09-09,Avner M Applbaum,Valmont Industries,0,8,0,8,
2025-09-09,Kimberly A Fields,ATI inc,4,9,0,13,
2025-09-09,Khozema Z Shipchandler,Twilio,0,2,0,2,
2025-09-09,Gary C Bhojwani,CNO Financial Group,1,5,1,7,
2025-09-09,William Andrew Hendricks Jr,Patterson-UTI Energy,0,0,0,0,
2025-09-09,Kevin D Hochman,Brinker International,1,3,0,4,
2025-09-09,James C Foster,Charles River Laboratories International,2,9,0,11,
2025-09-09,Rajiv K Prasad,Hyster-Yale,2,5,0,7,
2025-09-09,Eric T Steigerwalt,Brighthouse Financial,1,2,0,3,
2025-09-09,Thomas L Ryan,Service Corp International,6,4,0,10,
2025-09-09,Charles M Nifong Jr,CrossAmerica Partners,0,0,0,0,
2025-09-09,Anirudh Devgan,Cadence,13,24,3,40,
2025-09-09,Andi Owen,MillerKnoll,16,16,8,40,
2025-09-09,Sumit Roy,Realty Income,15,20,2,37,
2025-09-09,Timothy John Fitzgerald,Middleby,0,0,0,0,
2025-09-09,Robert H Schottenstein,M/I Homes,1,10,0,11,
2025-09-09,Stephen P MacMillan,Hologic,1,7,1,9,
2025-09-09,Lisa M Barton,Alliant Energy,3,0,0,3,
2025-09-09,Aaron P Jagdfeld,Generac,1,5,1,7,
2025-09-09,Erik Gershwind,MSC Industrial Direct,3,5,2,10,
2025-09-09,Varun Krishna,Rocket Companies,8,31,1,40,
2025-09-09,Fahmi Karam,Upbound Group,5,3,0,8,
2025-09-09,NADominic Ng,East West Bancorp,0,0,0,0,
2025-09-09,Mark Wang,Hilton Grand Vacations,38,2,0,40,
2025-09-09,Robert J Sheedy Jr,Grocery Outlet Holding,0,0,0,0,
2025-09-09,Simon D Campion,Dentsply Sirona,0,3,0,3,
2025-09-09,Jeremy Wensinger,V2X,6,8,0,14,
2025-09-09,Andrew Rees,Crocs,14,14,12,40,
2025-09-09,David M Maura,Spectrum Brands,6,0,0,6,
2025-09-09,Sachin S Lawande,Visteon,0,0,0,0,
2025-09-09,Neil M Ashe,Acuity Inc,0,2,0,2,
2025-09-09,Lorie L Tekorius,Greenbrier,1,9,0,10,
2025-09-09,John R Ciulla,Webster Financial,5,5,0,10,
2025-09-09,Sean D Keohane,Cabot Corporation,2,4,0,6,
2025-09-09,Drew M Wilkerson,RXO inc,0,0,0,0,
2025-09-09,Daniel E Brown,Chord Energy,1,0,0,1,
2025-09-09,Javier D Ferrer Fernandez,Popular inc,0,0,0,0,
2025-09-09,Olivier Rabiller,Garrett Motion inc,4,8,0,12,
2025-09-09,Ronald N Tutor,Tutor Perini Corporation,2,6,0,8,
2025-09-09,Jeff Liaw,Copart,4,5,0,9,
2025-09-09,Aman Narang,Toast inc,4,6,1,11,
2025-09-09,Joseph M Hogan,Align Technology,3,5,0,8,
2025-09-09,Kevin J Wheeler,A O Smith,0,17,1,18,
2025-09-09,Christopher A Cartwright,TransUnion,2,0,2,4,
2025-09-09,James Kelly,NCR Voyix,2,11,0,13,
2025-09-09,Tom Leighton,Akamai Technologies,14,14,5,33,
2025-09-09,Robert G Painter,Trimble,7,1,0,8,
2025-09-09,Tony Helton,Medical Mutual of Ohio,3,4,1,8,
2025-09-09,Caroline S Grace,AMN Healthcare Services,0,0,0,0,
2025-09-09,Patrick Kaltenbach,Mettler-Toledo International,1,9,0,10,
2025-09-09,Michael L Baur,ScanSource,0,1,0,1,
2025-09-09,Jason Lippert,LCI Industries,2,11,0,13,
2025-09-09,Fredric J Tomczyk,Cboe Global Markets,1,7,1,9,
2025-09-09,Octavio Marquez,Diebold Nixdorf,5,10,1,16,
2025-09-09,Sivasankaran Somasundaram,ChampionX,6,2,0,8,
2025-09-09,Ronald F Clarke,Corpay,0,0,0,0,
2025-09-09,Robert W Pittman,iHeartMedia,5,3,0,8,
2025-09-09,Patrick Zalupski,Dream Finders Homes,23,15,2,40,
2025-09-09,Keith E Smith,Boyd Gaming,0,6,0,6,
2025-09-09,Mehran Assadi,NLV Financial,1,1,0,2,
2025-09-09,Barry R Port,Ensign Group,2,5,2,9,
2025-09-09,Denise A Paulonis,Sally Beauty,1,2,0,3,
2025-09-09,Clifford A Skelton,Conduent,0,1,0,1,
2025-09-09,Jean-Michel Ribieras,Sylvamo,2,6,0,8,
2025-09-09,Douglas F Bauer,Tri Pointe Homes,0,6,0,6,
2025-09-09,Shawn O'Connell,EnerSys,4,5,0,9,
2025-09-09,Bill Meury,Incyte,7,14,0,21,
2025-09-09,Dale Francescon,Century Communities,2,11,3,16,
2025-09-09,Michael Nierenberg,Rithm Capital,10,28,2,40,
2025-09-09,Michael J Brown,Euronet Worldwide,3,6,0,9,
2025-09-09,Scott Seu,Hawaiian Electric Industries,5,17,1,23,
2025-09-09,Jason D Robins,DraftKings,5,2,0,7,
2025-09-09,Jonathan J Mazelsky,IDEXX Laboratories,1,1,1,3,
2025-09-09,Richard S Swartz,MYR Group,0,1,0,1,
2025-09-09,Stefano Caroti,Deckers Outdoor,2,7,1,10,
2025-09-09,Kevin R Sayer,DexCom,2,3,0,5,
2025-09-09,John T C Lee,MKS Instruments,3,9,0,12,
2025-09-09,Edward B Pitoniak,VICI Properties,1,7,0,8,
2025-09-09,Albert White III,Cooper Cos,0,0,0,0,
2025-09-09,Barry L Biffle,Frontier Airlines,1,6,6,13,
2025-09-09,Robert A Bruggeworth,Qorvo,5,4,0,9,
2025-09-09,Winnie Park,Five Below,8,28,4,40,
2025-09-09,Steven Oakland,TreeHouse Foods,2,13,0,15,
2025-09-09,James S Hagedorn,Scotts Miracle-Gro,1,0,0,1,
2025-09-09,Michael Cannon-Brookes,Atlassian,15,24,0,39,
2025-09-09,Bertrand Loy,Entegris,3,10,1,14,
2025-09-09,William E Waltz,Atkore,3,6,0,9,
2025-09-09,Celeste B Mastin,H B Fuller,1,3,0,4,
2025-09-09,Kyle T Larkin,Granite Construction,1,7,0,8,
2025-09-09,Michael J Happe,Winnebago Industries,1,3,0,4,
2025-09-09,Steven H Gunby,FTI Consulting,5,10,0,15,
2025-09-09,Stephan B Tanda,AptarGroup,1,5,2,8,
2025-09-09,Timothy P Boyle,Columbia Sportswear,4,2,2,8,
2025-09-09,Anthony J Wood,Roku,5,3,1,9,
2025-09-09,M Christopher Doyle,Civitas Resources,1,2,0,3,
2025-09-09,Andy Eidson,Alpha Metallurgical Resources,1,7,1,9,
2025-09-09,Andy L Nemeth,Patrick Industries,4,2,0,6,
2025-09-09,Roger W Jenkins,Murphy Oil,5,16,0,21,
2025-09-09,Kevin S Blair,Synovus Financial,6,2,1,9,
2025-09-09,Julie Felss Masino,Cracker Barrel Old Country Store,8,19,13,40,
2025-09-09,David M Overton,Cheesecake Factory,1,9,0,10,
2025-09-09,Nick DeIuliis,CNX Resources,5,4,0,9,
2025-09-09,Christopher Pappas,Chefs Warehouse,4,10,1,15,
2025-09-09,Tod Carpenter,Donaldson Company,2,8,0,10,
2025-09-09,Gregory L Christopher,Mueller Industries,2,5,0,7,
2025-09-09,Rob Saltiel,MRC Global,6,12,1,19,
2025-09-09,Jillian C Evanko,Chart Industries,3,7,0,10,
2025-09-09,Dave Guilmette,Alight Solutions,3,7,0,10,
2025-09-09,Joel Smejkal,Vishay Intertechnology,4,4,1,9,
2025-09-09,Dennis Degner,Range Resources,3,8,0,11,
2025-09-09,Ira D Robbins,Valley National Bancorp,1,2,0,3,
2025-09-09,Bernard Kim,Match Group,15,18,7,40,
2025-09-09,Vincent Pilette,Gen Digital,3,10,0,13,
2025-09-09,Timothy S Crane,Wintrust Financial,2,6,1,9,
2025-09-09,Pat Roche,Moog inc,4,11,2,17,
2025-09-09,Mark R Widmar,First Solar,2,6,2,10,
2025-09-09,Niko Lahanas,Central Garden & Pet,2,11,0,13,
2025-09-09,Chris Osowski,Green Plains inc,4,11,1,16,
2025-09-09,Derek J Leathers,Werner Enterprises,1,7,0,8,
2025-09-09,Adam Foroughi,AppLovin,11,25,4,40,
2025-09-09,Luca Savi,ITT,2,6,1,9,
2025-09-09,Lawrence H Silber,Herc Rentals,0,0,0,0,
2025-09-09,Hilton H Howell Jr,Gray Television,7,21,1,29,
2025-09-09,Eric D Ashleman,IDEX,0,9,1,10,
2025-09-09,Owen D Thomas,Boston Properties,3,7,0,10,
2025-09-09,Kurt Wolf,Pitney Bowes,6,18,1,25,
2025-09-09,Sara E Armbruster,Steelcase,2,0,0,2,
2025-09-09,Charles D. Young,Sun Communities,2,5,0,7,
2025-09-09,Suzanne Foster,AdaptHealth,5,8,1,14,
2025-09-09,Grant E Sims,Genesis Energy,2,2,0,4,
2025-09-09,Laura Prieskorn,Jackson Financial,1,6,2,9,
2025-09-09,Rick L Wessel,FirstCash,4,5,1,10,
2025-09-09,Sherman Miller,Cal-Maine Foods,12,28,0,40,
2025-09-09,Paul A Lang,Arch Resources,5,3,0,8,
2025-09-09,Ashish K Khandpur,Avient,2,7,0,9,
2025-09-09,Shyam K Reddy,BlueLinx,1,7,0,8,
2025-09-09,Christopher S Ripley,Sinclair,1,8,0,9,
2025-09-09,Stacy Kymes,BOK Financial,8,6,0,14,
2025-09-09,James H Walter,Permian Resources,0,1,0,1,
2025-09-09,Jason Murray,PACS Group,5,13,2,20,
2025-09-09,Brian Armstrong,Coinbase Global,12,22,6,40,
2025-09-09,Oscar K Brown,Western Midstream Partners,1,3,0,4,
2025-09-09,Nicholas R Lower,Federated Mutual Insurance,0,1,0,1,
2025-09-09,Morris Goldfarb,G-III Apparel Group,8,26,6,40,
2025-09-09,Mark D Morelli,Vontier,0,4,0,4,
2025-09-09,Matthew J Cox,Matson inc,1,6,0,7,
2025-09-09,David W Grzebinski,Kirby Corporation,1,3,0,4,
2025-09-09,Keith A Harvey,Kaiser Aluminum,3,4,1,8,
2025-09-09,Eric Nyman,Vista Outdoor,4,11,1,16,
2025-09-09,Doug Howe,Designer Brands,5,19,0,24,
2025-09-09,Jerry E Gahlhoff Jr,Rollins inc,0,2,0,2,
2025-09-09,D Scott Barbour,Advanced Drainage Systems,3,2,0,5,
2025-09-09,Sean Gamble,Cinemark,17,21,2,40,
2025-09-09,George Kurtz,CrowdStrike,16,21,3,40,
2025-09-09,Bill Ready,Pinterest,24,16,0,40,
2025-09-09,Fidji Simo,Instacart,9,30,1,40,
2025-09-09,Kimberly K Ryan,Hillenbrand,3,6,0,9,
2025-09-09,David S Graziosi,Allison Transmission,1,17,3,21,
2025-09-09,Gary G Friedman,Restoration Hardware,1,4,0,5,
2025-09-09,Lucinda M Baier,Brookdale Senior Living,4,3,1,8,
2025-09-09,Brian J Blaser,QuidelOrtho,1,9,0,10,
2025-09-09,E Jean Savage,Trinity Industries,1,8,1,10,
2025-09-09,Liam J Kelly,Teleflex,0,3,1,4,
2025-09-09,Laurans A Mendelson,HEICO,6,18,1,25,
2025-09-09,Frank H Laukien,Bruker,2,7,0,9,
2025-09-09,Harvey M Schwartz,Carlyle Group,5,12,0,17,
2025-09-09,Mark S LaVigne,Energizer,3,1,0,4,
2025-09-09,Joel Quadracci,Quad/Graphics,11,23,5,39,
2025-09-09,Amar Maletira,Rackspace Technology,5,12,2,19,
2025-09-09,Udit Batra,Waters Corporation,9,25,0,34,
2025-09-09,Eric M Green,West Pharmaceutical Services,2,7,0,9,
2025-09-09,Doug Palladini,Carters inc,2,2,2,6,
2025-09-09,G Mike Mikan,NeueHealth,4,2,0,6,
2025-09-09,Russell ChipChilds,SkyWest,0,0,0,0,
2025-09-09,Christopher H Hunter,Acadia Healthcare,0,2,0,2,
2025-09-09,Prahlad Singh,Revvity,2,7,0,9,
2025-09-09,Maria M Pope,Portland General Electric,1,1,0,2,
2025-09-09,Charles Chip Blankenship,Woodward inc,0,1,0,1,
2025-09-09,Mike Steib,TEGNA,15,18,1,34,
2025-09-09,Kurt J Ekert,Sabre Corporation,0,1,0,1,
2025-09-09,Matt Wilson,Light & Wonder,18,18,4,40,
2025-09-09,Rob Katz,Vail Resorts,3,11,26,40,
2025-09-09,Schnitzer Steel Industries,Radius Recycling,7,25,6,38,
2025-09-09,David A Spector,PennyMac Financial Services,6,2,0,8,
2025-09-09,Frederick J Holzgrefe III,Saia inc,1,1,0,2,
2025-09-09,Mark J Parrell,Equity Residential,4,7,0,11,
2025-09-09,John W Lindsay,Helmerich & Payne,0,4,0,4,
2025-09-09,Gary D Burnison,Korn Ferry,4,14,0,18,
2025-09-09,Timothy J McGrath,PC Connection Inc,1,2,0,3,
2025-09-09,Lynn M Bamford,Curtiss-Wright,12,8,0,20,
2025-09-09,Jonathan W Witter,Sallie Mae,0,1,0,1,
2025-09-09,Jeff Benck,Benchmark Electronics,6,9,0,15,
2025-09-09,Charles H Giancarlo,Pure Storage,1,3,0,4,
2025-09-09,Brian R Gray,Knife River Corporation,0,1,0,1,
2025-09-09,Jay Schmidt,Caleres inc,3,5,2,10,
2025-09-09,Dale Asplund,BrightView Holdings,1,6,0,7,
2025-09-09,Jeffrey S Edwards,Cooper-Standard,0,6,0,6,
2025-09-09,Glenn J Williams,Primerica,5,2,2,9,
2025-09-09,Francois Locoh-Donou,F5,8,21,2,31,
2025-09-09,Joseph Wm Foran,Matador Resources,8,8,0,16,
2025-09-09,Sridhar Ramaswamy,Snowflake inc,9,25,3,37,
2025-09-09,Mark D Dankberg,Viasat,2,3,3,8,
2025-09-09,Francisco J Leon,California Resources,1,3,1,5,
2025-09-09,Peter Stern,Peloton,17,19,4,40,
2025-09-09,David Baszucki,Roblox,9,22,9,40,
2025-09-09,Jeffrey W Edwards,Installed Building Products,0,2,0,2,
2025-09-09,Clark Lauritzen,First National of Nebraska,1,7,0,8,
2025-09-09,Carlos Alberini,Guess inc,12,27,1,40,
2025-09-09,Shyam P Kambeyanda,ESAB,4,3,0,7,
2025-09-09,Edmund Shallcross III,Amica Mutual Insurance,1,5,0,6,
2025-09-09,Benjamin W Schall,AvalonBay Communities,1,5,1,7,
2025-09-09,Allan C Thygesen,DocuSign,2,8,0,10,
2025-09-09,Bryan J Knutson,Titan Machinery,1,2,1,4,
2025-09-09,Heath Sampson,ModivCare,7,2,0,9,
2025-09-09,Ara K Hovnanian,Hovnanian Enterprises,1,16,1,18,
2025-09-09,Joshua G Silverman,Etsy,1,2,0,3,
2025-09-09,Kevin Roycraft,Adams Resources & Energy,5,4,1,10,
2025-09-09,J Eric Evans,Surgery Partners,1,1,0,2,
2025-09-09,Clint E Stein,Columbia Banking System,1,7,0,8,
2025-09-09,Lee M Shavel,Verisk Analytics,2,7,0,9,
2025-09-09,Dave Banyard Jr,MasterBrand,0,0,0,0,
2025-09-09,Peter R Ingram,Hawaiian Airlines inc,1,0,0,1,
2025-09-09,Kristin A Dolan,AMC Networks,4,2,0,6,
2025-09-09,Brendan T Cavanagh,SBA Communications,1,2,0,3,
2025-09-09,George F Chappelle Jr,Americold Realty Trust,1,3,0,4,
2025-09-09,Thomas E Gottwald,NewMarket Corporation,2,8,0,10,
2025-09-09,Thomas J Baltimore Jr,Park Hotels & Resorts,4,30,1,35,
2025-09-09,Peter M Moglia,Alexandria Real Estate Equities,3,5,0,8,
2025-09-09,Ronald J Kramer,Griffon Corporation,1,6,0,7,
2025-09-09,John L Plueger,Air Lease,2,12,0,14,
2025-09-09,Jennifer F Scanlon,UL Solutions,1,4,0,5,
2025-09-09,Greg Smith,Teradyne,1,8,2,11,
2025-09-09,Sean Trauschke,OGE Energy,18,5,0,23,
2025-09-09,Norman D Schwartz,Bio-Rad Laboratories,0,0,1,1,
2025-09-09,Scott Doyle,Spire inc,4,5,1,10,
2025-09-09,Michael E Reed,Gannett,0,5,2,7,
2025-09-09,Cindy J Miller,Stericycle,2,5,2,9,
2025-09-09,Phillip D Green,Cullen Frost Bankers,1,4,3,8,
2025-09-09,Joseph D Margolis,Extra Space Storage,0,9,1,10,
2025-09-09,Mark A Skonieczny,REV Group,7,3,0,10,
2025-09-09,Ladd Wilks,ProFrac Holding,4,2,0,6,
2025-09-09,Sundaram Nagarajan,Nordson,0,9,1,10,
2025-09-09,Anne P Noonan,Summit Materials,0,1,0,1,
2025-09-09,Lori Flees,Valvoline inc,4,5,1,10,
2025-09-09,Scott H Baxter,Kontoor Brands,2,1,0,3,
2025-09-09,Tim Larson,Skyline Champion,8,0,0,8,
2025-09-09,Chuck Divita,Teladoc Health,10,20,5,35,
2025-09-09,W Bradley Southern,Louisiana-Pacific Corporation,0,0,0,0,
2025-09-09,George C Freeman III,Universal Corporation,2,6,0,8,
2025-09-09,James A Brock,Consol Energy,1,0,0,1,
2025-09-09,Robert Antokol,Playtika Holding,0,8,1,9,
2025-09-09,Joe Craft,Alliance Resource Partners,8,8,2,18,
2025-09-09,Paul Keel,Envista,1,7,1,9,
2025-09-09,Jared Isaacman,Shift4 Payments,5,30,5,40,
2025-09-09,Mark Mac McFarland,Talen Energy,3,1,1,5,
2025-09-09,Tony R Thene,Carpenter Technology,1,8,0,9,
2025-09-09,Melissa D Smith,WEX,1,6,1,8,
2025-09-09,James Jim C Ryan III,Old National Bancorp,1,0,0,1,
2025-09-09,Peter J Federico,AGNC Investment,1,0,0,1,
2025-09-09,Brent L Yeagy,Wabash National,0,1,0,1,
2025-09-09,Henry A Fernandez,MSCI,2,16,0,18,
2025-09-09,Mark Penn,Stagwell,14,22,3,39,
2025-09-09,Julie Schertell,Mativ,3,9,0,12,
2025-09-09,Ashish Chand,Belden,2,6,1,9,
2025-09-09,Greg Anderson,Allegiant Travel Company,5,8,0,13,
2025-09-09,Drew Houston,Dropbox,15,18,7,40,
2025-09-09,Kevin T Conroy,Exact Sciences,2,5,2,9,
2025-09-09,Rex D Geveden,BWX Technologies,3,7,0,10,
2025-09-09,Scott R Wells,Clear Channel Outdoor Hldgs,0,0,0,0,
2025-09-09,Paul Bay,Ingram Micro,10,25,5,40,
2025-09-10,Doug McMillon,Walmart,17,17,6,40,
2025-09-10,Andrew Jassy,Amazon,3,32,5,40,
2025-09-10,Tim Cook,Apple,10,28,2,40,
2025-09-10,Stephen Hemsley,UnitedHealth,7,28,5,40,
2025-09-10,Warren Buffett,Berkshire Hathaway,12,17,10,39,
2025-09-10,David Joyner,CVS Health,7,28,5,40,
2025-09-10,Darren Woods,Exxon Mobil,10,23,6,39,
2025-09-10,Sundar Pichai,Alphabet,17,17,6,40,
2025-09-10,Brian Tyler,McKesson,5,15,6,26,
2025-09-10,Robert Mauch,Cencora,3,7,0,10,
2025-09-10,Ron Vachris,Costco,7,31,2,40,
2025-09-10,Jamie Dimon,JPMorgan Chase,8,19,13,40,
2025-09-10,Satya Nadella,Microsoft,16,22,2,40,
2025-09-10,Jason Hollar,Cardinal Health,13,22,5,40,
2025-09-10,Mike Wirth,Chevron,15,16,9,40,
2025-09-10,David Cordani,Cigna,21,15,4,40,
2025-09-10,Jim Farley,Ford Motor,17,17,6,40,
2025-09-10,Brian Moynihan,Bank of America,6,29,5,40,
2025-09-10,Mary Barra,General Motors,14,21,5,40,
2025-09-10,Gail Boudreaux,Elevance Health,16,17,7,40,
2025-09-10,Jane Fraser,Citigroup,12,24,4,40,
2025-09-10,Sarah London,Centene,13,18,9,40,
2025-09-10,Ted Decker,Home Depot,12,24,4,40,
2025-09-10,Maryann Mannen,Marathon Petroleum,7,14,1,22,
2025-09-10,Ron Sargent,Kroger,5,21,14,40,
2025-09-10,Mark Lashier,Phillips 66,11,21,7,39,
2025-09-10,Priscilla Almodovar,Fannie Mae,10,15,15,40,
2025-09-10,Tim Wentworth,Walgreens,8,23,9,40,
2025-09-10,Lane Riggs,Valero Energy,14,8,0,22,
2025-09-10,Mark Zuckerberg,Meta,5,21,14,40,
2025-09-10,Hans Vestberg,Verizon,15,21,4,40,
2025-09-10,John Stankey,AT&T,12,23,5,40,
2025-09-10,Brian Roberts,Comcast,10,28,2,40,
2025-09-10,Charles Scharf,Wells Fargo,27,6,7,40,
2025-09-10,David Solomon,Goldman Sachs,9,23,7,39,
2025-09-10,Michael Hutchins,Freddie Mac,1,10,4,15,
2025-09-10,Michael Fiddelke,Target,10,23,7,40,
2025-09-10,Jim Rechtin,Humana,20,15,5,40,
2025-09-10,Jon Farney,State Farm Insurance,1,15,3,19,
2025-09-10,Elon Musk,Tesla,11,25,4,40,
2025-09-10,Ted Pick,Morgan Stanley,17,19,4,40,
2025-09-10,Joaquin Duato,Johnson & Johnson,9,26,5,40,
2025-09-10,Juan Luciano,Archer Daniels Midland,4,20,16,40,
2025-09-10,Ramon Laguarta,PepsiCo,7,29,4,40,
2025-09-10,Carol Tom√©,UPS,4,24,12,40,
2025-09-10,Rajesh Subramaniam,FedEx,11,25,0,36,
2025-09-10,Bob Iger,Walt Disney,9,29,2,40,
2025-09-10,Michael Dell,Dell Technologies,10,24,6,40,
2025-09-10,Marvin Ellison,Lowes,16,23,1,40,
2025-09-10,Jon Moeller,Procter & Gamble,4,28,8,40,
2025-09-10,Thomas Long,Energy Transfer,8,0,1,9,
2025-09-10,Kelly Ortberg,Boeing,8,26,6,40,
2025-09-10,Susan Morris,Albertsons,14,22,4,40,
2025-09-10,Kevin Hourican,Sysco,8,28,4,40,
2025-09-10,Christopher Calio,RTX,6,12,0,18,
2025-09-10,Larry Culp,General Electric,10,27,3,40,
2025-09-10,James Taiclet,Lockheed Martin,13,20,7,40,
2025-09-10,Stephen Squeri,American Express,14,25,1,40,
2025-09-10,Joe Creed,Caterpillar,11,28,1,40,
2025-09-10,Michel Khalaf,MetLife,10,17,1,28,
2025-09-10,Samuel Hazen,HCA Healthcare,8,6,0,14,
2025-09-10,Tricia Griffith,Progressive Insurance,9,26,5,40,
2025-09-10,Arvind Krishna,IBM,12,22,6,40,
2025-09-10,John May,Deere,8,24,8,40,
2025-09-10,Jensen Huang,Nvidia,13,23,4,40,
2025-09-10,Philip Smith,StoneX,0,10,0,10,
2025-09-10,Robert M Davis,Merck,5,19,0,24,
2025-09-10,Ryan Lance,ConocoPhillips,15,21,4,40,
2025-09-10,Albert Bourla,Pfizer,26,10,4,40,
2025-09-10,Ed Bastian,Delta Air Lines,13,18,9,40,
2025-09-10,Patrick Zammit,TD Synnex,8,13,0,21,
2025-09-10,Kevin Murphy,Publix Super Markets,11,21,1,33,
2025-09-10,Thomas J Wilson,Allstate,1,7,1,9,
2025-09-10,Chuck Robbins,Cisco Systems,13,24,3,40,
2025-09-10,Kirt Walker,Nationwide Insurance,4,6,0,10,
2025-09-10,Christopher Winfrey,Charter Communications,4,14,5,23,
2025-09-10,Bob Michael,AbbVie,0,0,0,0,
2025-09-10,Craig DeSanto,New York Life Insurance,3,20,0,23,
2025-09-10,Lip-Bu Tan,Intel,6,27,7,40,
2025-09-10,Ernie Herrman,TJX,16,22,2,40,
2025-09-10,Andrew Sullivan,Prudential Financial,11,21,0,32,
2025-09-10,Enrique Lores,Hewlett Packard,11,19,4,34,
2025-09-10,Scott Kirby,United Airlines,33,4,3,40,
2025-09-10,George Holm,Performance Food,8,22,2,32,
2025-09-10,Donnie King,Tyson Foods,9,26,5,40,
2025-09-10,Robert Isom,American Airlines,6,26,8,40,
2025-09-10,Timothy M Sweeney,Liberty Mutual Insurance,12,0,0,12,
2025-09-10,Elliott Hill,Nike,13,24,3,40,
2025-09-10,Safra Catz,Oracle,12,21,7,40,
2025-09-10,AJ Jim Teague,Enterprise Products Partners,7,14,0,21,
2025-09-10,Richard Fairbank,Capital One,16,21,3,40,
2025-09-10,Willie Chiang,Plains GP,3,6,1,10,
2025-09-10,Michael Kasbar,World Kinect,2,10,0,12,
2025-09-10,Peter Zaffino,American International Group,10,26,4,40,
2025-09-10,James Quincey,The Coca-Cola Company,10,28,2,40,
2025-09-10,Thasunda Brown Duckett,TIAA,22,18,0,40,
2025-09-10,Jay Debertin,CHS,6,11,4,21,
2025-09-10,Chris Boerner,Bristol-Myers Squibb,11,22,7,40,
2025-09-10,Corie Barry,Best Buy,39,1,0,40,
2025-09-10,Marc Casper,Thermo Fisher Scientific,14,22,4,40,
2025-09-10,Roger Crandall,Mass Mutual,2,8,0,10,
2025-09-10,Juan Andrade,USAA,5,18,0,23,
2025-09-10,Phebe Novakovic,General Dynamics,29,8,3,40,
2025-09-10,Alan Schnitzer,Travelers Insurance,3,5,2,10,
2025-09-10,David Zaslav,Warner Bros Discovery,3,25,12,40,
2025-09-10,Gunjan Kedia,US Bancorp,15,23,2,40,
2025-09-10,Robert Ford,Abbott Laboratories,13,22,5,40,
2025-09-10,Kathy Warden,Northrop Grumman,16,19,5,40,
2025-09-10,Tim Gerend,Northwestern Mutual,13,26,1,40,
2025-09-10,Todd Vasos,Dollar General,7,27,6,40,
2025-09-10,Matthew Lucey,PBF Energy,7,2,0,9,
2025-09-10,Dara Khosrowshahi,Uber,13,22,5,40,
2025-09-10,Vimal Kapur,Honeywell,11,29,0,40,
2025-09-10,Dirk Van de Put,Mondelez,11,26,3,40,
2025-09-10,Brian Niccol,Starbucks,11,23,6,40,
2025-09-10,Cristiano Amon,Qualcomm,12,26,2,40,
2025-09-10,Hock Tan,Broadcom,17,21,2,40,
2025-09-10,David Flitman,US Foods,3,7,0,10,
2025-09-10,Paul Romanowski,DR Horton,4,15,5,24,
2025-09-10,Jacek Olczak,Philip Morris,13,24,3,40,
2025-09-10,Preston Feight,Paccar,8,28,1,37,
2025-09-10,Marc Benioff,Salesforce,8,20,12,40,
2025-09-10,Leon Topalian,Nucor,14,24,2,40,
2025-09-10,Michael Dastoor,Jabil,1,7,0,8,
2025-09-10,Jonathan Jaffe,Lennar,0,7,2,9,
2025-09-10,David Ricks,Eli Lilly,11,19,10,40,
2025-09-10,Joe Zubretsky,Molina Healthcare,7,5,4,16,
2025-09-10,Jennifer Rumsey,Cummins,7,27,6,40,
2025-09-10,Robin Vince,Bank of New York Mellon,20,19,1,40,
2025-09-10,Ted Sarandos,Netflix,13,24,3,40,
2025-09-10,William H Rogers Jr,Truist Financial,3,7,0,10,
2025-09-10,Sean Kerins,Arrow Electronics,2,11,0,13,
2025-09-10,William M Brown,3M,2,8,0,10,
2025-09-10,Ryan McInerney,Visa,12,23,5,40,
2025-09-10,Marc Rowan,Apollo Global Management,15,19,6,40,
2025-09-10,Tim Go,HF Sinclair,6,3,0,9,
2025-09-10,Robert Sulentic,CBRE Group,1,7,1,9,
2025-09-10,William Demchak,PNC Financial Services,15,20,5,40,
2025-09-10,Bryan DeBoer,Lithia Motors,2,34,4,40,
2025-09-10,William Nash,CarMax,4,4,2,10,
2025-09-10,Brian Robbins,Paramount Global,8,31,1,40,
2025-09-10,Michael Creedon,Dollar Tree,4,33,3,40,
2025-09-10,Sandy Douglas,United Natural Foods,34,5,1,40,
2025-09-10,Alex Chriss,PayPal,13,24,3,40,
2025-09-10,Roger Penske,Penske Automotive,18,21,1,40,
2025-09-10,Antonio Neri,Hewlett Packard Enterprise,10,22,8,40,
2025-09-10,Harry Sideris,Duke Energy,35,5,0,40,
2025-09-10,Vicki Hollub,Occidental Petroleum,20,16,4,40,
2025-09-10,Lawrence Coben,NRG Energy,5,3,0,8,
2025-09-10,Robert Bradway,Amgen,11,27,2,40,
2025-09-10,John Ketchum,NextEra Energy,23,17,0,40,
2025-09-10,Rainer Blair,Danaher,6,16,2,24,
2025-09-10,Daniel ODay,Gilead Sciences,1,8,1,10,
2025-09-10,Michael Manley,AutoNation,3,6,1,10,
2025-09-10,Carlos Abrams-Rivera,Kraft Heinz,4,32,4,40,
2025-09-10,Philip Gallagher,Avnet,0,5,0,5,
2025-09-10,Gary Dickerson,Applied Materials,7,19,14,40,
2025-09-10,Bob Jordan,Southwest Airlines,10,23,7,40,
2025-09-10,Rick Wurster,Charles Schwab,14,22,3,39,
2025-09-10,Lorenzo Simonelli,Baker Hughes,17,20,3,40,
2025-09-10,Chris Kempczinski,McDonalds,9,24,7,40,
2025-09-10,Christopher Womack,Southern Company,2,7,0,9,
2025-09-10,Michael Miebach,Mastercard,12,25,3,40,
2025-09-10,Joseph Dominguez,Constellation Energy,14,10,1,25,
2025-09-10,Christopher Swift,The Hartford,15,21,4,40,
2025-09-10,Patricia Poppe,PG&E,8,16,2,26,
2025-09-10,Bom Kim,Coupang,13,26,1,40,
2025-09-10,Ezra Yacob,EOG Resources,24,14,2,40,
2025-09-10,Jim Vena,Union Pacific,20,20,0,40,
2025-09-10,Matt Schroeder,Rite Aid,4,33,3,40,
2025-09-10,Tony Spring,Macys,8,26,6,40,
2025-09-10,Anthony Capuano,Marriott International,13,24,3,40,
2025-09-10,Raymond E Scott,Lear Corporation,4,6,0,10,
2025-09-10,William Stengel II,Genuine Parts,0,4,0,4,
2025-09-10,Heidi Petz,Sherwin-Williams,10,28,2,40,
2025-09-10,Jeff Miller,Halliburton,13,21,6,40,
2025-09-10,Kathleen Quirk,Freeport-McMoRan,14,17,2,33,
2025-09-10,Michael Rapino,Live Nation Entertainment,14,22,4,40,
2025-09-10,John Doyle,Marsh & McLennan,10,7,0,17,
2025-09-10,Lisa Su,Advanced Micro Devices,14,22,4,40,
2025-09-10,Frank Holding,First Citizens BancShares,9,15,2,26,
2025-09-10,John Engel,WESCO International,4,14,1,19,
2025-09-10,David Gitlin,Carrier Global,15,22,3,40,
2025-09-10,Lourenco Goncalves,Cleveland-Cliffs,5,19,16,40,
2025-09-10,Calvin G Butler Jr,Exelon,6,4,0,10,
2025-09-10,Joseph Bae,KKR & Co,7,7,1,15,
2025-09-10,Christine Leahy,CDW,0,7,2,9,
2025-09-10,Glenn Fogel,Booking Holdings,12,22,6,40,
2025-09-10,Brian Doubles,Synchrony Financial,5,6,1,12,
2025-09-10,Earl Austin,Quanta Services,2,5,2,9,
2025-09-10,Christian Ulbrich,Jones Lang LaSalle,7,15,0,22,
2025-09-10,Saumya Sutaria,Tenet Healthcare,6,2,1,9,
2025-09-10,William Gifford,Altria Group,3,6,1,10,
2025-09-10,Kevin Lobo,Stryker,13,24,3,40,
2025-09-10,Michael Hsu,Kimberly-Clark,6,7,0,13,
2025-09-10,Jack Fusco,Cheniere Energy,17,19,4,40,
2025-09-10,James Conroy,Ross Stores,4,11,0,15,
2025-09-10,Anthony Smurfit,Smurfit Westrock,4,6,0,10,
2025-09-10,Jeffrey Harmening,General Mills,3,17,5,25,
2025-09-10,Mark Stewart,Goodyear Tire & Rubber,3,36,1,40,
2025-09-10,Bob Eddy,BJs Wholesale Club,3,20,3,26,
2025-09-10,Peter Arduini,GE HealthCare Technologies,4,11,0,15,
2025-09-10,Noel Wallace,Colgate-Palmolive,9,23,2,34,
2025-09-10,Marc Bitzer,Whirlpool,10,16,14,40,
2025-09-10,Chris Kubasik,L3Harris Technologies,7,13,1,21,
2025-09-10,Shantanu Narayen,Adobe,19,19,1,39,
2025-09-10,Thomas Polen,Becton Dickinson,6,4,0,10,
2025-09-10,Richard P Dealy,Pioneer Natural Resources,7,3,0,10,
2025-09-10,Ravi Kumar S,Cognizant Technology Solutions,10,21,4,35,
2025-09-10,Andrew Clyde,Murphy USA,12,27,1,40,
2025-09-10,Mike Lyons,Fiserv,4,12,0,16,
2025-09-10,Jennifer Parmentier,Parker-Hannifin,2,12,0,14,
2025-09-10,William Fehrman,American Electric Power,3,7,0,10,
2025-09-10,Andrew Silvernail,International Paper,5,22,0,27,
2025-09-10,Jonas Prising,ManpowerGroup,7,23,2,32,
2025-09-10,John Zillmer,Aramark,7,12,2,21,
2025-09-10,Mark Millett,Steel Dynamics,18,2,0,20,
2025-09-10,Dan Amos,Aflac,14,18,8,40,
2025-09-10,Tony Cheng,Reinsurance Group of America,3,9,2,14,
2025-09-10,Karsanbhai,Emerson Electric,8,14,2,24,
2025-09-10,Ronald P OHanley,State Street,0,4,0,4,
2025-09-10,Timothy Knavish,PPG Industries,0,1,0,1,
2025-09-10,David Burritt,United States Steel,9,21,10,40,
2025-09-10,Maria Black,Automatic Data Processing,5,3,0,8,
2025-09-10,Daryl Kenningham,Group 1 Automotive,8,30,2,40,
2025-09-10,Robert Blue,Dominion Energy,27,11,1,39,
2025-09-10,Larry Fink,BlackRock,9,24,7,40,
2025-09-10,Pierce Norton II,Oneok,5,3,1,9,
2025-09-10,David Bozeman,CH Robinson Worldwide,2,8,0,10,
2025-09-10,Haviv Ilan,Texas Instruments,13,24,3,40,
2025-09-10,Michael Bender,Kohls,2,25,13,40,
2025-09-10,Philip Daniele III,AutoZone,0,2,0,2,
2025-09-10,Timothy Archer,Lam Research,4,6,0,10,
2025-09-10,Charles Magro,Corteva,5,3,1,9,
2025-09-10,Rick Lanoha,Peter Kiewit Sons,0,1,0,1,
2025-09-10,Peter Jackson,Builders FirstSource,5,11,1,17,
2025-09-10,Martin Schroeter,Kyndryl,10,29,0,39,
2025-09-10,Hamid Akhavan,EchoStar,5,24,11,40,
2025-09-10,Bill Westrate,American Family Insurance,10,18,2,30,
2025-09-10,Avigal Soreq,Delek US,4,8,5,17,
2025-09-10,Beth Ford,Land OLakes,5,6,1,12,
2025-09-10,Walker Martin,Sempra,0,2,0,2,
2025-09-10,Eric Slifka,Global Partners,14,20,6,40,
2025-09-10,DG Macpherson,WW Grainger,2,6,1,9,
2025-09-10,Bob Pragada,Jacobs Solutions,5,10,0,15,
2025-09-10,Pedro Pizarro,Edison International,17,9,14,40,
2025-09-10,William Hornbuckle,MGM Resorts International,9,24,1,34,
2025-09-10,Andrew McMahon,Guardian Life insurance,6,11,0,17,
2025-09-10,Christopher OHerlihy,Illinois Tool Works,0,1,0,1,
2025-09-10,James Cracchiolo,Ameriprise Financial,2,23,2,27,
2025-09-10,Ryan Marshall,PulteGroup,9,15,11,35,
2025-09-10,Matthew Meloy,Targa Resources,6,4,0,10,
2025-09-10,Michael Rhodes,Ally Financial,8,28,4,40,
2025-09-10,Joseph Fadool,BorgWarner,4,9,0,13,
2025-09-10,St√©phane de La Faverie,Est√©e Lauder,12,24,4,40,
2025-09-10,Benjamin Tisch,Loews,2,7,0,9,
2025-09-10,Brad Beckham,OReilly Automotive,2,8,0,10,
2025-09-10,Thomas Gayner,Markel Group,1,9,0,10,
2025-09-10,Donald Allan,Stanley Black & Decker,8,31,1,40,
2025-09-10,Sanjay Mehrotra,Micron Technology,15,23,2,40,
2025-09-10,James Breuer,Fluor,1,1,1,3,
2025-09-10,Thomas Bell,Leidos,9,19,2,30,
2025-09-10,Scott Smith,Viatris,6,4,0,10,
2025-09-10,Kimberly Dang,Kinder Morgan,11,1,0,12,
2025-09-10,Christophe Beck,Ecolab,18,22,0,40,
2025-09-10,Brent Shafer,Baxter International,1,10,0,11,
2025-09-10,Clay Gaspar,Devon Energy,22,3,0,25,
2025-09-10,Steven Cahillane,Kellanova,1,7,0,8,
2025-09-10,Raul Nicholas Vargas Ochoa,Farmers Insurance Exchange,0,0,0,0,
2025-09-10,Darren Rebelez,Caseys General Stores,4,6,0,10,
2025-09-10,Ari Bousbib,IQVIA,6,15,1,22,
2025-09-10,Jon Vander Ark,Republic Services,13,18,9,40,
2025-09-10,Timothy Cofer,Keurig Dr Pepper,2,7,1,10,
2025-09-10,Karla Lewis,Reliance Inc,5,4,0,9,
2025-09-10,David Hult,Asbury Automotive Group,9,30,1,40,
2025-09-10,Darryl Button,Pacific Life,1,8,0,9,
2025-09-10,James Burke,Vistra,7,3,0,10,
2025-09-10,John Barrett,Western & Southern Financial,9,29,2,40,
2025-09-10,William Krueger,The Andersons Inc,0,2,0,2,
2025-09-10,Erik Nordstrom,Nordstrom,5,30,5,40,
2025-09-10,John Wren,Omnicom Group,13,21,6,40,
2025-09-10,Stephanie Ferris,Fidelity National Information Services,14,24,2,40,
2025-09-10,Timothy Cawley,Consolidated Edison,5,4,0,9,
2025-09-10,Joseph Hinrichs,CSX,6,10,1,17,
2025-09-10,Troy Rudd,AECOM,9,24,4,37,
2025-09-10,Kathleen Johnson,Lumen Technologies,4,4,1,9,
2025-09-10,Harry Lawton III,Tractor Supply,1,0,0,1,
2025-09-10,Raul Fernandez,DXC Technology,5,29,1,35,
2025-09-10,Eric Hansotia,AGCO,13,17,1,31,
2025-09-10,David Bruton Smith,Sonic Automotive,3,8,9,20,
2025-09-10,Sasan Goodarzi,Intuit,10,26,4,40,
2025-09-10,Matthew Flannery,United Rentals,32,2,0,34,
2025-09-10,Marc Miller,Universal Health Services,4,20,3,27,
2025-09-10,Michael Mahoney,Boston Scientific,12,28,0,40,
2025-09-10,Judith Marks,Otis Worldwide,3,3,0,6,
2025-09-10,Robert Frenzel,Xcel Energy,4,2,1,7,
2025-09-10,Penny Pennington,Edward Jones,8,26,6,40,
2025-09-10,Daniel Fisher,Ball,3,23,6,32,
2025-09-10,Justin Jude,LKQ,4,6,1,11,
2025-09-10,James Blackledge,Mutual of Omaha,1,32,1,34,
2025-09-10,Bruce Bodine,Mosaic,2,7,0,9,
2025-09-10,Scott Donnelly,Textron,6,20,2,28,
2025-09-10,Adam Schechter,Labcorp Holdings,2,6,1,9,
2025-09-10,Deanna Strable-Soethout,Principal Financial,1,6,0,7,
2025-09-10,Leonard Schleifer,Regeneron Pharmaceuticals,6,27,7,40,
2025-09-10,Paul Shoukry,Raymond James Financial,14,25,1,40,
2025-09-10,Lauren Hobart,Dicks Sporting Goods,12,25,3,40,
2025-09-10,Jamie Whisnant,Auto-Owners Insurance,0,2,0,2,
2025-09-10,Ariane Gorin,Expedia,10,28,2,40,
2025-09-10,Shelley Simpson,JB Hunt Transport Services,10,27,3,40,
2025-09-10,Ren√© Jones,M&T Bank,12,23,5,40,
2025-09-10,Gerardo Norcia,DTE Energy,7,2,0,9,
2025-09-10,Andr√©s Gluski,AES,16,21,0,37,
2025-09-10,Timothy Spence,Fifth Third Bancorp,6,3,1,10,
2025-09-10,Eduardo Menezes,Air Products & Chemicals,3,6,1,10,
2025-09-10,Wendell Weeks,Corning,15,23,2,40,
2025-09-10,Anthony Guzzi,EMCOR Group,3,3,1,7,
2025-09-10,Adam Norwitt,Amphenol,3,16,0,19,
2025-09-10,Jean-Marc Gilson,Westlake Corporation,2,5,0,7,
2025-09-10,Lori Koch,DuPont,7,18,0,25,
2025-09-10,Derek Chang,Liberty Media,36,3,1,40,
2025-09-10,Martina Cheung,S&P Global,10,26,0,36,
2025-09-10,Tim Hingtgen,Community Health Systems,11,27,2,40,
2025-09-10,Brian Tierney,FirstEnergy,6,21,3,30,
2025-09-10,Rick McKenney,Unum Group,5,4,0,9,
2025-09-10,Stanley Bergman,Henry Schein,12,27,1,40,
2025-09-10,Tiang Yew Tan,Western Digital,0,3,0,3,
2025-09-10,Vincent Roche,Analog Devices,12,23,4,39,
2025-09-10,Sean Connolly,Conagra Brands,8,30,2,40,
2025-09-10,Bruce Van Saun,Citizens Financial Group,14,25,1,40,
2025-09-10,Mark George,Norfolk Southern,17,19,4,40,
2025-09-10,Andrew Marsh,Entergy,3,4,0,7,
2025-09-10,Robert Berkley,WR Berkley,9,26,5,40,
2025-09-10,Javier Rodriguez,DaVita,15,12,1,28,
2025-09-10,Michael OGrady,Northern Trust,3,3,0,6,
2025-09-10,James Snee,Hormel Foods,2,27,1,30,
2025-09-10,Timothy J Donahue,Crown Holdings,3,10,0,13,
2025-09-10,Joseph Ferraro,Avis Budget,3,6,1,10,
2025-09-10,Niraj Shah,Wayfair,6,27,7,40,
2025-09-10,Jos√© Mas,MasTec,7,14,0,21,
2025-09-10,Joseph Nolan,Eversource Energy,5,4,1,10,
2025-09-10,Thomas Palmer,Newmont,5,4,0,9,
2025-09-10,Robert Sanchez,Ryder System,9,9,1,19,
2025-09-10,Michael Nolan,Fidelity National Financial,4,0,0,4,
2025-09-10,Gavin Hattersley,Molson Coors Beverage,4,30,6,40,
2025-09-10,Thomas Reeg,Caesars Entertainment,5,6,0,11,
2025-09-10,Ellen Cooper,Lincoln National,2,7,0,9,
2025-09-10,Bracken Darrell,VF Corporation,8,29,3,40,
2025-09-10,Erik Fyrwald,International Flavors & Fragrances,6,9,4,19,
2025-09-10,Christopher Kastner,Huntington Ingalls Industries,3,5,0,8,
2025-09-10,Shane OKelly,Advance Auto Parts,0,6,0,6,
2025-09-10,Ralph LaRossa,Public Service Enterprise Group,12,17,0,29,
2025-09-10,Kecia Steelman,Ulta Beauty,34,5,1,40,
2025-09-10,Michele Buck,Hershey,6,32,2,40,
2025-09-10,Sumit Singh,Chewy,12,24,4,40,
2025-09-10,Steven Vondran,American Tower,4,6,0,10,
2025-09-10,Jeffrey Lorberbaum,Mohawk Industries,10,6,1,17,
2025-09-10,Keith Demmings,Assurant,5,6,0,11,
2025-09-10,Robert Martin,Thor Industries,3,6,1,10,
2025-09-10,Kathleen Mazzarella,Graybar Electric,1,6,1,8,
2025-09-10,Joey Wat,Yum China,13,25,2,40,
2025-09-10,Scott Richardson,Celanese,8,22,4,34,
2025-09-10,David Rawlinson II,QVC,8,15,2,25,
2025-09-10,Alan Armstrong,Williams,24,12,4,40,
2025-09-10,Philippe Krakowsky,Interpublic Group,13,24,3,40,
2025-09-10,Brendan McCracken,Ovintiv,6,5,0,11,
2025-09-10,Andrew Teno,Icahn Enterprises,5,5,0,10,
2025-09-10,Stephen Steinour,Huntington Bancshares,2,7,0,9,
2025-09-10,Timothy NeCastro,Erie Insurance,3,6,1,10,
2025-09-10,Ernest Garcia III,Carvana,25,11,4,40,
2025-09-10,R Bruce McDonald,Dana Incorporated,3,7,1,11,
2025-09-10,William Oplinger,Alcoa Corporation,1,9,0,10,
2025-09-10,Mark Pearson,Equitable,8,8,0,16,
2025-09-10,Richard Wallace,KLA,3,2,0,5,
2025-09-10,Ricardo Cardenas,Darden Restaurants,4,3,1,8,
2025-09-10,Mikael Bratt,Autoliv,5,8,2,15,
2025-09-10,Benito Minicucci,Alaska Air,1,3,1,5,
2025-09-10,Christopher Gorman,KeyCorp,5,5,0,10,
2025-09-10,Robert Goldstein,Las Vegas Sands,4,31,5,40,
2025-09-10,Edward Pesicka,Owens & Minor,3,31,2,36,
2025-09-10,Christopher Nassetta,Hilton Worldwide,8,15,2,25,
2025-09-10,Jamie Iannone,Ebay,13,23,3,39,
2025-09-10,Patrick Gallagher,Arthur J Gallagher,8,30,2,40,
2025-09-10,Rich Steinmeier,LPL Financial,23,15,2,40,
2025-09-10,Stephen Spray,Cincinnati Financial,1,7,1,9,
2025-09-10,Douglas Yearley,Toll Brothers,11,24,5,40,
2025-09-10,Gregory Brown,Motorola Solutions,1,8,1,10,
2025-09-10,Brian Chesky,Airbnb,2,30,8,40,
2025-09-10,Jeffrey Sprecher,Intercontinental Exchange,14,22,4,40,
2025-09-10,Robert Thomson,News Corp,5,33,2,40,
2025-09-10,Scott Boatwright,Chipotle Mexican Grill,8,27,5,40,
2025-09-10,Reshma Kewalramani,Vertex Pharmaceuticals,21,14,5,40,
2025-09-10,Christopher Viehbacher,Biogen,0,25,2,27,
2025-09-10,Malcolm Wilson,GXO Logistics,6,21,0,27,
2025-09-10,Tony Sarsam,SpartanNash,17,21,2,40,
2025-09-10,Michael O‚ÄôSullivan,Burlington Stores,9,27,4,40,
2025-09-10,Teresa Rasmussen,Thrivent Financial for Lutherans,3,2,0,5,
2025-09-10,Eugene Bredow,NVR,0,4,1,5,
2025-09-10,Brian Chambers,Owens Corning,3,11,0,14,
2025-09-10,Rafael Santana,Westinghouse Air Brake Technologies,3,7,1,11,
2025-09-10,John Pfeifer,Oshkosh Corporation,3,18,0,21,
2025-09-10,Cameron Bready,Global Payments,8,29,3,40,
2025-09-10,Calvin McDonald,Lululemon athletica,8,31,1,40,
2025-09-10,J Kent Masters,Albemarle Corporation,4,5,0,9,
2025-09-10,Joanna Geraghty,JetBlue Airways,14,19,7,40,
2025-09-10,Robert Steer,Seaboard,1,4,0,5,
2025-09-10,William Newlands,Constellation Brands,0,2,2,4,
2025-09-10,Michael Doss,Graphic Packaging,4,9,1,14,
2025-09-10,Gil West,Hertz,7,25,8,40,
2025-09-10,Malcolm C Roberts,FM Global,2,10,2,14,
2025-09-10,Mick Beekhuizen,Campbell Soup,8,22,0,30,
2025-09-10,Daniel Wall,Expeditors International of Washington,2,4,0,6,
2025-09-10,Gregory Roberts,A-Mark Precious Metals,1,4,1,6,
2025-09-10,Horacio Rozanski,Booz Allen Hamilton,17,18,5,40,
2025-09-10,James Davis,Quest Diagnostics,5,4,1,10,
2025-09-10,Dennis Mathew,Altice,4,27,8,39,
2025-09-10,Stefan Larsson,PVH,11,24,5,40,
2025-09-10,Mark Costa,Eastman Chemical,5,14,4,23,
2025-09-10,Joyce Mullen,Insight Enterprises,6,11,0,17,
2025-09-10,John Turner,Regions Financial,20,17,3,40,
2025-09-10,Julian G Francis,Beacon Roofing Supply,0,1,0,1,
2025-09-10,Blake Moret,Rockwell Automation,11,27,2,40,
2025-09-10,Mike Speetzen,Polaris Inc,3,18,2,23,
2025-09-10,William McDermott,ServiceNow,3,5,0,8,
2025-09-10,Jure Sola,Sanmina,3,12,0,15,
2025-09-10,Bob Flexon,UGI Utilities Inc,0,1,0,1,
2025-09-10,Scott Lauber,WEC Energy,15,6,0,21,
2025-09-10,Jon Rousseau,BrightSpring Health Services,20,19,1,40,
2025-09-10,Todd Schneider,Cintas,12,18,1,31,
2025-09-10,Peter Matt,Commercial Metals,5,4,0,9,
2025-09-10,Robert D Lawler,Continental Resources,0,0,0,0,
2025-09-10,Domenic Dell‚ÄôOsso Jr,Expand Energy,4,0,0,4,
2025-09-10,Jason P Wells,CenterPoint Energy,9,4,1,14,
2025-09-10,H Michael Krimbill,NGL Energy Partners,7,2,0,9,
2025-09-10,Tony Xu,DoorDash,16,17,7,40,
2025-09-10,Clay Williams,NOV,7,21,4,32,
2025-09-10,Kristin Peck,Zoetis,12,19,1,32,
2025-09-10,Mark Smucker,JM Smucker,13,21,6,40,
2025-09-10,Steve Sanghi,Microchip Technology,8,28,4,40,
2025-09-10,Richard Tobin,Dover Corporation,3,3,0,6,
2025-09-10,Kaes Van‚Äôt Hof,Diamondback Energy,20,16,3,39,
2025-09-10,Deon Stander,Avery Dennison,0,13,0,13,
2025-09-10,Vincent Sorgi,PPL,9,9,1,19,
2025-09-10,Hassane El-Khoury,ON Semiconductor,3,19,5,27,
2025-09-10,Arie Kotler,ARKO,5,22,1,28,
2025-09-10,William Monteleone,Par Pacific,1,7,2,10,
2025-09-10,John Christmann IV,APA,5,5,0,10,
2025-09-10,Adaire Fox-Martin,Equinix,15,22,3,40,
2025-09-10,Joseph M Otting,Flagstar Financial,3,5,2,10,
2025-09-10,Mary Dillon,Foot Locker,11,25,4,40,
2025-09-10,James Zallie,Ingredion,3,7,0,10,
2025-09-10,Christopher Peterson,Newell Brands,1,8,1,10,
2025-09-10,Scott Salmirs,ABM Industries,6,5,1,12,
2025-09-10,Christopher Hilger,Securian Financial,0,6,0,6,
2025-09-10,Hamid Moghadam,Prologis,8,27,5,40,
2025-09-10,Stephen Schwarzman,Blackstone,13,20,6,39,
2025-09-10,Robert Greenberg,Skechers USA,5,23,3,31,
2025-09-10,Keith Allman,Masco,4,9,1,14,
2025-09-10,Rusty Rush,Rush Enterprises,15,22,3,40,
2025-09-10,Jennifer Johnson,Franklin Resources,1,7,2,10,
2025-09-10,Gerry P Smith,ODP Business Solutions,0,1,0,1,
2025-09-10,Carl Lindner lll,American Financial,0,0,0,0,
2025-09-10,Mark Kowlzan,Packaging Corp of America,0,9,1,10,
2025-09-10,Thomas Hill,Vulcan Materials,4,6,2,12,
2025-09-10,Milan Galik,Interactive Brokers,7,18,2,27,
2025-09-10,Laura Alber,Williams-Sonoma,13,22,5,40,
2025-09-10,Mario Harik,XPO,8,31,1,40,
2025-09-10,Devin Stockfish,Weyerhaeuser,5,6,0,11,
2025-09-10,Thomas J McInerney,Genworth Financial,1,5,0,6,
2025-09-10,Garrick Rochow,CMS Energy,11,3,1,15,
2025-09-10,Toni Townes-Whitley,Science Applications International,12,21,1,34,
2025-09-10,Rich Handler,Jefferies Financial,12,9,2,23,
2025-09-10,Daniel Heaf,Bath & Body Works,12,26,2,40,
2025-09-10,Andrew Wilson,Electronic Arts,13,17,10,40,
2025-09-10,Sheryl Palmer,Taylor Morrison Home,8,10,1,19,
2025-09-10,Ivan Tornos,Zimmer Biomet,9,30,1,40,
2025-09-10,Linda Rendle,Clorox,2,35,2,39,
2025-09-10,Matthew Pine,Xylem Inc,1,9,1,11,
2025-09-10,Heather Lavallee,Voya Financial,7,11,2,20,
2025-09-10,Daniel Florness,Fastenal,3,4,2,9,
2025-09-10,Albert Nahmad,Watsco,2,7,0,9,
2025-09-10,Carl Eschenbach,Workday,11,20,9,40,
2025-09-10,Craig Smiddy,Old Republic International,3,5,1,9,
2025-09-10,Frank C Sullivan,RPM International,4,8,0,12,
2025-09-10,Matthew Missad,UFP Industries,7,3,0,10,
2025-09-10,Martin J Lyons,Ameren,2,4,1,7,
2025-09-10,Adam W Miller,Knight Swift Transportation,0,2,1,3,
2025-09-10,Rodney Sacks,Monster Beverage,12,26,1,39,
2025-09-10,Gary Guthart,Intuitive Surgical,13,24,3,40,
2025-09-10,Charles Liang,Super Micro Computer,35,4,1,40,
2025-09-10,Christopher Caldwell,Concentrix,3,5,0,8,
2025-09-10,Gordon J Hardie,O-I Glass,0,4,0,4,
2025-09-10,David Gibbs,Yum Brands,2,38,0,40,
2025-09-10,Steve Henry,Domtar,5,5,0,10,
2025-09-10,Chuck Treadway,CommScope,8,21,3,32,
2025-09-10,Rob Vitale,Post Holdings,1,13,5,19,
2025-09-10,Steven J Moskowitz,Crown Castle,2,5,3,10,
2025-09-10,Emmanuel Ligner,Avantor,2,11,1,14,
2025-09-10,Stuart Bradie,KBR,13,16,4,33,
2025-09-10,Carrie Wheeler,Opendoor Technologies,11,25,4,40,
2025-09-10,Russell Becker,APi Group,3,5,0,8,
2025-09-10,Toby Rice,EQT,23,14,3,40,
2025-09-10,Jesse Arenivas,EnLink Midstream,8,8,0,16,
2025-09-10,Nikesh Arora,Palo Alto Networks,5,27,8,40,
2025-09-10,Steven Bandrowczak,Xerox,1,8,1,10,
2025-09-10,Vicente Reynal,Ingersoll Rand,7,28,0,35,
2025-09-10,William T Dillard II,Dillards,3,3,2,8,
2025-09-10,C Howard Nye,Martin Marietta Materials,1,5,4,10,
2025-09-10,Giordano Albertazzi,Vertiv,13,18,4,35,
2025-09-10,Stephane Bancel,Moderna,9,20,11,40,
2025-09-10,Nate R Jorgensen,Boise Cascade,0,0,0,0,
2025-09-10,Jack Sinclair,Sprouts Farmers Market,18,22,0,40,
2025-09-10,Padraig McDonnell,Agilent Technologies,9,12,0,21,
2025-09-10,Kenneth T Lane,Olin,0,1,0,1,
2025-09-10,Randall C Stuewe,Darling Ingredients,26,1,0,27,
2025-09-10,R Howard Coker,Sonoco Products,2,7,1,10,
2025-09-10,John Mengucci,CACI International,19,19,2,40,
2025-09-10,Mark Witkowski,Core & Main,2,12,2,16,
2025-09-10,Lee M Tillman,Marathon Oil,4,5,0,9,
2025-09-10,Mark Hoplamazian,Hyatt Hotels,14,21,5,40,
2025-09-10,David S Chernow,Select Medical,0,9,0,9,
2025-09-10,Brendan M Foley,McCormick & Company,0,8,0,8,
2025-09-10,Joanne Crevoiserat,Tapestry,13,23,4,40,
2025-09-10,John Plant,Howmet Aerospace,6,12,3,21,
2025-09-10,Shankh Mitra,Welltower,15,23,2,40,
2025-09-10,W Anthony Will,CF Industries,4,5,0,9,
2025-09-10,David A Zapico,Ametek,3,17,1,21,
2025-09-10,Kevin Stein,TransDigm,10,8,1,19,
2025-09-10,Craig Billings,Wynn Resorts,12,25,3,40,
2025-09-10,William J Way,Southwestern Energy,2,0,0,2,
2025-09-10,Giel Rutten,Amkor Technology,3,7,1,11,
2025-09-10,Paul Sarvadi,Insperity,4,4,0,8,
2025-09-10,Donald Zurbay,Patterson Companies Inc,1,3,0,4,
2025-09-10,Rob Sharps,T Rowe Price,12,23,5,40,
2025-09-10,Patrice Louvet,Ralph Lauren,14,17,9,40,
2025-09-10,Jeffrey Mezger,KB Home,2,31,7,40,
2025-09-10,David M Foulkes,Brunswick,1,8,0,9,
2025-09-10,M Keith Waddell,Robert Half,2,7,0,9,
2025-09-10,Jay Snowden,PENN Entertainment,18,19,3,40,
2025-09-10,George Kurian,NetApp,15,23,2,40,
2025-09-10,Kevin Ali,Organon,9,18,2,29,
2025-09-10,Joel D Anderson,Petco Health and Wellness,3,8,0,11,
2025-09-10,Louis V Pinkham,Regal Rexnord,0,1,0,1,
2025-09-10,Jay Geldmacher,Resideo Technologies,9,6,0,15,
2025-09-10,Marcus Lemonis,Camping World,10,21,9,40,
2025-09-10,Peter R Huntsman,Huntsman,7,11,3,21,
2025-09-10,Hillary Super,Victorias Secret,11,4,8,23,
2025-09-10,Michelle Gass,Levi Strauss,13,24,2,39,
2025-09-10,Neil Hunn,Roper Technologies,2,20,0,22,
2025-09-10,Steven P Lawrence,Academy Sports and Outdoors,1,1,0,2,
2025-09-10,Phillippe Lord,Meritage Homes,8,14,0,22,
2025-09-10,David C Dauch,American Axle & Manufacturing,4,7,2,13,
2025-09-10,Olumide Soroye,Fortive,1,9,0,10,
2025-09-10,Adena Friedman,Nasdaq,15,21,4,40,
2025-09-10,Tim Gokey,Broadridge Financial Solutions,5,12,1,18,
2025-09-10,Patrick M Shanahan,Spirit AeroSystems,2,8,0,10,
2025-09-10,Robert Kyncl,Warner Music Group,9,29,2,40,
2025-09-10,Denise Dignam,Chemours,2,19,2,23,
2025-09-10,Jim DeVries,ADT,10,7,1,18,
2025-09-10,Bernard Zovighian,Edwards Lifesciences,7,7,2,16,
2025-09-10,Mark E Seaton,First American Financial,1,9,0,10,
2025-09-10,John C Roche,Hanover Insurance Group,8,17,1,26,
2025-09-10,Adam J Greenlee,Silgan,0,6,0,6,
2025-09-10,Jayne Hrdlicka,Endeavor Group,0,1,0,1,
2025-09-10,Robert Fauber,Moodys Corporation,0,5,0,5,
2025-09-10,Thomas E Jorden,Coterra Energy,9,0,0,9,
2025-09-10,Eugene A Hall,Gartner,1,8,0,9,
2025-09-10,Kevin Plank,Under Armour,9,27,4,40,
2025-09-10,James W Lanning,Ingles Markets,3,3,0,6,
2025-09-10,Matthew T Farrell,Church & Dwight,7,7,0,14,
2025-09-10,Kevin M Freeman,Old Dominion Freight Line,0,0,0,0,
2025-09-10,Joe Shoen,U-Haul,15,20,4,39,
2025-09-10,Mark Bertolini,Oscar Health,13,18,9,40,
2025-09-10,Jayshree Ullal,Arista Networks,20,18,2,40,
2025-09-10,Sassine Ghazi,Synopsys,10,26,4,40,
2025-09-10,Jochen Zeitz,Harley-Davidson,7,23,10,40,
2025-09-10,Nick Jeffery,Frontier Communications,10,26,1,37,
2025-09-10,Thomas Edward McCormick,Primoris Services,0,4,0,4,
2025-09-10,D Christian Koch,Carlisle Companies,1,3,0,4,
2025-09-10,David E Simon,Simon Property Group,4,5,1,10,
2025-09-10,Stephen Bratspies,Hanesbrands,2,11,1,14,
2025-09-10,Ryan M. Schneider,Anywhere Real Estate Inc,0,0,0,0,
2025-09-10,George Bobb III,Teledyne Technologies,1,4,0,5,
2025-09-10,Terrence A Duffy,CME Group,6,8,1,15,
2025-09-10,Rami Rahim,Juniper Networks,11,26,3,40,
2025-09-10,Sue Nabi,Coty,16,18,6,40,
2025-09-10,Peter D Arvan,Pool Corporation,2,7,0,9,
2025-09-10,David Campbell,Evergy,15,9,0,24,
2025-09-10,Matthew J Murphy,Marvell Technology,3,6,1,10,
2025-09-10,Lloyd Yates,NiSource,6,4,0,10,
2025-09-10,William C Stone,SS&C Technologies,2,6,0,8,
2025-09-10,Mark Rourke,Schneider National,10,18,1,29,
2025-09-10,Andrew Anagnost,Autodesk,9,25,6,40,
2025-09-10,Dustin Semach,Sealed Air Corporation,0,9,0,9,
2025-09-10,William L Meaney,Iron Mountain,3,18,0,21,
2025-09-10,Andy P Power,Digital Realty Trust,0,0,0,0,
2025-09-10,Satish Dhanasekaran,Keysight Technologies,2,10,0,12,
2025-09-10,Frank M Svoboda,Globe Life,3,4,3,10,
2025-09-10,Carey A Smith,Parsons Corporation,0,2,0,2,
2025-09-10,Ynon Kreiz,Mattel,7,26,7,40,
2025-09-10,Karen S Haller,Southwest Gas,3,6,0,9,
2025-09-10,Terrance Williams,TruStage,3,6,1,10,
2025-09-10,Eric W Gerstenberg,Clean Harbors,5,1,1,7,
2025-09-10,Gunner Smith,Cornerstone Building Brands,1,8,1,10,
2025-09-10,Gerben W Bakker,Hubbell,1,4,0,5,
2025-09-10,Dave Davis,Spirit Airlines,7,29,4,40,
2025-09-10,Michael J Smith,Lamb Weston,0,6,3,9,
2025-09-10,Strauss Zelnick,Take-Two Interactive Software,15,17,8,40,
2025-09-10,John C Turner Jr,GMS,2,8,0,10,
2025-09-10,David M OMalley,Penn Mutual Life Insurance,0,1,0,1,
2025-09-10,Frank A Lonegro,Landstar System,2,4,0,6,
2025-09-10,James F Risoleo,Host Hotels & Resorts,5,16,0,21,
2025-09-10,Ken Xie,Fortinet,13,17,8,38,
2025-09-10,Doug Shulman,OneMain,4,6,0,10,
2025-09-10,Ryan Cohen,GameStop,11,21,8,40,
2025-09-10,Mark W Begor,Equifax,3,14,0,17,
2025-09-10,Jay L Schottenstein,American Eagle Outfitters,11,19,1,31,
2025-09-10,Curtis C Farmer,Comerica,5,9,0,14,
2025-09-10,Ole Rosgaard,Greif,2,15,1,18,
2025-09-10,Brian E Lane,Comfort Systems USA,10,0,0,10,
2025-09-10,Robert M Buck,TopBuild,2,6,0,8,
2025-09-10,Ralph Andretta,Bread Financial,3,9,0,12,
2025-09-10,Jim Anderson,Coherent,6,34,0,40,
2025-09-10,Walter C. D. Carlson,Telephone & Data Systems,0,3,0,3,
2025-09-10,Ronald Kruszewski,Stifel Financial,7,3,0,10,
2025-09-10,Richard Hayne,Urban Outfitters,13,19,8,40,
2025-09-10,Simon Meester,Terex,3,7,0,10,
2025-09-10,Edward J Lehner,Ryerson Holding,0,2,0,2,
2025-09-10,Nicholas T Pinchuk,Snap-on,3,5,0,8,
2025-09-10,Ryals McMullian,Flowers Foods,5,31,3,39,
2025-09-10,D Bryan Jordan,First Horizon,3,8,1,12,
2025-09-10,John B Gibson,Paychex,5,5,0,10,
2025-09-10,Chris Cocks,Hasbro,12,19,9,40,
2025-09-10,Pete McPartland,Sentry Insurance Group,0,2,0,2,
2025-09-10,Michael Arougheti,Ares Management,16,22,2,40,
2025-09-10,Alok Maskara,Lennox International,5,3,1,9,
2025-09-10,James C Grech,Peabody Energy,3,0,0,3,
2025-09-10,Joseph P Lacher Jr,Kemper,4,19,4,27,
2025-09-10,Perry A Sook,Nexstar Media Group,8,27,1,36,
2025-09-10,Wade Davis,TelevisaUnivision,13,26,1,40,
2025-09-10,Scott L Thompson,Tempur Sealy International,0,7,0,7,
2025-09-10,Mike Simonds,TriNet Group,0,9,0,9,
2025-09-10,B Andrew Rose,Worthington Enterprises,1,1,0,2,
2025-09-10,Bruce L Caswell,Maximus,3,5,0,8,
2025-09-10,Robert L Reffkin,Compass,1,7,0,8,
2025-09-10,Mark Eubanks,Brinks Company,1,2,1,4,
2025-09-10,Peter Quigley,Kelly Services inc,1,9,0,10,
2025-09-10,David L Yowan,Navient,2,1,0,3,
2025-09-10,Mary E Kipp,Puget Sound Energy,4,1,2,7,
2025-09-10,Adam Aron,AMC Entertainment,16,18,6,40,
2025-09-10,Mark J Tarr,Encompass Health,2,6,1,9,
2025-09-10,Liam K Griffin,Skyworks Solutions,1,8,0,9,
2025-09-10,Richard G Kyle,Timken,2,14,1,17,
2025-09-10,Ron Gusek,Liberty Energy,21,1,0,22,
2025-09-10,John E Geller Jr,Marriott Vacations Worldwide,6,5,0,11,
2025-09-10,Karl G. Glassman,Leggett & Platt,0,4,0,4,
2025-09-10,Bruce K Thorn,Big Lots,2,6,2,10,
2025-09-10,Jonathan H Weis,Weis Markets,11,28,0,39,
2025-09-10,Jeffrey B Guldner,Pinnacle West Capital,1,3,0,4,
2025-09-10,Arkadiy Dobkin,EPAM Systems,11,14,1,26,
2025-09-10,Paul M Rady,Antero Resources,4,8,0,12,
2025-09-10,Michael Spanos,Bloomin Brands,1,8,1,10,
2025-09-10,Nicole A Kivisto,MDU Resources Group,2,3,0,5,
2025-09-10,Gerald L Morgan,Texas Roadhouse,4,2,4,10,
2025-09-10,Gabriel Tirador,Mercury General,4,4,2,10,
2025-09-10,Nicholas I Fink,Fortune Brands Innovations,4,6,0,10,
2025-09-10,Paul E Burdiss,Zions Bancorp,1,1,0,2,
2025-09-10,William J Christensen,JELD-WEN Holding,4,4,0,8,
2025-09-10,Evan Spiegel,Snap Inc,19,17,4,40,
2025-09-10,Bill Burns,Zebra Technologies,5,23,1,29,
2025-09-10,Steven Sell,Agilon Health,0,7,0,7,
2025-09-10,Richard M Olson,Toro Company,1,12,0,13,
2025-09-10,Eric S Yuan,Zoom Video Communications,6,7,0,13,
2025-09-10,Dan L Batrack,Tetra Tech,2,5,1,8,
2025-09-10,Joseph D Russell Jr,Public Storage,0,8,0,8,
2025-09-10,Jacob Thaysen,Illumina inc,5,7,0,12,
2025-09-10,Debra A Cafaro,Ventas inc,6,6,0,12,
2025-09-10,Pierre R Brondeau,FMC Corporation,0,5,0,5,
2025-09-10,Judy R McReynolds,ArcBest,5,15,1,21,
2025-09-10,Russell J Weiner,Dominos Pizza inc,0,0,0,0,
2025-09-10,Theodore S Hanson,ASGN,0,1,0,1,
2025-09-10,RJ Scaringe,Rivian Automotive,10,27,3,40,
2025-09-10,Jeffrey N Simmons,Elanco Animal Health,2,5,1,8,
2025-09-10,Tim O Shaughnessy,Graham Holdings Company,3,7,0,10,
2025-09-10,Thomas V Taylor,Floor & Decor,1,2,1,4,
2025-09-10,Neil A Schrimsher,Applied Industrial Technologies,5,25,1,31,
2025-09-10,Robert E Price,PriceSmart,4,6,0,10,
2025-09-10,John David Risher,Lyft,4,3,1,8,
2025-09-10,Gary B Smith,Ciena,4,7,0,11,
2025-09-10,Joey Levin,IAC,6,31,1,38,
2025-09-10,Jim Jacobs,Country Financial,7,3,2,12,
2025-09-10,Devin B McGranahan,Western Union,1,5,0,6,
2025-09-10,R Scott Rowe,Flowserve,5,4,1,10,
2025-09-10,Kenneth A Vecchione,Western Alliance Bancorp,0,0,1,1,
2025-09-10,John C Rademacher,Option Care Health,6,1,0,7,
2025-09-10,Doug Black,SiteOne Landscape Supply,3,19,2,24,
2025-09-10,Oliver G Brewer III,Topgolf Callaway Brands,1,0,0,1,
2025-09-10,Glenn Sanford,eXp World,15,21,4,40,
2025-09-10,Fran Horowitz,Abercrombie & Fitch,13,20,7,40,
2025-09-10,Kevin Akers,Atmos Energy,7,3,0,10,
2025-09-10,Alessandro Maselli,Catalent,3,12,3,18,
2025-09-10,J Powell Brown,Brown & Brown,13,21,6,40,
2025-09-10,Aman Bhutani,GoDaddy,16,22,2,40,
2025-09-10,John C. Griffith,American Water Works,0,4,0,4,
2025-09-10,John J Marchioni,Selective Insurance Group,4,13,3,20,
2025-09-10,Lawson E Whiting,Brown-Forman,1,7,1,9,
2025-09-10,Dave Peacock,Advantage Solutions,23,8,0,31,
2025-09-10,Mick Farrell,ResMed,15,23,2,40,
2025-09-10,Kamal Hathi,Splunk,3,4,0,7,
2025-09-10,Todd Kelsey,Plexus,3,6,0,9,
2025-09-10,Phillip D Yeager,Hub Group,4,5,0,9,
2025-09-10,Steven B Hedlund,Lincoln Electric,4,6,0,10,
2025-09-10,Timothy C Oliver,NCR Atleos,0,1,0,1,
2025-09-10,Bruce Fleming,Calumet,2,6,0,8,
2025-09-10,Daniel S. Peyovich,Dycom Industries,0,3,0,3,
2025-09-10,Avner M Applbaum,Valmont Industries,0,8,0,8,
2025-09-10,Kimberly A Fields,ATI inc,4,9,0,13,
2025-09-10,Khozema Z Shipchandler,Twilio,0,2,0,2,
2025-09-10,Gary C Bhojwani,CNO Financial Group,1,5,1,7,
2025-09-10,William Andrew Hendricks Jr,Patterson-UTI Energy,0,0,0,0,
2025-09-10,Kevin D Hochman,Brinker International,1,3,0,4,
2025-09-10,James C Foster,Charles River Laboratories International,2,10,0,12,
2025-09-10,Rajiv K Prasad,Hyster-Yale,2,5,0,7,
2025-09-10,Eric T Steigerwalt,Brighthouse Financial,1,0,0,1,
2025-09-10,Thomas L Ryan,Service Corp International,6,4,0,10,
2025-09-10,Charles M Nifong Jr,CrossAmerica Partners,0,0,0,0,
2025-09-10,Anirudh Devgan,Cadence,11,26,3,40,
2025-09-10,Andi Owen,MillerKnoll,16,16,8,40,
2025-09-10,Sumit Roy,Realty Income,16,19,2,37,
2025-09-10,Timothy John Fitzgerald,Middleby,0,0,0,0,
2025-09-10,Robert H Schottenstein,M/I Homes,1,9,0,10,
2025-09-10,Stephen P MacMillan,Hologic,1,7,1,9,
2025-09-10,Lisa M Barton,Alliant Energy,3,0,0,3,
2025-09-10,Aaron P Jagdfeld,Generac,1,6,1,8,
2025-09-10,Erik Gershwind,MSC Industrial Direct,3,5,2,10,
2025-09-10,Varun Krishna,Rocket Companies,9,30,1,40,
2025-09-10,Fahmi Karam,Upbound Group,4,4,0,8,
2025-09-10,NADominic Ng,East West Bancorp,0,0,0,0,
2025-09-10,Mark Wang,Hilton Grand Vacations,38,2,0,40,
2025-09-10,Robert J Sheedy Jr,Grocery Outlet Holding,0,0,0,0,
2025-09-10,Simon D Campion,Dentsply Sirona,0,3,0,3,
2025-09-10,Jeremy Wensinger,V2X,6,7,0,13,
2025-09-10,Andrew Rees,Crocs,14,15,11,40,
2025-09-10,David M Maura,Spectrum Brands,6,0,0,6,
2025-09-10,Sachin S Lawande,Visteon,0,0,0,0,
2025-09-10,Neil M Ashe,Acuity Inc,0,2,0,2,
2025-09-10,Lorie L Tekorius,Greenbrier,1,9,0,10,
2025-09-10,John R Ciulla,Webster Financial,5,5,0,10,
2025-09-10,Sean D Keohane,Cabot Corporation,3,4,0,7,
2025-09-10,Drew M Wilkerson,RXO inc,0,1,0,1,
2025-09-10,Daniel E Brown,Chord Energy,1,0,0,1,
2025-09-10,Javier D Ferrer Fernandez,Popular inc,0,0,0,0,
2025-09-10,Olivier Rabiller,Garrett Motion inc,4,8,0,12,
2025-09-10,Ronald N Tutor,Tutor Perini Corporation,3,6,0,9,
2025-09-10,Jeff Liaw,Copart,4,5,0,9,
2025-09-10,Aman Narang,Toast inc,4,5,1,10,
2025-09-10,Joseph M Hogan,Align Technology,3,5,0,8,
2025-09-10,Kevin J Wheeler,A O Smith,0,18,1,19,
2025-09-10,Christopher A Cartwright,TransUnion,2,0,2,4,
2025-09-10,James Kelly,NCR Voyix,2,11,0,13,
2025-09-10,Tom Leighton,Akamai Technologies,14,15,5,34,
2025-09-10,Robert G Painter,Trimble,7,2,0,9,
2025-09-10,Tony Helton,Medical Mutual of Ohio,2,4,1,7,
2025-09-10,Caroline S Grace,AMN Healthcare Services,0,0,0,0,
2025-09-10,Patrick Kaltenbach,Mettler-Toledo International,1,9,0,10,
2025-09-10,Michael L Baur,ScanSource,0,2,0,2,
2025-09-10,Jason Lippert,LCI Industries,2,12,0,14,
2025-09-10,Fredric J Tomczyk,Cboe Global Markets,1,7,1,9,
2025-09-10,Octavio Marquez,Diebold Nixdorf,5,10,1,16,
2025-09-10,Sivasankaran Somasundaram,ChampionX,4,2,0,6,
2025-09-10,Ronald F Clarke,Corpay,0,0,0,0,
2025-09-10,Robert W Pittman,iHeartMedia,5,3,0,8,
2025-09-10,Patrick Zalupski,Dream Finders Homes,23,15,2,40,
2025-09-10,Keith E Smith,Boyd Gaming,0,6,0,6,
2025-09-10,Mehran Assadi,NLV Financial,1,1,0,2,
2025-09-10,Barry R Port,Ensign Group,2,5,2,9,
2025-09-10,Denise A Paulonis,Sally Beauty,1,2,0,3,
2025-09-10,Clifford A Skelton,Conduent,0,1,0,1,
2025-09-10,Jean-Michel Ribieras,Sylvamo,2,6,0,8,
2025-09-10,Douglas F Bauer,Tri Pointe Homes,0,5,0,5,
2025-09-10,Shawn OConnell,EnerSys,0,1,0,1,
2025-09-10,Bill Meury,Incyte,7,14,0,21,
2025-09-10,Dale Francescon,Century Communities,1,11,3,15,
2025-09-10,Michael Nierenberg,Rithm Capital,10,28,2,40,
2025-09-10,Michael J Brown,Euronet Worldwide,2,7,0,9,
2025-09-10,Scott Seu,Hawaiian Electric Industries,5,16,1,22,
2025-09-10,Jason D Robins,DraftKings,5,2,0,7,
2025-09-10,Jonathan J Mazelsky,IDEXX Laboratories,1,1,1,3,
2025-09-10,Richard S Swartz,MYR Group,0,1,0,1,
2025-09-10,Stefano Caroti,Deckers Outdoor,2,7,1,10,
2025-09-10,Kevin R Sayer,DexCom,2,3,0,5,
2025-09-10,John T C Lee,MKS Instruments,3,9,0,12,
2025-09-10,Edward B Pitoniak,VICI Properties,1,7,0,8,
2025-09-10,Albert White III,Cooper Cos,0,0,0,0,
2025-09-10,Barry L Biffle,Frontier Airlines,1,6,6,13,
2025-09-10,Robert A Bruggeworth,Qorvo,5,4,0,9,
2025-09-10,Winnie Park,Five Below,9,27,4,40,
2025-09-10,Steven Oakland,TreeHouse Foods,2,12,0,14,
2025-09-10,James S Hagedorn,Scotts Miracle-Gro,1,0,0,1,
2025-09-10,Michael Cannon-Brookes,Atlassian,16,23,0,39,
2025-09-10,Bertrand Loy,Entegris,3,10,1,14,
2025-09-10,William E Waltz,Atkore,2,7,0,9,
2025-09-10,Celeste B Mastin,H B Fuller,1,3,0,4,
2025-09-10,Kyle T Larkin,Granite Construction,1,7,0,8,
2025-09-10,Michael J Happe,Winnebago Industries,1,3,0,4,
2025-09-10,Steven H Gunby,FTI Consulting,5,10,0,15,
2025-09-10,Stephan B Tanda,AptarGroup,1,5,2,8,
2025-09-10,Timothy P Boyle,Columbia Sportswear,4,2,2,8,
2025-09-10,Anthony J Wood,Roku,5,3,1,9,
2025-09-10,M Christopher Doyle,Civitas Resources,1,2,0,3,
2025-09-10,Andy Eidson,Alpha Metallurgical Resources,1,7,1,9,
2025-09-10,Andy L Nemeth,Patrick Industries,4,2,0,6,
2025-09-10,Roger W Jenkins,Murphy Oil,5,16,0,21,
2025-09-10,Kevin S Blair,Synovus Financial,8,1,1,10,
2025-09-10,Julie Felss Masino,Cracker Barrel Old Country Store,11,16,13,40,
2025-09-10,David M Overton,Cheesecake Factory,1,9,0,10,
2025-09-10,Nick DeIuliis,CNX Resources,8,1,0,9,
2025-09-10,Christopher Pappas,Chefs Warehouse,4,10,1,15,
2025-09-10,Tod Carpenter,Donaldson Company,2,8,0,10,
2025-09-10,Gregory L Christopher,Mueller Industries,2,6,0,8,
2025-09-10,Rob Saltiel,MRC Global,6,12,1,19,
2025-09-10,Jillian C Evanko,Chart Industries,3,7,0,10,
2025-09-10,Dave Guilmette,Alight Solutions,3,7,0,10,
2025-09-10,Joel Smejkal,Vishay Intertechnology,4,5,1,10,
2025-09-10,Dennis Degner,Range Resources,3,8,0,11,
2025-09-10,Ira D Robbins,Valley National Bancorp,1,2,0,3,
2025-09-10,Bernard Kim,Match Group,15,18,7,40,
2025-09-10,Vincent Pilette,Gen Digital,3,10,0,13,
2025-09-10,Timothy S Crane,Wintrust Financial,2,6,1,9,
2025-09-10,Pat Roche,Moog inc,4,11,2,17,
2025-09-10,Mark R Widmar,First Solar,3,5,2,10,
2025-09-10,Niko Lahanas,Central Garden & Pet,2,11,0,13,
2025-09-10,Chris Osowski,Green Plains inc,4,10,1,15,
2025-09-10,Derek J Leathers,Werner Enterprises,1,7,0,8,
2025-09-10,Adam Foroughi,AppLovin,12,24,4,40,
2025-09-10,Luca Savi,ITT,2,7,1,10,
2025-09-10,Lawrence H Silber,Herc Rentals,0,0,0,0,
2025-09-10,Hilton H Howell Jr,Gray Television,7,21,1,29,
2025-09-10,Eric D Ashleman,IDEX,0,9,1,10,
2025-09-10,Owen D Thomas,Boston Properties,2,8,0,10,
2025-09-10,Kurt Wolf,Pitney Bowes,6,18,1,25,
2025-09-10,Sara E Armbruster,Steelcase,2,0,0,2,
2025-09-10,Charles D. Young,Sun Communities,2,5,0,7,
2025-09-10,Suzanne Foster,AdaptHealth,5,8,1,14,
2025-09-10,Grant E Sims,Genesis Energy,2,2,0,4,
2025-09-10,Laura Prieskorn,Jackson Financial,2,6,2,10,
2025-09-10,Rick L Wessel,FirstCash,4,5,1,10,
2025-09-10,Sherman Miller,Cal-Maine Foods,12,28,0,40,
2025-09-10,Paul A Lang,Arch Resources,5,4,0,9,
2025-09-10,Ashish K Khandpur,Avient,2,7,0,9,
2025-09-10,Shyam K Reddy,BlueLinx,1,7,0,8,
2025-09-10,Christopher S Ripley,Sinclair,1,8,0,9,
2025-09-10,Stacy Kymes,BOK Financial,8,7,0,15,
2025-09-10,James H Walter,Permian Resources,0,1,0,1,
2025-09-10,Jason Murray,PACS Group,5,13,2,20,
2025-09-10,Brian Armstrong,Coinbase Global,12,23,5,40,
2025-09-10,Oscar K Brown,Western Midstream Partners,1,3,0,4,
2025-09-10,Nicholas R Lower,Federated Mutual Insurance,0,1,0,1,
2025-09-10,Morris Goldfarb,G-III Apparel Group,8,27,5,40,
2025-09-10,Mark D Morelli,Vontier,0,3,0,3,
2025-09-10,Matthew J Cox,Matson inc,2,5,0,7,
2025-09-10,David W Grzebinski,Kirby Corporation,1,2,0,3,
2025-09-10,Keith A Harvey,Kaiser Aluminum,4,4,1,9,
2025-09-10,Eric Nyman,Vista Outdoor,4,11,1,16,
2025-09-10,Doug Howe,Designer Brands,5,20,0,25,
2025-09-10,Jerry E Gahlhoff Jr,Rollins inc,0,2,0,2,
2025-09-10,D Scott Barbour,Advanced Drainage Systems,2,2,0,4,
2025-09-10,Sean Gamble,Cinemark,16,22,2,40,
2025-09-10,George Kurtz,CrowdStrike,14,23,3,40,
2025-09-10,Bill Ready,Pinterest,24,16,0,40,
2025-09-10,Fidji Simo,Instacart,11,28,1,40,
2025-09-10,Kimberly K Ryan,Hillenbrand,3,6,0,9,
2025-09-10,David S Graziosi,Allison Transmission,1,17,3,21,
2025-09-10,Gary G Friedman,Restoration Hardware,1,4,0,5,
2025-09-10,Lucinda M Baier,Brookdale Senior Living,4,3,1,8,
2025-09-10,Brian J Blaser,QuidelOrtho,1,9,0,10,
2025-09-10,E Jean Savage,Trinity Industries,1,8,1,10,
2025-09-10,Liam J Kelly,Teleflex,0,4,1,5,
2025-09-10,Laurans A Mendelson,HEICO,7,19,1,27,
2025-09-10,Frank H Laukien,Bruker,2,7,0,9,
2025-09-10,Harvey M Schwartz,Carlyle Group,5,12,0,17,
2025-09-10,Mark S LaVigne,Energizer,3,1,0,4,
2025-09-10,Joel Quadracci,Quad/Graphics,11,23,5,39,
2025-09-10,Amar Maletira,Rackspace Technology,7,12,2,21,
2025-09-10,Udit Batra,Waters Corporation,9,25,1,35,
2025-09-10,Eric M Green,West Pharmaceutical Services,3,7,0,10,
2025-09-10,Doug Palladini,Carters inc,2,2,2,6,
2025-09-10,G Mike Mikan,NeueHealth,4,2,0,6,
2025-09-10,Russell ChipChilds,SkyWest,0,0,0,0,
2025-09-10,Christopher H Hunter,Acadia Healthcare,0,2,0,2,
2025-09-10,Prahlad Singh,Revvity,2,7,0,9,
2025-09-10,Maria M Pope,Portland General Electric,1,0,0,1,
2025-09-10,Charles Chip Blankenship,Woodward inc,0,1,0,1,
2025-09-10,Mike Steib,TEGNA,14,17,1,32,
2025-09-10,Kurt J Ekert,Sabre Corporation,0,1,0,1,
2025-09-10,Matt Wilson,Light & Wonder,18,18,4,40,
2025-09-10,Rob Katz,Vail Resorts,4,11,25,40,
2025-09-10,Schnitzer Steel Industries,Radius Recycling,7,25,6,38,
2025-09-10,David A Spector,PennyMac Financial Services,6,2,0,8,
2025-09-10,Frederick J Holzgrefe III,Saia inc,1,1,0,2,
2025-09-10,Mark J Parrell,Equity Residential,4,7,0,11,
2025-09-10,John W Lindsay,Helmerich & Payne,0,4,0,4,
2025-09-10,Gary D Burnison,Korn Ferry,4,14,0,18,
2025-09-10,Timothy J McGrath,PC Connection Inc,1,2,0,3,
2025-09-10,Lynn M Bamford,Curtiss-Wright,12,9,0,21,
2025-09-10,Jonathan W Witter,Sallie Mae,0,2,0,2,
2025-09-10,Jeff Benck,Benchmark Electronics,5,9,0,14,
2025-09-10,Charles H Giancarlo,Pure Storage,1,3,0,4,
2025-09-10,Brian R Gray,Knife River Corporation,0,1,0,1,
2025-09-10,Jay Schmidt,Caleres inc,3,5,2,10,
2025-09-10,Dale Asplund,BrightView Holdings,1,6,0,7,
2025-09-10,Jeffrey S Edwards,Cooper-Standard,0,7,0,7,
2025-09-10,Glenn J Williams,Primerica,5,2,2,9,
2025-09-10,Francois Locoh-Donou,F5,7,22,2,31,
2025-09-10,Joseph Wm Foran,Matador Resources,8,10,0,18,
2025-09-10,Sridhar Ramaswamy,Snowflake inc,10,24,3,37,
2025-09-10,Mark D Dankberg,Viasat,2,3,3,8,
2025-09-10,Francisco J Leon,California Resources,1,3,1,5,
2025-09-10,Peter Stern,Peloton,18,18,4,40,
2025-09-10,David Baszucki,Roblox,9,21,10,40,
2025-09-10,Jeffrey W Edwards,Installed Building Products,0,1,0,1,
2025-09-10,Clark Lauritzen,First National of Nebraska,1,7,0,8,
2025-09-10,Carlos Alberini,Guess inc,13,26,1,40,
2025-09-10,Shyam P Kambeyanda,ESAB,4,3,0,7,
2025-09-10,Edmund Shallcross III,Amica Mutual Insurance,1,5,0,6,
2025-09-10,Benjamin W Schall,AvalonBay Communities,1,5,1,7,
2025-09-10,Allan C Thygesen,DocuSign,2,8,0,10,
2025-09-10,Bryan J Knutson,Titan Machinery,1,1,1,3,
2025-09-10,Heath Sampson,ModivCare,7,1,1,9,
2025-09-10,Ara K Hovnanian,Hovnanian Enterprises,1,16,1,18,
2025-09-10,Joshua G Silverman,Etsy,1,2,0,3,
2025-09-10,Kevin Roycraft,Adams Resources & Energy,5,4,1,10,
2025-09-10,J Eric Evans,Surgery Partners,0,3,0,3,
2025-09-10,Clint E Stein,Columbia Banking System,1,7,0,8,
2025-09-10,Lee M Shavel,Verisk Analytics,2,7,0,9,
2025-09-10,Dave Banyard Jr,MasterBrand,0,0,0,0,
2025-09-10,Peter R Ingram,Hawaiian Airlines inc,1,0,0,1,
2025-09-10,Kristin A Dolan,AMC Networks,4,2,0,6,
2025-09-10,Brendan T Cavanagh,SBA Communications,1,2,0,3,
2025-09-10,George F Chappelle Jr,Americold Realty Trust,2,3,0,5,
2025-09-10,Thomas E Gottwald,NewMarket Corporation,2,8,0,10,
2025-09-10,Thomas J Baltimore Jr,Park Hotels & Resorts,4,31,1,36,
2025-09-10,Peter M Moglia,Alexandria Real Estate Equities,3,5,0,8,
2025-09-10,Ronald J Kramer,Griffon Corporation,1,6,0,7,
2025-09-10,John L Plueger,Air Lease,2,13,0,15,
2025-09-10,Jennifer F Scanlon,UL Solutions,1,3,0,4,
2025-09-10,Greg Smith,Teradyne,1,8,2,11,
2025-09-10,Sean Trauschke,OGE Energy,18,5,0,23,
2025-09-10,Norman D Schwartz,Bio-Rad Laboratories,0,0,1,1,
2025-09-10,Scott Doyle,Spire inc,4,5,1,10,
2025-09-10,Michael E Reed,Gannett,0,5,2,7,
2025-09-10,Cindy J Miller,Stericycle,2,4,3,9,
2025-09-10,Phillip D Green,Cullen Frost Bankers,1,4,3,8,
2025-09-10,Joseph D Margolis,Extra Space Storage,0,8,1,9,
2025-09-10,Mark A Skonieczny,REV Group,6,4,0,10,
2025-09-10,Ladd Wilks,ProFrac Holding,3,2,0,5,
2025-09-10,Sundaram Nagarajan,Nordson,0,9,1,10,
2025-09-10,Anne P Noonan,Summit Materials,0,1,0,1,
2025-09-10,Lori Flees,Valvoline inc,4,5,1,10,
2025-09-10,Scott H Baxter,Kontoor Brands,2,1,0,3,
2025-09-10,Tim Larson,Skyline Champion,8,0,0,8,
2025-09-10,Chuck Divita,Teladoc Health,11,19,5,35,
2025-09-10,W Bradley Southern,Louisiana-Pacific Corporation,0,0,0,0,
2025-09-10,George C Freeman III,Universal Corporation,2,6,0,8,
2025-09-10,James A Brock,Consol Energy,1,0,0,1,
2025-09-10,Robert Antokol,Playtika Holding,1,7,1,9,
2025-09-10,Joe Craft,Alliance Resource Partners,7,9,2,18,
2025-09-10,Paul Keel,Envista,2,6,1,9,
2025-09-10,Jared Isaacman,Shift4 Payments,6,28,6,40,
2025-09-10,Mark Mac McFarland,Talen Energy,3,1,1,5,
2025-09-10,Tony R Thene,Carpenter Technology,2,7,0,9,
2025-09-10,Melissa D Smith,WEX,1,5,1,7,
2025-09-10,James Jim C Ryan III,Old National Bancorp,1,0,0,1,
2025-09-10,Peter J Federico,AGNC Investment,1,0,0,1,
2025-09-10,Brent L Yeagy,Wabash National,0,1,0,1,
2025-09-10,Henry A Fernandez,MSCI,2,16,0,18,
2025-09-10,Mark Penn,Stagwell,13,22,4,39,
2025-09-10,Julie Schertell,Mativ,3,9,0,12,
2025-09-10,Ashish Chand,Belden,3,6,1,10,
2025-09-10,Greg Anderson,Allegiant Travel Company,5,8,0,13,
2025-09-10,Drew Houston,Dropbox,15,18,7,40,
2025-09-10,Kevin T Conroy,Exact Sciences,2,5,2,9,
2025-09-10,Rex D Geveden,BWX Technologies,3,7,0,10,
2025-09-10,Scott R Wells,Clear Channel Outdoor Hldgs,0,0,0,0,
2025-09-10,Paul Bay,Ingram Micro,10,25,5,40,
2025-09-11,Doug McMillon,Walmart,16,18,6,40,
2025-09-11,Andrew Jassy,Amazon,3,31,6,40,
2025-09-11,Tim Cook,Apple,9,29,2,40,
2025-09-11,Stephen Hemsley,UnitedHealth,7,29,4,40,
2025-09-11,Warren Buffett,Berkshire Hathaway,14,15,11,40,
2025-09-11,David Joyner,CVS Health,6,29,5,40,
2025-09-11,Darren Woods,Exxon Mobil,10,23,6,39,
2025-09-11,Sundar Pichai,Alphabet,20,15,5,40,
2025-09-11,Brian Tyler,McKesson,5,14,5,24,
2025-09-11,Robert Mauch,Cencora,3,7,0,10,
2025-09-11,Ron Vachris,Costco,7,32,1,40,
2025-09-11,Jamie Dimon,JPMorgan Chase,7,21,12,40,
2025-09-11,Satya Nadella,Microsoft,16,22,2,40,
2025-09-11,Jason Hollar,Cardinal Health,14,22,4,40,
2025-09-11,Mike Wirth,Chevron,15,17,8,40,
2025-09-11,David Cordani,Cigna,20,16,4,40,
2025-09-11,Jim Farley,Ford Motor,14,18,8,40,
2025-09-11,Brian Moynihan,Bank of America,6,29,5,40,
2025-09-11,Mary Barra,General Motors,14,21,5,40,
2025-09-11,Gail Boudreaux,Elevance Health,15,17,8,40,
2025-09-11,Jane Fraser,Citigroup,13,23,4,40,
2025-09-11,Sarah London,Centene,14,17,9,40,
2025-09-11,Ted Decker,Home Depot,12,24,4,40,
2025-09-11,Maryann Mannen,Marathon Petroleum,8,14,1,23,
2025-09-11,Ron Sargent,Kroger,5,22,13,40,
2025-09-11,Mark Lashier,Phillips 66,11,20,7,38,
2025-09-11,Priscilla Almodovar,Fannie Mae,10,16,14,40,
2025-09-11,Tim Wentworth,Walgreens,8,26,6,40,
2025-09-11,Lane Riggs,Valero Energy,14,8,0,22,
2025-09-11,Mark Zuckerberg,Meta,7,19,14,40,
2025-09-11,Hans Vestberg,Verizon,16,20,4,40,
2025-09-11,John Stankey,AT&T,12,24,4,40,
2025-09-11,Brian Roberts,Comcast,10,28,2,40,
2025-09-11,Charles Scharf,Wells Fargo,27,6,7,40,
2025-09-11,David Solomon,Goldman Sachs,6,21,13,40,
2025-09-11,Michael Hutchins,Freddie Mac,2,10,4,16,
2025-09-11,Michael Fiddelke,Target,11,20,9,40,
2025-09-11,Jim Rechtin,Humana,21,15,4,40,
2025-09-11,Jon Farney,State Farm Insurance,1,14,3,18,
2025-09-11,Elon Musk,Tesla,12,23,5,40,
2025-09-11,Ted Pick,Morgan Stanley,18,19,3,40,
2025-09-11,Joaquin Duato,Johnson & Johnson,12,24,4,40,
2025-09-11,Juan Luciano,Archer Daniels Midland,4,20,14,38,
2025-09-11,Ramon Laguarta,PepsiCo,6,27,7,40,
2025-09-11,Carol Tom√©,UPS,4,25,11,40,
2025-09-11,Rajesh Subramaniam,FedEx,11,26,0,37,
2025-09-11,Bob Iger,Walt Disney,8,29,3,40,
2025-09-11,Michael Dell,Dell Technologies,11,24,5,40,
2025-09-11,Marvin Ellison,Lowes,15,25,0,40,
2025-09-11,Jon Moeller,Procter & Gamble,5,28,7,40,
2025-09-11,Thomas Long,Energy Transfer,9,0,1,10,
2025-09-11,Kelly Ortberg,Boeing,10,27,3,40,
2025-09-11,Susan Morris,Albertsons,14,22,4,40,
2025-09-11,Kevin Hourican,Sysco,8,29,3,40,
2025-09-11,Christopher Calio,RTX,6,11,0,17,
2025-09-11,Larry Culp,General Electric,10,27,3,40,
2025-09-11,James Taiclet,Lockheed Martin,14,18,8,40,
2025-09-11,Stephen Squeri,American Express,14,25,1,40,
2025-09-11,Joe Creed,Caterpillar,10,28,2,40,
2025-09-11,Michel Khalaf,MetLife,10,17,1,28,
2025-09-11,Samuel Hazen,HCA Healthcare,8,6,0,14,
2025-09-11,Tricia Griffith,Progressive Insurance,9,26,5,40,
2025-09-11,Arvind Krishna,IBM,13,21,6,40,
2025-09-11,John May,Deere,8,25,7,40,
2025-09-11,Jensen Huang,Nvidia,17,18,5,40,
2025-09-11,Philip Smith,StoneX,0,10,0,10,
2025-09-11,Robert M Davis,Merck,5,19,0,24,
2025-09-11,Ryan Lance,ConocoPhillips,16,20,4,40,
2025-09-11,Albert Bourla,Pfizer,28,9,3,40,
2025-09-11,Ed Bastian,Delta Air Lines,13,17,10,40,
2025-09-11,Patrick Zammit,TD Synnex,8,13,0,21,
2025-09-11,Kevin Murphy,Publix Super Markets,11,20,1,32,
2025-09-11,Thomas J Wilson,Allstate,1,9,1,11,
2025-09-11,Chuck Robbins,Cisco Systems,12,24,4,40,
2025-09-11,Kirt Walker,Nationwide Insurance,4,6,0,10,
2025-09-11,Christopher Winfrey,Charter Communications,5,14,5,24,
2025-09-11,Bob Michael,AbbVie,0,0,0,0,
2025-09-11,Craig DeSanto,New York Life Insurance,3,20,0,23,
2025-09-11,Lip-Bu Tan,Intel,6,28,6,40,
2025-09-11,Ernie Herrman,TJX,17,21,2,40,
2025-09-11,Andrew Sullivan,Prudential Financial,11,20,0,31,
2025-09-11,Enrique Lores,Hewlett Packard,10,19,5,34,
2025-09-11,Scott Kirby,United Airlines,31,4,5,40,
2025-09-11,George Holm,Performance Food,8,20,2,30,
2025-09-11,Donnie King,Tyson Foods,8,28,4,40,
2025-09-11,Robert Isom,American Airlines,7,25,8,40,
2025-09-11,Timothy M Sweeney,Liberty Mutual Insurance,12,0,0,12,
2025-09-11,Elliott Hill,Nike,13,25,2,40,
2025-09-11,Safra Catz,Oracle,22,13,5,40,
2025-09-11,AJ Jim Teague,Enterprise Products Partners,6,14,0,20,
2025-09-11,Richard Fairbank,Capital One,14,24,2,40,
2025-09-11,Willie Chiang,Plains GP,3,6,1,10,
2025-09-11,Michael Kasbar,World Kinect,2,10,0,12,
2025-09-11,Peter Zaffino,American International Group,8,27,5,40,
2025-09-11,James Quincey,The Coca-Cola Company,10,27,3,40,
2025-09-11,Thasunda Brown Duckett,TIAA,22,17,1,40,
2025-09-11,Jay Debertin,CHS,5,11,4,20,
2025-09-11,Chris Boerner,Bristol-Myers Squibb,10,24,6,40,
2025-09-11,Corie Barry,Best Buy,39,1,0,40,
2025-09-11,Marc Casper,Thermo Fisher Scientific,13,24,3,40,
2025-09-11,Roger Crandall,Mass Mutual,2,8,0,10,
2025-09-11,Juan Andrade,USAA,5,18,0,23,
2025-09-11,Phebe Novakovic,General Dynamics,29,8,3,40,
2025-09-11,Alan Schnitzer,Travelers Insurance,3,5,2,10,
2025-09-11,David Zaslav,Warner Bros Discovery,6,24,10,40,
2025-09-11,Gunjan Kedia,US Bancorp,15,23,2,40,
2025-09-11,Robert Ford,Abbott Laboratories,13,21,6,40,
2025-09-11,Kathy Warden,Northrop Grumman,14,22,4,40,
2025-09-11,Tim Gerend,Northwestern Mutual,14,25,1,40,
2025-09-11,Todd Vasos,Dollar General,7,26,7,40,
2025-09-11,Matthew Lucey,PBF Energy,8,2,0,10,
2025-09-11,Dara Khosrowshahi,Uber,12,24,4,40,
2025-09-11,Vimal Kapur,Honeywell,12,28,0,40,
2025-09-11,Dirk Van de Put,Mondelez,9,27,4,40,
2025-09-11,Brian Niccol,Starbucks,14,21,5,40,
2025-09-11,Cristiano Amon,Qualcomm,12,26,2,40,
2025-09-11,Hock Tan,Broadcom,13,25,2,40,
2025-09-11,David Flitman,US Foods,2,8,0,10,
2025-09-11,Paul Romanowski,DR Horton,5,15,5,25,
2025-09-11,Jacek Olczak,Philip Morris,13,24,3,40,
2025-09-11,Preston Feight,Paccar,8,28,1,37,
2025-09-11,Marc Benioff,Salesforce,8,19,13,40,
2025-09-11,Leon Topalian,Nucor,15,23,2,40,
2025-09-11,Michael Dastoor,Jabil,2,6,0,8,
2025-09-11,Jonathan Jaffe,Lennar,0,7,2,9,
2025-09-11,David Ricks,Eli Lilly,10,20,10,40,
2025-09-11,Joe Zubretsky,Molina Healthcare,8,5,4,17,
2025-09-11,Jennifer Rumsey,Cummins,8,27,5,40,
2025-09-11,Robin Vince,Bank of New York Mellon,19,19,2,40,
2025-09-11,Ted Sarandos,Netflix,13,24,3,40,
2025-09-11,William H Rogers Jr,Truist Financial,3,7,0,10,
2025-09-11,Sean Kerins,Arrow Electronics,1,11,0,12,
2025-09-11,William M Brown,3M,2,8,0,10,
2025-09-11,Ryan McInerney,Visa,12,23,5,40,
2025-09-11,Marc Rowan,Apollo Global Management,14,22,4,40,
2025-09-11,Tim Go,HF Sinclair,6,3,0,9,
2025-09-11,Robert Sulentic,CBRE Group,1,7,1,9,
2025-09-11,William Demchak,PNC Financial Services,15,19,6,40,
2025-09-11,Bryan DeBoer,Lithia Motors,3,34,3,40,
2025-09-11,William Nash,CarMax,4,4,2,10,
2025-09-11,Brian Robbins,Paramount Global,7,29,2,38,
2025-09-11,Michael Creedon,Dollar Tree,6,33,1,40,
2025-09-11,Sandy Douglas,United Natural Foods,33,6,1,40,
2025-09-11,Alex Chriss,PayPal,14,23,3,40,
2025-09-11,Roger Penske,Penske Automotive,16,22,2,40,
2025-09-11,Antonio Neri,Hewlett Packard Enterprise,8,25,7,40,
2025-09-11,Harry Sideris,Duke Energy,36,4,0,40,
2025-09-11,Vicki Hollub,Occidental Petroleum,20,16,4,40,
2025-09-11,Lawrence Coben,NRG Energy,5,3,0,8,
2025-09-11,Robert Bradway,Amgen,11,27,2,40,
2025-09-11,John Ketchum,NextEra Energy,23,17,0,40,
2025-09-11,Rainer Blair,Danaher,5,16,2,23,
2025-09-11,Daniel ODay,Gilead Sciences,1,8,1,10,
2025-09-11,Michael Manley,AutoNation,3,6,1,10,
2025-09-11,Carlos Abrams-Rivera,Kraft Heinz,5,30,5,40,
2025-09-11,Philip Gallagher,Avnet,1,5,0,6,
2025-09-11,Gary Dickerson,Applied Materials,7,19,14,40,
2025-09-11,Bob Jordan,Southwest Airlines,9,24,7,40,
2025-09-11,Rick Wurster,Charles Schwab,14,21,4,39,
2025-09-11,Lorenzo Simonelli,Baker Hughes,16,21,3,40,
2025-09-11,Chris Kempczinski,McDonalds,8,23,9,40,
2025-09-11,Christopher Womack,Southern Company,3,7,0,10,
2025-09-11,Michael Miebach,Mastercard,10,26,4,40,
2025-09-11,Joseph Dominguez,Constellation Energy,15,10,1,26,
2025-09-11,Christopher Swift,The Hartford,15,21,4,40,
2025-09-11,Patricia Poppe,PG&E,8,16,2,26,
2025-09-11,Bom Kim,Coupang,12,27,1,40,
2025-09-11,Ezra Yacob,EOG Resources,24,14,2,40,
2025-09-11,Jim Vena,Union Pacific,22,17,1,40,
2025-09-11,Matt Schroeder,Rite Aid,4,33,3,40,
2025-09-11,Tony Spring,Macys,8,26,6,40,
2025-09-11,Anthony Capuano,Marriott International,13,25,2,40,
2025-09-11,Raymond E Scott,Lear Corporation,4,6,0,10,
2025-09-11,William Stengel II,Genuine Parts,0,4,0,4,
2025-09-11,Heidi Petz,Sherwin-Williams,10,28,2,40,
2025-09-11,Jeff Miller,Halliburton,12,22,6,40,
2025-09-11,Kathleen Quirk,Freeport-McMoRan,13,17,2,32,
2025-09-11,Michael Rapino,Live Nation Entertainment,14,23,3,40,
2025-09-11,John Doyle,Marsh & McLennan,10,6,0,16,
2025-09-11,Lisa Su,Advanced Micro Devices,16,20,4,40,
2025-09-11,Frank Holding,First Citizens BancShares,9,15,2,26,
2025-09-11,John Engel,WESCO International,4,14,1,19,
2025-09-11,David Gitlin,Carrier Global,15,23,2,40,
2025-09-11,Lourenco Goncalves,Cleveland-Cliffs,5,20,15,40,
2025-09-11,Calvin G Butler Jr,Exelon,6,4,0,10,
2025-09-11,Joseph Bae,KKR & Co,7,7,1,15,
2025-09-11,Christine Leahy,CDW,0,7,2,9,
2025-09-11,Glenn Fogel,Booking Holdings,12,22,6,40,
2025-09-11,Brian Doubles,Synchrony Financial,4,7,1,12,
2025-09-11,Earl Austin,Quanta Services,2,5,2,9,
2025-09-11,Christian Ulbrich,Jones Lang LaSalle,7,15,0,22,
2025-09-11,Saumya Sutaria,Tenet Healthcare,5,3,1,9,
2025-09-11,William Gifford,Altria Group,3,6,1,10,
2025-09-11,Kevin Lobo,Stryker,10,27,3,40,
2025-09-11,Michael Hsu,Kimberly-Clark,6,6,0,12,
2025-09-11,Jack Fusco,Cheniere Energy,18,18,4,40,
2025-09-11,James Conroy,Ross Stores,4,12,0,16,
2025-09-11,Anthony Smurfit,Smurfit Westrock,4,6,0,10,
2025-09-11,Jeffrey Harmening,General Mills,3,17,5,25,
2025-09-11,Mark Stewart,Goodyear Tire & Rubber,3,36,1,40,
2025-09-11,Bob Eddy,BJs Wholesale Club,3,19,3,25,
2025-09-11,Peter Arduini,GE HealthCare Technologies,4,11,0,15,
2025-09-11,Noel Wallace,Colgate-Palmolive,9,23,2,34,
2025-09-11,Marc Bitzer,Whirlpool,11,15,14,40,
2025-09-11,Chris Kubasik,L3Harris Technologies,7,13,1,21,
2025-09-11,Shantanu Narayen,Adobe,19,19,1,39,
2025-09-11,Thomas Polen,Becton Dickinson,6,4,0,10,
2025-09-11,Richard P Dealy,Pioneer Natural Resources,7,3,0,10,
2025-09-11,Ravi Kumar S,Cognizant Technology Solutions,10,22,3,35,
2025-09-11,Andrew Clyde,Murphy USA,12,27,1,40,
2025-09-11,Mike Lyons,Fiserv,4,12,0,16,
2025-09-11,Jennifer Parmentier,Parker-Hannifin,3,12,0,15,
2025-09-11,William Fehrman,American Electric Power,2,8,0,10,
2025-09-11,Andrew Silvernail,International Paper,5,20,0,25,
2025-09-11,Jonas Prising,ManpowerGroup,7,23,2,32,
2025-09-11,John Zillmer,Aramark,7,14,2,23,
2025-09-11,Mark Millett,Steel Dynamics,18,2,0,20,
2025-09-11,Dan Amos,Aflac,13,18,9,40,
2025-09-11,Tony Cheng,Reinsurance Group of America,3,10,2,15,
2025-09-11,Karsanbhai,Emerson Electric,8,14,2,24,
2025-09-11,Ronald P OHanley,State Street,0,4,0,4,
2025-09-11,Timothy Knavish,PPG Industries,0,1,0,1,
2025-09-11,David Burritt,United States Steel,9,19,11,39,
2025-09-11,Maria Black,Automatic Data Processing,5,4,0,9,
2025-09-11,Daryl Kenningham,Group 1 Automotive,8,30,2,40,
2025-09-11,Robert Blue,Dominion Energy,26,13,1,40,
2025-09-11,Larry Fink,BlackRock,7,27,6,40,
2025-09-11,Pierce Norton II,Oneok,5,3,1,9,
2025-09-11,David Bozeman,CH Robinson Worldwide,2,8,0,10,
2025-09-11,Haviv Ilan,Texas Instruments,11,26,3,40,
2025-09-11,Michael Bender,Kohls,2,25,13,40,
2025-09-11,Philip Daniele III,AutoZone,0,2,0,2,
2025-09-11,Timothy Archer,Lam Research,3,7,0,10,
2025-09-11,Charles Magro,Corteva,5,3,1,9,
2025-09-11,Rick Lanoha,Peter Kiewit Sons,0,2,0,2,
2025-09-11,Peter Jackson,Builders FirstSource,5,12,1,18,
2025-09-11,Martin Schroeter,Kyndryl,9,30,0,39,
2025-09-11,Hamid Akhavan,EchoStar,5,25,10,40,
2025-09-11,Bill Westrate,American Family Insurance,10,17,2,29,
2025-09-11,Avigal Soreq,Delek US,4,9,5,18,
2025-09-11,Beth Ford,Land OLakes,4,7,1,12,
2025-09-11,Walker Martin,Sempra,0,2,0,2,
2025-09-11,Eric Slifka,Global Partners,12,23,5,40,
2025-09-11,DG Macpherson,WW Grainger,2,6,1,9,
2025-09-11,Bob Pragada,Jacobs Solutions,6,10,0,16,
2025-09-11,Pedro Pizarro,Edison International,15,10,15,40,
2025-09-11,William Hornbuckle,MGM Resorts International,9,25,1,35,
2025-09-11,Andrew McMahon,Guardian Life insurance,6,12,0,18,
2025-09-11,Christopher OHerlihy,Illinois Tool Works,0,1,0,1,
2025-09-11,James Cracchiolo,Ameriprise Financial,2,23,2,27,
2025-09-11,Ryan Marshall,PulteGroup,10,15,10,35,
2025-09-11,Matthew Meloy,Targa Resources,6,4,0,10,
2025-09-11,Michael Rhodes,Ally Financial,7,28,5,40,
2025-09-11,Joseph Fadool,BorgWarner,4,9,0,13,
2025-09-11,St√©phane de La Faverie,Est√©e Lauder,12,25,3,40,
2025-09-11,Benjamin Tisch,Loews,2,7,0,9,
2025-09-11,Brad Beckham,OReilly Automotive,2,8,0,10,
2025-09-11,Thomas Gayner,Markel Group,1,9,0,10,
2025-09-11,Donald Allan,Stanley Black & Decker,8,31,1,40,
2025-09-11,Sanjay Mehrotra,Micron Technology,16,22,2,40,
2025-09-11,James Breuer,Fluor,1,1,1,3,
2025-09-11,Thomas Bell,Leidos,9,19,2,30,
2025-09-11,Scott Smith,Viatris,6,4,0,10,
2025-09-11,Kimberly Dang,Kinder Morgan,11,1,0,12,
2025-09-11,Christophe Beck,Ecolab,19,21,0,40,
2025-09-11,Brent Shafer,Baxter International,1,10,0,11,
2025-09-11,Clay Gaspar,Devon Energy,22,3,0,25,
2025-09-11,Steven Cahillane,Kellanova,1,7,0,8,
2025-09-11,Raul Nicholas Vargas Ochoa,Farmers Insurance Exchange,0,0,0,0,
2025-09-11,Darren Rebelez,Caseys General Stores,4,6,0,10,
2025-09-11,Ari Bousbib,IQVIA,6,16,1,23,
2025-09-11,Jon Vander Ark,Republic Services,12,19,9,40,
2025-09-11,Timothy Cofer,Keurig Dr Pepper,2,6,1,9,
2025-09-11,Karla Lewis,Reliance Inc,4,5,0,9,
2025-09-11,David Hult,Asbury Automotive Group,7,32,1,40,
2025-09-11,Darryl Button,Pacific Life,1,8,0,9,
2025-09-11,James Burke,Vistra,7,3,0,10,
2025-09-11,John Barrett,Western & Southern Financial,9,29,2,40,
2025-09-11,William Krueger,The Andersons Inc,0,2,0,2,
2025-09-11,Erik Nordstrom,Nordstrom,7,28,5,40,
2025-09-11,John Wren,Omnicom Group,13,22,5,40,
2025-09-11,Stephanie Ferris,Fidelity National Information Services,15,23,2,40,
2025-09-11,Timothy Cawley,Consolidated Edison,4,5,0,9,
2025-09-11,Joseph Hinrichs,CSX,6,10,1,17,
2025-09-11,Troy Rudd,AECOM,9,24,4,37,
2025-09-11,Kathleen Johnson,Lumen Technologies,4,4,1,9,
2025-09-11,Harry Lawton III,Tractor Supply,1,0,0,1,
2025-09-11,Raul Fernandez,DXC Technology,5,28,1,34,
2025-09-11,Eric Hansotia,AGCO,15,24,1,40,
2025-09-11,David Bruton Smith,Sonic Automotive,3,8,9,20,
2025-09-11,Sasan Goodarzi,Intuit,9,27,4,40,
2025-09-11,Matthew Flannery,United Rentals,32,2,0,34,
2025-09-11,Marc Miller,Universal Health Services,4,21,3,28,
2025-09-11,Michael Mahoney,Boston Scientific,11,29,0,40,
2025-09-11,Judith Marks,Otis Worldwide,3,3,1,7,
2025-09-11,Robert Frenzel,Xcel Energy,3,3,1,7,
2025-09-11,Penny Pennington,Edward Jones,9,26,5,40,
2025-09-11,Daniel Fisher,Ball,3,23,7,33,
2025-09-11,Justin Jude,LKQ,4,6,1,11,
2025-09-11,James Blackledge,Mutual of Omaha,1,32,1,34,
2025-09-11,Bruce Bodine,Mosaic,3,6,0,9,
2025-09-11,Scott Donnelly,Textron,10,27,3,40,
2025-09-11,Adam Schechter,Labcorp Holdings,2,6,1,9,
2025-09-11,Deanna Strable-Soethout,Principal Financial,1,6,0,7,
2025-09-11,Leonard Schleifer,Regeneron Pharmaceuticals,6,27,7,40,
2025-09-11,Paul Shoukry,Raymond James Financial,15,24,1,40,
2025-09-11,Lauren Hobart,Dicks Sporting Goods,12,25,3,40,
2025-09-11,Jamie Whisnant,Auto-Owners Insurance,0,2,0,2,
2025-09-11,Ariane Gorin,Expedia,9,28,2,39,
2025-09-11,Shelley Simpson,JB Hunt Transport Services,10,27,3,40,
2025-09-11,Ren√© Jones,M&T Bank,12,25,3,40,
2025-09-11,Gerardo Norcia,DTE Energy,6,2,1,9,
2025-09-11,Andr√©s Gluski,AES,15,21,0,36,
2025-09-11,Timothy Spence,Fifth Third Bancorp,5,4,1,10,
2025-09-11,Eduardo Menezes,Air Products & Chemicals,3,6,1,10,
2025-09-11,Wendell Weeks,Corning,15,23,2,40,
2025-09-11,Anthony Guzzi,EMCOR Group,2,3,1,6,
2025-09-11,Adam Norwitt,Amphenol,4,15,0,19,
2025-09-11,Jean-Marc Gilson,Westlake Corporation,2,5,0,7,
2025-09-11,Lori Koch,DuPont,6,20,0,26,
2025-09-11,Derek Chang,Liberty Media,36,3,1,40,
2025-09-11,Martina Cheung,S&P Global,10,27,0,37,
2025-09-11,Tim Hingtgen,Community Health Systems,11,27,2,40,
2025-09-11,Brian Tierney,FirstEnergy,6,21,3,30,
2025-09-11,Rick McKenney,Unum Group,5,4,0,9,
2025-09-11,Stanley Bergman,Henry Schein,12,27,1,40,
2025-09-11,Tiang Yew Tan,Western Digital,0,3,0,3,
2025-09-11,Vincent Roche,Analog Devices,12,23,4,39,
2025-09-11,Sean Connolly,Conagra Brands,8,30,2,40,
2025-09-11,Bruce Van Saun,Citizens Financial Group,14,25,1,40,
2025-09-11,Mark George,Norfolk Southern,18,18,4,40,
2025-09-11,Andrew Marsh,Entergy,4,4,0,8,
2025-09-11,Robert Berkley,WR Berkley,8,28,4,40,
2025-09-11,Javier Rodriguez,DaVita,15,13,1,29,
2025-09-11,Michael OGrady,Northern Trust,3,3,0,6,
2025-09-11,James Snee,Hormel Foods,2,26,1,29,
2025-09-11,Timothy J Donahue,Crown Holdings,3,10,0,13,
2025-09-11,Joseph Ferraro,Avis Budget,3,6,1,10,
2025-09-11,Niraj Shah,Wayfair,7,25,8,40,
2025-09-11,Jos√© Mas,MasTec,7,13,1,21,
2025-09-11,Joseph Nolan,Eversource Energy,5,4,1,10,
2025-09-11,Thomas Palmer,Newmont,5,4,0,9,
2025-09-11,Robert Sanchez,Ryder System,9,9,1,19,
2025-09-11,Michael Nolan,Fidelity National Financial,4,0,0,4,
2025-09-11,Gavin Hattersley,Molson Coors Beverage,5,29,6,40,
2025-09-11,Thomas Reeg,Caesars Entertainment,4,6,0,10,
2025-09-11,Ellen Cooper,Lincoln National,2,7,0,9,
2025-09-11,Bracken Darrell,VF Corporation,8,29,3,40,
2025-09-11,Erik Fyrwald,International Flavors & Fragrances,6,10,4,20,
2025-09-11,Christopher Kastner,Huntington Ingalls Industries,3,4,0,7,
2025-09-11,Shane OKelly,Advance Auto Parts,0,6,0,6,
2025-09-11,Ralph LaRossa,Public Service Enterprise Group,13,17,0,30,
2025-09-11,Kecia Steelman,Ulta Beauty,36,3,1,40,
2025-09-11,Michele Buck,Hershey,6,32,2,40,
2025-09-11,Sumit Singh,Chewy,12,24,4,40,
2025-09-11,Steven Vondran,American Tower,4,6,0,10,
2025-09-11,Jeffrey Lorberbaum,Mohawk Industries,11,6,1,18,
2025-09-11,Keith Demmings,Assurant,5,8,0,13,
2025-09-11,Robert Martin,Thor Industries,4,5,1,10,
2025-09-11,Kathleen Mazzarella,Graybar Electric,1,6,1,8,
2025-09-11,Joey Wat,Yum China,13,24,3,40,
2025-09-11,Scott Richardson,Celanese,8,22,4,34,
2025-09-11,David Rawlinson II,QVC,8,13,2,23,
2025-09-11,Alan Armstrong,Williams,26,11,3,40,
2025-09-11,Philippe Krakowsky,Interpublic Group,13,24,3,40,
2025-09-11,Brendan McCracken,Ovintiv,6,5,0,11,
2025-09-11,Andrew Teno,Icahn Enterprises,5,5,0,10,
2025-09-11,Stephen Steinour,Huntington Bancshares,2,8,0,10,
2025-09-11,Timothy NeCastro,Erie Insurance,3,7,0,10,
2025-09-11,Ernest Garcia III,Carvana,24,12,4,40,
2025-09-11,R Bruce McDonald,Dana Incorporated,3,7,1,11,
2025-09-11,William Oplinger,Alcoa Corporation,1,8,1,10,
2025-09-11,Mark Pearson,Equitable,7,8,0,15,
2025-09-11,Richard Wallace,KLA,1,3,0,4,
2025-09-11,Ricardo Cardenas,Darden Restaurants,4,2,1,7,
2025-09-11,Mikael Bratt,Autoliv,5,8,2,15,
2025-09-11,Benito Minicucci,Alaska Air,1,4,0,5,
2025-09-11,Christopher Gorman,KeyCorp,5,5,0,10,
2025-09-11,Robert Goldstein,Las Vegas Sands,4,31,5,40,
2025-09-11,Edward Pesicka,Owens & Minor,3,31,2,36,
2025-09-11,Christopher Nassetta,Hilton Worldwide,8,16,2,26,
2025-09-11,Jamie Iannone,Ebay,18,20,2,40,
2025-09-11,Patrick Gallagher,Arthur J Gallagher,9,30,1,40,
2025-09-11,Rich Steinmeier,LPL Financial,23,15,2,40,
2025-09-11,Stephen Spray,Cincinnati Financial,1,7,1,9,
2025-09-11,Douglas Yearley,Toll Brothers,11,24,5,40,
2025-09-11,Gregory Brown,Motorola Solutions,1,8,1,10,
2025-09-11,Brian Chesky,Airbnb,2,30,8,40,
2025-09-11,Jeffrey Sprecher,Intercontinental Exchange,15,21,4,40,
2025-09-11,Robert Thomson,News Corp,5,32,3,40,
2025-09-11,Scott Boatwright,Chipotle Mexican Grill,10,27,3,40,
2025-09-11,Reshma Kewalramani,Vertex Pharmaceuticals,21,14,5,40,
2025-09-11,Christopher Viehbacher,Biogen,0,24,2,26,
2025-09-11,Malcolm Wilson,GXO Logistics,6,21,0,27,
2025-09-11,Tony Sarsam,SpartanNash,17,21,2,40,
2025-09-11,Michael O‚ÄôSullivan,Burlington Stores,8,28,4,40,
2025-09-11,Teresa Rasmussen,Thrivent Financial for Lutherans,3,2,0,5,
2025-09-11,Eugene Bredow,NVR,0,4,1,5,
2025-09-11,Brian Chambers,Owens Corning,2,12,0,14,
2025-09-11,Rafael Santana,Westinghouse Air Brake Technologies,3,8,1,12,
2025-09-11,John Pfeifer,Oshkosh Corporation,3,17,0,20,
2025-09-11,Cameron Bready,Global Payments,7,30,3,40,
2025-09-11,Calvin McDonald,Lululemon athletica,8,31,1,40,
2025-09-11,J Kent Masters,Albemarle Corporation,4,5,0,9,
2025-09-11,Joanna Geraghty,JetBlue Airways,15,17,8,40,
2025-09-11,Robert Steer,Seaboard,1,4,0,5,
2025-09-11,William Newlands,Constellation Brands,0,3,2,5,
2025-09-11,Michael Doss,Graphic Packaging,4,8,1,13,
2025-09-11,Gil West,Hertz,6,26,8,40,
2025-09-11,Malcolm C Roberts,FM Global,2,9,2,13,
2025-09-11,Mick Beekhuizen,Campbell Soup,8,21,0,29,
2025-09-11,Daniel Wall,Expeditors International of Washington,2,4,0,6,
2025-09-11,Gregory Roberts,A-Mark Precious Metals,1,4,1,6,
2025-09-11,Horacio Rozanski,Booz Allen Hamilton,16,19,5,40,
2025-09-11,James Davis,Quest Diagnostics,5,4,1,10,
2025-09-11,Dennis Mathew,Altice,4,27,8,39,
2025-09-11,Stefan Larsson,PVH,11,24,5,40,
2025-09-11,Mark Costa,Eastman Chemical,4,14,4,22,
2025-09-11,Joyce Mullen,Insight Enterprises,5,11,0,16,
2025-09-11,John Turner,Regions Financial,21,17,2,40,
2025-09-11,Julian G Francis,Beacon Roofing Supply,0,1,0,1,
2025-09-11,Blake Moret,Rockwell Automation,11,27,2,40,
2025-09-11,Mike Speetzen,Polaris Inc,3,18,2,23,
2025-09-11,William McDermott,ServiceNow,4,5,0,9,
2025-09-11,Jure Sola,Sanmina,3,11,1,15,
2025-09-11,Bob Flexon,UGI Utilities Inc,0,1,0,1,
2025-09-11,Scott Lauber,WEC Energy,14,6,0,20,
2025-09-11,Jon Rousseau,BrightSpring Health Services,21,18,1,40,
2025-09-11,Todd Schneider,Cintas,12,18,1,31,
2025-09-11,Peter Matt,Commercial Metals,5,4,0,9,
2025-09-11,Robert D Lawler,Continental Resources,0,0,0,0,
2025-09-11,Domenic Dell‚ÄôOsso Jr,Expand Energy,4,0,0,4,
2025-09-11,Jason P Wells,CenterPoint Energy,9,4,1,14,
2025-09-11,H Michael Krimbill,NGL Energy Partners,8,1,0,9,
2025-09-11,Tony Xu,DoorDash,18,15,7,40,
2025-09-11,Clay Williams,NOV,7,20,4,31,
2025-09-11,Kristin Peck,Zoetis,12,20,1,33,
2025-09-11,Mark Smucker,JM Smucker,13,21,6,40,
2025-09-11,Steve Sanghi,Microchip Technology,8,28,4,40,
2025-09-11,Richard Tobin,Dover Corporation,3,3,0,6,
2025-09-11,Kaes Van‚Äôt Hof,Diamondback Energy,22,14,3,39,
2025-09-11,Deon Stander,Avery Dennison,0,13,0,13,
2025-09-11,Vincent Sorgi,PPL,8,9,1,18,
2025-09-11,Hassane El-Khoury,ON Semiconductor,2,19,5,26,
2025-09-11,Arie Kotler,ARKO,5,23,0,28,
2025-09-11,William Monteleone,Par Pacific,1,7,2,10,
2025-09-11,John Christmann IV,APA,5,4,1,10,
2025-09-11,Adaire Fox-Martin,Equinix,15,22,3,40,
2025-09-11,Joseph M Otting,Flagstar Financial,2,5,2,9,
2025-09-11,Mary Dillon,Foot Locker,11,25,4,40,
2025-09-11,James Zallie,Ingredion,3,7,0,10,
2025-09-11,Christopher Peterson,Newell Brands,1,8,1,10,
2025-09-11,Scott Salmirs,ABM Industries,6,5,1,12,
2025-09-11,Christopher Hilger,Securian Financial,0,6,0,6,
2025-09-11,Hamid Moghadam,Prologis,7,28,5,40,
2025-09-11,Stephen Schwarzman,Blackstone,12,22,5,39,
2025-09-11,Robert Greenberg,Skechers USA,5,23,3,31,
2025-09-11,Keith Allman,Masco,4,9,1,14,
2025-09-11,Rusty Rush,Rush Enterprises,15,22,3,40,
2025-09-11,Jennifer Johnson,Franklin Resources,1,7,2,10,
2025-09-11,Gerry P Smith,ODP Business Solutions,0,1,0,1,
2025-09-11,Carl Lindner lll,American Financial,0,0,0,0,
2025-09-11,Mark Kowlzan,Packaging Corp of America,0,8,1,9,
2025-09-11,Thomas Hill,Vulcan Materials,4,7,2,13,
2025-09-11,Milan Galik,Interactive Brokers,7,16,2,25,
2025-09-11,Laura Alber,Williams-Sonoma,16,20,4,40,
2025-09-11,Mario Harik,XPO,7,32,1,40,
2025-09-11,Devin Stockfish,Weyerhaeuser,5,5,0,10,
2025-09-11,Thomas J McInerney,Genworth Financial,1,6,0,7,
2025-09-11,Garrick Rochow,CMS Energy,11,3,1,15,
2025-09-11,Toni Townes-Whitley,Science Applications International,12,20,1,33,
2025-09-11,Rich Handler,Jefferies Financial,12,10,2,24,
2025-09-11,Daniel Heaf,Bath & Body Works,11,27,2,40,
2025-09-11,Andrew Wilson,Electronic Arts,12,18,10,40,
2025-09-11,Sheryl Palmer,Taylor Morrison Home,8,11,1,20,
2025-09-11,Ivan Tornos,Zimmer Biomet,8,31,1,40,
2025-09-11,Linda Rendle,Clorox,2,34,2,38,
2025-09-11,Matthew Pine,Xylem Inc,1,9,1,11,
2025-09-11,Heather Lavallee,Voya Financial,7,11,2,20,
2025-09-11,Daniel Florness,Fastenal,4,4,2,10,
2025-09-11,Albert Nahmad,Watsco,2,7,0,9,
2025-09-11,Carl Eschenbach,Workday,11,21,8,40,
2025-09-11,Craig Smiddy,Old Republic International,3,5,1,9,
2025-09-11,Frank C Sullivan,RPM International,3,8,1,12,
2025-09-11,Matthew Missad,UFP Industries,7,3,0,10,
2025-09-11,Martin J Lyons,Ameren,2,4,1,7,
2025-09-11,Adam W Miller,Knight Swift Transportation,0,2,1,3,
2025-09-11,Rodney Sacks,Monster Beverage,12,26,1,39,
2025-09-11,Gary Guthart,Intuitive Surgical,13,23,4,40,
2025-09-11,Charles Liang,Super Micro Computer,35,4,1,40,
2025-09-11,Christopher Caldwell,Concentrix,3,5,0,8,
2025-09-11,Gordon J Hardie,O-I Glass,0,6,0,6,
2025-09-11,David Gibbs,Yum Brands,2,38,0,40,
2025-09-11,Steve Henry,Domtar,4,5,0,9,
2025-09-11,Chuck Treadway,CommScope,8,21,3,32,
2025-09-11,Rob Vitale,Post Holdings,1,12,4,17,
2025-09-11,Steven J Moskowitz,Crown Castle,3,4,3,10,
2025-09-11,Emmanuel Ligner,Avantor,2,11,1,14,
2025-09-11,Stuart Bradie,KBR,11,14,4,29,
2025-09-11,Carrie Wheeler,Opendoor Technologies,11,26,3,40,
2025-09-11,Russell Becker,APi Group,3,5,0,8,
2025-09-11,Toby Rice,EQT,23,14,3,40,
2025-09-11,Jesse Arenivas,EnLink Midstream,8,8,0,16,
2025-09-11,Nikesh Arora,Palo Alto Networks,6,25,9,40,
2025-09-11,Steven Bandrowczak,Xerox,1,8,1,10,
2025-09-11,Vicente Reynal,Ingersoll Rand,7,28,0,35,
2025-09-11,William T Dillard II,Dillards,3,3,2,8,
2025-09-11,C Howard Nye,Martin Marietta Materials,1,5,4,10,
2025-09-11,Giordano Albertazzi,Vertiv,15,19,4,38,
2025-09-11,Stephane Bancel,Moderna,10,23,7,40,
2025-09-11,Nate R Jorgensen,Boise Cascade,0,0,0,0,
2025-09-11,Jack Sinclair,Sprouts Farmers Market,18,22,0,40,
2025-09-11,Padraig McDonnell,Agilent Technologies,12,10,0,22,
2025-09-11,Kenneth T Lane,Olin,0,1,0,1,
2025-09-11,Randall C Stuewe,Darling Ingredients,27,1,0,28,
2025-09-11,R Howard Coker,Sonoco Products,2,7,1,10,
2025-09-11,John Mengucci,CACI International,21,18,1,40,
2025-09-11,Mark Witkowski,Core & Main,2,13,1,16,
2025-09-11,Lee M Tillman,Marathon Oil,5,5,0,10,
2025-09-11,Mark Hoplamazian,Hyatt Hotels,15,20,5,40,
2025-09-11,David S Chernow,Select Medical,0,9,0,9,
2025-09-11,Brendan M Foley,McCormick & Company,0,9,0,9,
2025-09-11,Joanne Crevoiserat,Tapestry,12,24,4,40,
2025-09-11,John Plant,Howmet Aerospace,5,12,3,20,
2025-09-11,Shankh Mitra,Welltower,16,22,2,40,
2025-09-11,W Anthony Will,CF Industries,3,4,0,7,
2025-09-11,David A Zapico,Ametek,3,17,1,21,
2025-09-11,Kevin Stein,TransDigm,10,9,1,20,
2025-09-11,Craig Billings,Wynn Resorts,13,25,2,40,
2025-09-11,William J Way,Southwestern Energy,2,0,0,2,
2025-09-11,Giel Rutten,Amkor Technology,3,7,1,11,
2025-09-11,Paul Sarvadi,Insperity,4,5,0,9,
2025-09-11,Donald Zurbay,Patterson Companies Inc,1,3,0,4,
2025-09-11,Rob Sharps,T Rowe Price,13,22,5,40,
2025-09-11,Patrice Louvet,Ralph Lauren,14,17,9,40,
2025-09-11,Jeffrey Mezger,KB Home,2,31,7,40,
2025-09-11,David M Foulkes,Brunswick,1,8,0,9,
2025-09-11,M Keith Waddell,Robert Half,3,7,0,10,
2025-09-11,Jay Snowden,PENN Entertainment,18,19,3,40,
2025-09-11,George Kurian,NetApp,15,22,3,40,
2025-09-11,Kevin Ali,Organon,8,17,2,27,
2025-09-11,Joel D Anderson,Petco Health and Wellness,3,9,0,12,
2025-09-11,Louis V Pinkham,Regal Rexnord,0,1,0,1,
2025-09-11,Jay Geldmacher,Resideo Technologies,9,6,0,15,
2025-09-11,Marcus Lemonis,Camping World,10,21,9,40,
2025-09-11,Peter R Huntsman,Huntsman,7,11,3,21,
2025-09-11,Hillary Super,Victorias Secret,10,5,8,23,
2025-09-11,Michelle Gass,Levi Strauss,12,25,2,39,
2025-09-11,Neil Hunn,Roper Technologies,2,18,0,20,
2025-09-11,Steven P Lawrence,Academy Sports and Outdoors,1,1,0,2,
2025-09-11,Phillippe Lord,Meritage Homes,8,14,0,22,
2025-09-11,David C Dauch,American Axle & Manufacturing,5,6,2,13,
2025-09-11,Olumide Soroye,Fortive,1,9,0,10,
2025-09-11,Adena Friedman,Nasdaq,15,21,4,40,
2025-09-11,Tim Gokey,Broadridge Financial Solutions,5,12,1,18,
2025-09-11,Patrick M Shanahan,Spirit AeroSystems,1,9,0,10,
2025-09-11,Robert Kyncl,Warner Music Group,10,29,1,40,
2025-09-11,Denise Dignam,Chemours,3,19,2,24,
2025-09-11,Jim DeVries,ADT,10,7,1,18,
2025-09-11,Bernard Zovighian,Edwards Lifesciences,6,7,2,15,
2025-09-11,Mark E Seaton,First American Financial,1,8,0,9,
2025-09-11,John C Roche,Hanover Insurance Group,8,16,1,25,
2025-09-11,Adam J Greenlee,Silgan,0,6,0,6,
2025-09-11,Jayne Hrdlicka,Endeavor Group,0,1,0,1,
2025-09-11,Robert Fauber,Moodys Corporation,0,6,0,6,
2025-09-11,Thomas E Jorden,Coterra Energy,9,0,0,9,
2025-09-11,Eugene A Hall,Gartner,1,8,0,9,
2025-09-11,Kevin Plank,Under Armour,8,28,3,39,
2025-09-11,James W Lanning,Ingles Markets,3,3,0,6,
2025-09-11,Matthew T Farrell,Church & Dwight,7,7,0,14,
2025-09-11,Kevin M Freeman,Old Dominion Freight Line,0,0,0,0,
2025-09-11,Joe Shoen,U-Haul,15,20,4,39,
2025-09-11,Mark Bertolini,Oscar Health,13,18,9,40,
2025-09-11,Jayshree Ullal,Arista Networks,18,21,1,40,
2025-09-11,Sassine Ghazi,Synopsys,11,25,4,40,
2025-09-11,Jochen Zeitz,Harley-Davidson,6,23,11,40,
2025-09-11,Nick Jeffery,Frontier Communications,10,26,1,37,
2025-09-11,Thomas Edward McCormick,Primoris Services,0,4,0,4,
2025-09-11,D Christian Koch,Carlisle Companies,1,4,0,5,
2025-09-11,David E Simon,Simon Property Group,3,6,1,10,
2025-09-11,Stephen Bratspies,Hanesbrands,2,11,1,14,
2025-09-11,Ryan M. Schneider,Anywhere Real Estate Inc,0,0,0,0,
2025-09-11,George Bobb III,Teledyne Technologies,1,4,0,5,
2025-09-11,Terrence A Duffy,CME Group,6,8,1,15,
2025-09-11,Rami Rahim,Juniper Networks,11,26,3,40,
2025-09-11,Sue Nabi,Coty,15,18,7,40,
2025-09-11,Peter D Arvan,Pool Corporation,3,6,0,9,
2025-09-11,David Campbell,Evergy,15,9,0,24,
2025-09-11,Matthew J Murphy,Marvell Technology,2,7,1,10,
2025-09-11,Lloyd Yates,NiSource,6,4,0,10,
2025-09-11,William C Stone,SS&C Technologies,2,6,0,8,
2025-09-11,Mark Rourke,Schneider National,10,18,1,29,
2025-09-11,Andrew Anagnost,Autodesk,10,24,6,40,
2025-09-11,Dustin Semach,Sealed Air Corporation,0,9,0,9,
2025-09-11,William L Meaney,Iron Mountain,3,17,0,20,
2025-09-11,Andy P Power,Digital Realty Trust,0,0,0,0,
2025-09-11,Satish Dhanasekaran,Keysight Technologies,3,10,0,13,
2025-09-11,Frank M Svoboda,Globe Life,3,5,2,10,
2025-09-11,Carey A Smith,Parsons Corporation,0,2,0,2,
2025-09-11,Ynon Kreiz,Mattel,8,25,7,40,
2025-09-11,Karen S Haller,Southwest Gas,2,7,0,9,
2025-09-11,Terrance Williams,TruStage,4,5,1,10,
2025-09-11,Eric W Gerstenberg,Clean Harbors,5,1,1,7,
2025-09-11,Gunner Smith,Cornerstone Building Brands,1,8,1,10,
2025-09-11,Gerben W Bakker,Hubbell,1,4,0,5,
2025-09-11,Dave Davis,Spirit Airlines,6,23,1,30,
2025-09-11,Michael J Smith,Lamb Weston,0,7,3,10,
2025-09-11,Strauss Zelnick,Take-Two Interactive Software,14,18,8,40,
2025-09-11,John C Turner Jr,GMS,2,7,0,9,
2025-09-11,David M OMalley,Penn Mutual Life Insurance,0,1,0,1,
2025-09-11,Frank A Lonegro,Landstar System,1,4,0,5,
2025-09-11,James F Risoleo,Host Hotels & Resorts,5,16,0,21,
2025-09-11,Ken Xie,Fortinet,12,18,8,38,
2025-09-11,Doug Shulman,OneMain,4,6,0,10,
2025-09-11,Ryan Cohen,GameStop,13,20,7,40,
2025-09-11,Mark W Begor,Equifax,3,14,0,17,
2025-09-11,Jay L Schottenstein,American Eagle Outfitters,9,18,1,28,
2025-09-11,Curtis C Farmer,Comerica,4,9,0,13,
2025-09-11,Ole Rosgaard,Greif,2,15,1,18,
2025-09-11,Brian E Lane,Comfort Systems USA,10,0,0,10,
2025-09-11,Robert M Buck,TopBuild,5,5,0,10,
2025-09-11,Ralph Andretta,Bread Financial,3,9,0,12,
2025-09-11,Jim Anderson,Coherent,6,34,0,40,
2025-09-11,Walter C. D. Carlson,Telephone & Data Systems,0,3,0,3,
2025-09-11,Ronald Kruszewski,Stifel Financial,7,3,0,10,
2025-09-11,Richard Hayne,Urban Outfitters,12,20,8,40,
2025-09-11,Simon Meester,Terex,3,7,0,10,
2025-09-11,Edward J Lehner,Ryerson Holding,0,2,0,2,
2025-09-11,Nicholas T Pinchuk,Snap-on,3,6,0,9,
2025-09-11,Ryals McMullian,Flowers Foods,5,31,3,39,
2025-09-11,D Bryan Jordan,First Horizon,3,8,1,12,
2025-09-11,John B Gibson,Paychex,5,5,0,10,
2025-09-11,Chris Cocks,Hasbro,11,19,10,40,
2025-09-11,Pete McPartland,Sentry Insurance Group,0,2,0,2,
2025-09-11,Michael Arougheti,Ares Management,17,22,1,40,
2025-09-11,Alok Maskara,Lennox International,5,3,1,9,
2025-09-11,James C Grech,Peabody Energy,3,0,0,3,
2025-09-11,Joseph P Lacher Jr,Kemper,4,19,4,27,
2025-09-11,Perry A Sook,Nexstar Media Group,8,25,1,34,
2025-09-11,Wade Davis,TelevisaUnivision,14,25,1,40,
2025-09-11,Scott L Thompson,Tempur Sealy International,0,7,0,7,
2025-09-11,Mike Simonds,TriNet Group,0,9,0,9,
2025-09-11,B Andrew Rose,Worthington Enterprises,0,1,0,1,
2025-09-11,Bruce L Caswell,Maximus,3,4,0,7,
2025-09-11,Robert L Reffkin,Compass,1,7,0,8,
2025-09-11,Mark Eubanks,Brinks Company,1,2,1,4,
2025-09-11,Peter Quigley,Kelly Services inc,1,9,0,10,
2025-09-11,David L Yowan,Navient,1,1,0,2,
2025-09-11,Mary E Kipp,Puget Sound Energy,4,1,2,7,
2025-09-11,Adam Aron,AMC Entertainment,16,19,5,40,
2025-09-11,Mark J Tarr,Encompass Health,2,5,1,8,
2025-09-11,Liam K Griffin,Skyworks Solutions,1,8,0,9,
2025-09-11,Richard G Kyle,Timken,2,13,1,16,
2025-09-11,Ron Gusek,Liberty Energy,23,1,0,24,
2025-09-11,John E Geller Jr,Marriott Vacations Worldwide,6,6,0,12,
2025-09-11,Karl G. Glassman,Leggett & Platt,0,4,0,4,
2025-09-11,Bruce K Thorn,Big Lots,3,5,2,10,
2025-09-11,Jonathan H Weis,Weis Markets,11,28,0,39,
2025-09-11,Jeffrey B Guldner,Pinnacle West Capital,1,3,0,4,
2025-09-11,Arkadiy Dobkin,EPAM Systems,11,14,1,26,
2025-09-11,Paul M Rady,Antero Resources,4,8,0,12,
2025-09-11,Michael Spanos,Bloomin Brands,1,8,1,10,
2025-09-11,Nicole A Kivisto,MDU Resources Group,4,3,0,7,
2025-09-11,Gerald L Morgan,Texas Roadhouse,3,2,5,10,
2025-09-11,Gabriel Tirador,Mercury General,4,4,2,10,
2025-09-11,Nicholas I Fink,Fortune Brands Innovations,4,6,0,10,
2025-09-11,Paul E Burdiss,Zions Bancorp,1,1,0,2,
2025-09-11,William J Christensen,JELD-WEN Holding,4,5,0,9,
2025-09-11,Evan Spiegel,Snap Inc,19,17,4,40,
2025-09-11,Bill Burns,Zebra Technologies,7,23,1,31,
2025-09-11,Steven Sell,Agilon Health,0,7,0,7,
2025-09-11,Richard M Olson,Toro Company,1,10,0,11,
2025-09-11,Eric S Yuan,Zoom Video Communications,6,7,0,13,
2025-09-11,Dan L Batrack,Tetra Tech,2,5,1,8,
2025-09-11,Joseph D Russell Jr,Public Storage,0,8,0,8,
2025-09-11,Jacob Thaysen,Illumina inc,4,8,0,12,
2025-09-11,Debra A Cafaro,Ventas inc,6,7,0,13,
2025-09-11,Pierre R Brondeau,FMC Corporation,0,5,0,5,
2025-09-11,Judy R McReynolds,ArcBest,4,15,1,20,
2025-09-11,Russell J Weiner,Dominos Pizza inc,0,0,0,0,
2025-09-11,Theodore S Hanson,ASGN,0,1,0,1,
2025-09-11,RJ Scaringe,Rivian Automotive,9,28,3,40,
2025-09-11,Jeffrey N Simmons,Elanco Animal Health,2,5,1,8,
2025-09-11,Tim O Shaughnessy,Graham Holdings Company,3,7,0,10,
2025-09-11,Thomas V Taylor,Floor & Decor,1,2,1,4,
2025-09-11,Neil A Schrimsher,Applied Industrial Technologies,6,24,1,31,
2025-09-11,Robert E Price,PriceSmart,4,6,0,10,
2025-09-11,John David Risher,Lyft,4,3,1,8,
2025-09-11,Gary B Smith,Ciena,4,8,0,12,
2025-09-11,Joey Levin,IAC,7,31,1,39,
2025-09-11,Jim Jacobs,Country Financial,7,5,2,14,
2025-09-11,Devin B McGranahan,Western Union,1,5,0,6,
2025-09-11,R Scott Rowe,Flowserve,5,4,1,10,
2025-09-11,Kenneth A Vecchione,Western Alliance Bancorp,0,0,1,1,
2025-09-11,John C Rademacher,Option Care Health,5,1,0,6,
2025-09-11,Doug Black,SiteOne Landscape Supply,3,19,2,24,
2025-09-11,Oliver G Brewer III,Topgolf Callaway Brands,1,0,0,1,
2025-09-11,Glenn Sanford,eXp World,16,20,4,40,
2025-09-11,Fran Horowitz,Abercrombie & Fitch,12,21,7,40,
2025-09-11,Kevin Akers,Atmos Energy,7,3,0,10,
2025-09-11,Alessandro Maselli,Catalent,2,12,3,17,
2025-09-11,J Powell Brown,Brown & Brown,13,22,5,40,
2025-09-11,Aman Bhutani,GoDaddy,16,22,2,40,
2025-09-11,John C. Griffith,American Water Works,0,4,0,4,
2025-09-11,John J Marchioni,Selective Insurance Group,5,13,3,21,
2025-09-11,Lawson E Whiting,Brown-Forman,1,7,1,9,
2025-09-11,Dave Peacock,Advantage Solutions,22,8,0,30,
2025-09-11,Mick Farrell,ResMed,17,20,2,39,
2025-09-11,Kamal Hathi,Splunk,2,4,0,6,
2025-09-11,Todd Kelsey,Plexus,3,6,0,9,
2025-09-11,Phillip D Yeager,Hub Group,4,5,0,9,
2025-09-11,Steven B Hedlund,Lincoln Electric,4,6,0,10,
2025-09-11,Timothy C Oliver,NCR Atleos,0,1,0,1,
2025-09-11,Bruce Fleming,Calumet,3,6,0,9,
2025-09-11,Daniel S. Peyovich,Dycom Industries,0,3,0,3,
2025-09-11,Avner M Applbaum,Valmont Industries,0,8,0,8,
2025-09-11,Kimberly A Fields,ATI inc,4,10,0,14,
2025-09-11,Khozema Z Shipchandler,Twilio,0,2,1,3,
2025-09-11,Gary C Bhojwani,CNO Financial Group,1,6,1,8,
2025-09-11,William Andrew Hendricks Jr,Patterson-UTI Energy,0,0,0,0,
2025-09-11,Kevin D Hochman,Brinker International,1,3,0,4,
2025-09-11,James C Foster,Charles River Laboratories International,3,10,0,13,
2025-09-11,Rajiv K Prasad,Hyster-Yale,2,5,0,7,
2025-09-11,Eric T Steigerwalt,Brighthouse Financial,1,1,0,2,
2025-09-11,Thomas L Ryan,Service Corp International,6,4,0,10,
2025-09-11,Charles M Nifong Jr,CrossAmerica Partners,0,0,0,0,
2025-09-11,Anirudh Devgan,Cadence,10,26,2,38,
2025-09-11,Andi Owen,MillerKnoll,16,15,9,40,
2025-09-11,Sumit Roy,Realty Income,15,20,2,37,
2025-09-11,Timothy John Fitzgerald,Middleby,0,0,0,0,
2025-09-11,Robert H Schottenstein,M/I Homes,2,8,0,10,
2025-09-11,Stephen P MacMillan,Hologic,0,8,1,9,
2025-09-11,Lisa M Barton,Alliant Energy,3,0,0,3,
2025-09-11,Aaron P Jagdfeld,Generac,1,6,1,8,
2025-09-11,Erik Gershwind,MSC Industrial Direct,2,5,2,9,
2025-09-11,Varun Krishna,Rocket Companies,9,30,1,40,
2025-09-11,Fahmi Karam,Upbound Group,4,4,0,8,
2025-09-11,NADominic Ng,East West Bancorp,0,0,0,0,
2025-09-11,Mark Wang,Hilton Grand Vacations,38,2,0,40,
2025-09-11,Robert J Sheedy Jr,Grocery Outlet Holding,0,0,0,0,
2025-09-11,Simon D Campion,Dentsply Sirona,0,2,0,2,
2025-09-11,Jeremy Wensinger,V2X,6,7,0,13,
2025-09-11,Andrew Rees,Crocs,14,14,12,40,
2025-09-11,David M Maura,Spectrum Brands,5,0,0,5,
2025-09-11,Sachin S Lawande,Visteon,0,0,0,0,
2025-09-11,Neil M Ashe,Acuity Inc,0,2,0,2,
2025-09-11,Lorie L Tekorius,Greenbrier,1,9,0,10,
2025-09-11,John R Ciulla,Webster Financial,5,5,0,10,
2025-09-11,Sean D Keohane,Cabot Corporation,4,4,0,8,
2025-09-11,Drew M Wilkerson,RXO inc,0,1,0,1,
2025-09-11,Daniel E Brown,Chord Energy,1,0,0,1,
2025-09-11,Javier D Ferrer Fernandez,Popular inc,0,1,0,1,
2025-09-11,Olivier Rabiller,Garrett Motion inc,4,8,0,12,
2025-09-11,Ronald N Tutor,Tutor Perini Corporation,3,6,0,9,
2025-09-11,Jeff Liaw,Copart,4,6,0,10,
2025-09-11,Aman Narang,Toast inc,4,6,1,11,
2025-09-11,Joseph M Hogan,Align Technology,3,5,0,8,
2025-09-11,Kevin J Wheeler,A O Smith,0,19,1,20,
2025-09-11,Christopher A Cartwright,TransUnion,2,0,2,4,
2025-09-11,James Kelly,NCR Voyix,2,12,0,14,
2025-09-11,Tom Leighton,Akamai Technologies,14,14,5,33,
2025-09-11,Robert G Painter,Trimble,7,1,0,8,
2025-09-11,Tony Helton,Medical Mutual of Ohio,2,3,1,6,
2025-09-11,Caroline S Grace,AMN Healthcare Services,0,0,0,0,
2025-09-11,Patrick Kaltenbach,Mettler-Toledo International,1,9,0,10,
2025-09-11,Michael L Baur,ScanSource,0,2,0,2,
2025-09-11,Jason Lippert,LCI Industries,2,12,0,14,
2025-09-11,Fredric J Tomczyk,Cboe Global Markets,1,7,1,9,
2025-09-11,Octavio Marquez,Diebold Nixdorf,5,10,1,16,
2025-09-11,Sivasankaran Somasundaram,ChampionX,5,1,0,6,
2025-09-11,Ronald F Clarke,Corpay,0,0,0,0,
2025-09-11,Robert W Pittman,iHeartMedia,5,3,0,8,
2025-09-11,Patrick Zalupski,Dream Finders Homes,23,15,2,40,
2025-09-11,Keith E Smith,Boyd Gaming,0,6,0,6,
2025-09-11,Mehran Assadi,NLV Financial,1,1,0,2,
2025-09-11,Barry R Port,Ensign Group,2,5,2,9,
2025-09-11,Denise A Paulonis,Sally Beauty,1,1,0,2,
2025-09-11,Clifford A Skelton,Conduent,0,1,0,1,
2025-09-11,Jean-Michel Ribieras,Sylvamo,2,5,0,7,
2025-09-11,Douglas F Bauer,Tri Pointe Homes,0,6,0,6,
2025-09-11,Shawn OConnell,EnerSys,0,1,0,1,
2025-09-11,Bill Meury,Incyte,7,15,0,22,
2025-09-11,Dale Francescon,Century Communities,1,10,3,14,
2025-09-11,Michael Nierenberg,Rithm Capital,9,29,2,40,
2025-09-11,Michael J Brown,Euronet Worldwide,1,7,0,8,
2025-09-11,Scott Seu,Hawaiian Electric Industries,5,14,1,20,
2025-09-11,Jason D Robins,DraftKings,5,2,0,7,
2025-09-11,Jonathan J Mazelsky,IDEXX Laboratories,1,1,1,3,
2025-09-11,Richard S Swartz,MYR Group,0,1,0,1,
2025-09-11,Stefano Caroti,Deckers Outdoor,3,6,1,10,
2025-09-11,Kevin R Sayer,DexCom,2,3,0,5,
2025-09-11,John T C Lee,MKS Instruments,3,8,0,11,
2025-09-11,Edward B Pitoniak,VICI Properties,1,7,0,8,
2025-09-11,Albert White III,Cooper Cos,0,0,0,0,
2025-09-11,Barry L Biffle,Frontier Airlines,1,5,6,12,
2025-09-11,Robert A Bruggeworth,Qorvo,5,4,0,9,
2025-09-11,Winnie Park,Five Below,10,26,4,40,
2025-09-11,Steven Oakland,TreeHouse Foods,2,13,0,15,
2025-09-11,James S Hagedorn,Scotts Miracle-Gro,1,0,0,1,
2025-09-11,Michael Cannon-Brookes,Atlassian,17,22,0,39,
2025-09-11,Bertrand Loy,Entegris,3,10,1,14,
2025-09-11,William E Waltz,Atkore,3,6,0,9,
2025-09-11,Celeste B Mastin,H B Fuller,0,3,0,3,
2025-09-11,Kyle T Larkin,Granite Construction,1,7,0,8,
2025-09-11,Michael J Happe,Winnebago Industries,1,3,0,4,
2025-09-11,Steven H Gunby,FTI Consulting,5,11,0,16,
2025-09-11,Stephan B Tanda,AptarGroup,1,5,2,8,
2025-09-11,Timothy P Boyle,Columbia Sportswear,4,3,2,9,
2025-09-11,Anthony J Wood,Roku,5,3,1,9,
2025-09-11,M Christopher Doyle,Civitas Resources,1,2,0,3,
2025-09-11,Andy Eidson,Alpha Metallurgical Resources,0,7,2,9,
2025-09-11,Andy L Nemeth,Patrick Industries,4,3,0,7,
2025-09-11,Roger W Jenkins,Murphy Oil,4,17,0,21,
2025-09-11,Kevin S Blair,Synovus Financial,7,2,1,10,
2025-09-11,Julie Felss Masino,Cracker Barrel Old Country Store,10,17,13,40,
2025-09-11,David M Overton,Cheesecake Factory,1,9,0,10,
2025-09-11,Nick DeIuliis,CNX Resources,7,2,0,9,
2025-09-11,Christopher Pappas,Chefs Warehouse,4,10,1,15,
2025-09-11,Tod Carpenter,Donaldson Company,1,9,0,10,
2025-09-11,Gregory L Christopher,Mueller Industries,2,6,0,8,
2025-09-11,Rob Saltiel,MRC Global,5,12,1,18,
2025-09-11,Jillian C Evanko,Chart Industries,3,7,0,10,
2025-09-11,Dave Guilmette,Alight Solutions,3,7,0,10,
2025-09-11,Joel Smejkal,Vishay Intertechnology,4,5,1,10,
2025-09-11,Dennis Degner,Range Resources,3,8,0,11,
2025-09-11,Ira D Robbins,Valley National Bancorp,1,2,0,3,
2025-09-11,Bernard Kim,Match Group,15,18,7,40,
2025-09-11,Vincent Pilette,Gen Digital,3,10,0,13,
2025-09-11,Timothy S Crane,Wintrust Financial,2,6,1,9,
2025-09-11,Pat Roche,Moog inc,4,11,2,17,
2025-09-11,Mark R Widmar,First Solar,3,5,2,10,
2025-09-11,Niko Lahanas,Central Garden & Pet,2,11,0,13,
2025-09-11,Chris Osowski,Green Plains inc,4,8,1,13,
2025-09-11,Derek J Leathers,Werner Enterprises,1,7,0,8,
2025-09-11,Adam Foroughi,AppLovin,11,25,4,40,
2025-09-11,Luca Savi,ITT,2,8,0,10,
2025-09-11,Lawrence H Silber,Herc Rentals,0,0,0,0,
2025-09-11,Hilton H Howell Jr,Gray Television,7,21,1,29,
2025-09-11,Eric D Ashleman,IDEX,0,9,1,10,
2025-09-11,Owen D Thomas,Boston Properties,2,8,0,10,
2025-09-11,Kurt Wolf,Pitney Bowes,7,17,1,25,
2025-09-11,Sara E Armbruster,Steelcase,1,0,0,1,
2025-09-11,Charles D. Young,Sun Communities,2,5,0,7,
2025-09-11,Suzanne Foster,AdaptHealth,5,9,1,15,
2025-09-11,Grant E Sims,Genesis Energy,2,2,0,4,
2025-09-11,Laura Prieskorn,Jackson Financial,2,6,2,10,
2025-09-11,Rick L Wessel,FirstCash,4,5,1,10,
2025-09-11,Sherman Miller,Cal-Maine Foods,12,28,0,40,
2025-09-11,Paul A Lang,Arch Resources,5,4,0,9,
2025-09-11,Ashish K Khandpur,Avient,2,7,0,9,
2025-09-11,Shyam K Reddy,BlueLinx,1,7,0,8,
2025-09-11,Christopher S Ripley,Sinclair,1,8,0,9,
2025-09-11,Stacy Kymes,BOK Financial,8,7,0,15,
2025-09-11,James H Walter,Permian Resources,0,0,0,0,
2025-09-11,Jason Murray,PACS Group,4,14,2,20,
2025-09-11,Brian Armstrong,Coinbase Global,12,22,6,40,
2025-09-11,Oscar K Brown,Western Midstream Partners,1,2,0,3,
2025-09-11,Nicholas R Lower,Federated Mutual Insurance,0,1,0,1,
2025-09-11,Morris Goldfarb,G-III Apparel Group,9,26,5,40,
2025-09-11,Mark D Morelli,Vontier,0,3,0,3,
2025-09-11,Matthew J Cox,Matson inc,2,6,0,8,
2025-09-11,David W Grzebinski,Kirby Corporation,1,3,0,4,
2025-09-11,Keith A Harvey,Kaiser Aluminum,4,4,1,9,
2025-09-11,Eric Nyman,Vista Outdoor,3,11,1,15,
2025-09-11,Doug Howe,Designer Brands,5,20,0,25,
2025-09-11,Jerry E Gahlhoff Jr,Rollins inc,0,2,0,2,
2025-09-11,D Scott Barbour,Advanced Drainage Systems,2,2,0,4,
2025-09-11,Sean Gamble,Cinemark,16,22,2,40,
2025-09-11,George Kurtz,CrowdStrike,12,24,4,40,
2025-09-11,Bill Ready,Pinterest,24,16,0,40,
2025-09-11,Fidji Simo,Instacart,10,29,1,40,
2025-09-11,Kimberly K Ryan,Hillenbrand,3,6,0,9,
2025-09-11,David S Graziosi,Allison Transmission,1,19,3,23,
2025-09-11,Gary G Friedman,Restoration Hardware,1,4,0,5,
2025-09-11,Lucinda M Baier,Brookdale Senior Living,4,3,1,8,
2025-09-11,Brian J Blaser,QuidelOrtho,1,9,0,10,
2025-09-11,E Jean Savage,Trinity Industries,1,8,1,10,
2025-09-11,Liam J Kelly,Teleflex,1,2,0,3,
2025-09-11,Laurans A Mendelson,HEICO,7,18,1,26,
2025-09-11,Frank H Laukien,Bruker,2,7,0,9,
2025-09-11,Harvey M Schwartz,Carlyle Group,5,12,0,17,
2025-09-11,Mark S LaVigne,Energizer,3,1,0,4,
2025-09-11,Joel Quadracci,Quad/Graphics,11,24,5,40,
2025-09-11,Amar Maletira,Rackspace Technology,5,12,2,19,
2025-09-11,Udit Batra,Waters Corporation,10,24,0,34,
2025-09-11,Eric M Green,West Pharmaceutical Services,3,7,0,10,
2025-09-11,Doug Palladini,Carters inc,2,2,2,6,
2025-09-11,G Mike Mikan,NeueHealth,4,2,0,6,
2025-09-11,Russell ChipChilds,SkyWest,0,0,0,0,
2025-09-11,Christopher H Hunter,Acadia Healthcare,0,2,0,2,
2025-09-11,Prahlad Singh,Revvity,3,7,0,10,
2025-09-11,Maria M Pope,Portland General Electric,1,1,0,2,
2025-09-11,Charles Chip Blankenship,Woodward inc,0,1,0,1,
2025-09-11,Mike Steib,TEGNA,14,15,1,30,
2025-09-11,Kurt J Ekert,Sabre Corporation,0,1,0,1,
2025-09-11,Matt Wilson,Light & Wonder,19,17,4,40,
2025-09-11,Rob Katz,Vail Resorts,4,11,25,40,
2025-09-11,Schnitzer Steel Industries,Radius Recycling,6,24,5,35,
2025-09-11,David A Spector,PennyMac Financial Services,6,2,0,8,
2025-09-11,Frederick J Holzgrefe III,Saia inc,1,1,0,2,
2025-09-11,Mark J Parrell,Equity Residential,4,8,0,12,
2025-09-11,John W Lindsay,Helmerich & Payne,0,5,0,5,
2025-09-11,Gary D Burnison,Korn Ferry,4,14,0,18,
2025-09-11,Timothy J McGrath,PC Connection Inc,1,2,0,3,
2025-09-11,Lynn M Bamford,Curtiss-Wright,13,8,0,21,
2025-09-11,Jonathan W Witter,Sallie Mae,0,1,0,1,
2025-09-11,Jeff Benck,Benchmark Electronics,5,9,0,14,
2025-09-11,Charles H Giancarlo,Pure Storage,1,3,0,4,
2025-09-11,Brian R Gray,Knife River Corporation,0,1,0,1,
2025-09-11,Jay Schmidt,Caleres inc,3,5,2,10,
2025-09-11,Dale Asplund,BrightView Holdings,1,7,0,8,
2025-09-11,Jeffrey S Edwards,Cooper-Standard,0,7,0,7,
2025-09-11,Glenn J Williams,Primerica,6,2,2,10,
2025-09-11,Francois Locoh-Donou,F5,7,22,2,31,
2025-09-11,Joseph Wm Foran,Matador Resources,8,10,0,18,
2025-09-11,Sridhar Ramaswamy,Snowflake inc,10,24,4,38,
2025-09-11,Mark D Dankberg,Viasat,2,5,3,10,
2025-09-11,Francisco J Leon,California Resources,1,3,1,5,
2025-09-11,Peter Stern,Peloton,18,18,4,40,
2025-09-11,David Baszucki,Roblox,9,22,9,40,
2025-09-11,Jeffrey W Edwards,Installed Building Products,0,1,0,1,
2025-09-11,Clark Lauritzen,First National of Nebraska,1,7,0,8,
2025-09-11,Carlos Alberini,Guess inc,12,27,1,40,
2025-09-11,Shyam P Kambeyanda,ESAB,4,3,0,7,
2025-09-11,Edmund Shallcross III,Amica Mutual Insurance,0,5,0,5,
2025-09-11,Benjamin W Schall,AvalonBay Communities,1,5,1,7,
2025-09-11,Allan C Thygesen,DocuSign,3,6,0,9,
2025-09-11,Bryan J Knutson,Titan Machinery,1,1,1,3,
2025-09-11,Heath Sampson,ModivCare,6,2,1,9,
2025-09-11,Ara K Hovnanian,Hovnanian Enterprises,1,16,1,18,
2025-09-11,Joshua G Silverman,Etsy,1,2,0,3,
2025-09-11,Kevin Roycraft,Adams Resources & Energy,0,0,0,0,
2025-09-11,J Eric Evans,Surgery Partners,0,3,0,3,
2025-09-11,Clint E Stein,Columbia Banking System,1,5,0,6,
2025-09-11,Lee M Shavel,Verisk Analytics,2,7,0,9,
2025-09-11,Dave Banyard Jr,MasterBrand,0,0,0,0,
2025-09-11,Peter R Ingram,Hawaiian Airlines inc,1,0,0,1,
2025-09-11,Kristin A Dolan,AMC Networks,4,2,0,6,
2025-09-11,Brendan T Cavanagh,SBA Communications,1,2,0,3,
2025-09-11,George F Chappelle Jr,Americold Realty Trust,2,3,0,5,
2025-09-11,Thomas E Gottwald,NewMarket Corporation,2,8,0,10,
2025-09-11,Thomas J Baltimore Jr,Park Hotels & Resorts,4,30,1,35,
2025-09-11,Peter M Moglia,Alexandria Real Estate Equities,3,5,0,8,
2025-09-11,Ronald J Kramer,Griffon Corporation,1,6,0,7,
2025-09-11,John L Plueger,Air Lease,2,13,0,15,
2025-09-11,Jennifer F Scanlon,UL Solutions,1,4,0,5,
2025-09-11,Greg Smith,Teradyne,1,8,2,11,
2025-09-11,Sean Trauschke,OGE Energy,17,4,0,21,
2025-09-11,Norman D Schwartz,Bio-Rad Laboratories,0,0,0,0,
2025-09-11,Scott Doyle,Spire inc,3,6,1,10,
2025-09-11,Michael E Reed,Gannett,0,4,2,6,
2025-09-11,Cindy J Miller,Stericycle,2,4,2,8,
2025-09-11,Phillip D Green,Cullen Frost Bankers,1,3,3,7,
2025-09-11,Joseph D Margolis,Extra Space Storage,1,8,1,10,
2025-09-11,Mark A Skonieczny,REV Group,6,4,0,10,
2025-09-11,Ladd Wilks,ProFrac Holding,3,3,0,6,
2025-09-11,Sundaram Nagarajan,Nordson,0,9,1,10,
2025-09-11,Anne P Noonan,Summit Materials,0,1,0,1,
2025-09-11,Lori Flees,Valvoline inc,4,4,1,9,
2025-09-11,Scott H Baxter,Kontoor Brands,2,1,0,3,
2025-09-11,Tim Larson,Skyline Champion,8,0,0,8,
2025-09-11,Chuck Divita,Teladoc Health,11,19,5,35,
2025-09-11,W Bradley Southern,Louisiana-Pacific Corporation,0,0,0,0,
2025-09-11,George C Freeman III,Universal Corporation,2,6,0,8,
2025-09-11,James A Brock,Consol Energy,1,0,0,1,
2025-09-11,Robert Antokol,Playtika Holding,1,7,1,9,
2025-09-11,Joe Craft,Alliance Resource Partners,6,10,2,18,
2025-09-11,Paul Keel,Envista,2,6,1,9,
2025-09-11,Jared Isaacman,Shift4 Payments,5,29,6,40,
2025-09-11,Mark Mac McFarland,Talen Energy,3,1,1,5,
2025-09-11,Tony R Thene,Carpenter Technology,1,9,0,10,
2025-09-11,Melissa D Smith,WEX,1,6,1,8,
2025-09-11,James Jim C Ryan III,Old National Bancorp,1,0,0,1,
2025-09-11,Peter J Federico,AGNC Investment,1,0,0,1,
2025-09-11,Brent L Yeagy,Wabash National,0,1,0,1,
2025-09-11,Henry A Fernandez,MSCI,2,16,0,18,
2025-09-11,Mark Penn,Stagwell,11,24,5,40,
2025-09-11,Julie Schertell,Mativ,0,0,0,0,
2025-09-11,Ashish Chand,Belden,2,6,1,9,
2025-09-11,Greg Anderson,Allegiant Travel Company,5,8,0,13,
2025-09-11,Drew Houston,Dropbox,15,18,7,40,
2025-09-11,Kevin T Conroy,Exact Sciences,2,5,2,9,
2025-09-11,Rex D Geveden,BWX Technologies,3,7,0,10,
2025-09-11,Scott R Wells,Clear Channel Outdoor Hldgs,0,0,0,0,
2025-09-11,Paul Bay,Ingram Micro,10,25,5,40,
2025-09-12,Doug McMillon,Walmart,17,17,6,40,
2025-09-12,Andrew Jassy,Amazon,3,31,6,40,
2025-09-12,Tim Cook,Apple,9,28,3,40,
2025-09-12,Stephen Hemsley,UnitedHealth,8,28,4,40,
2025-09-12,Warren Buffett,Berkshire Hathaway,12,19,9,40,
2025-09-12,David Joyner,CVS Health,6,29,5,40,
2025-09-12,Darren Woods,Exxon Mobil,10,23,6,39,
2025-09-12,Sundar Pichai,Alphabet,17,17,6,40,
2025-09-12,Brian Tyler,McKesson,5,14,5,24,
2025-09-12,Robert Mauch,Cencora,3,7,0,10,
2025-09-12,Ron Vachris,Costco,6,31,3,40,
2025-09-12,Jamie Dimon,JPMorgan Chase,5,22,13,40,
2025-09-12,Satya Nadella,Microsoft,18,17,4,39,
2025-09-12,Jason Hollar,Cardinal Health,14,22,4,40,
2025-09-12,Mike Wirth,Chevron,17,15,8,40,
2025-09-12,David Cordani,Cigna,20,16,4,40,
2025-09-12,Jim Farley,Ford Motor,16,16,8,40,
2025-09-12,Brian Moynihan,Bank of America,7,29,4,40,
2025-09-12,Mary Barra,General Motors,14,22,4,40,
2025-09-12,Gail Boudreaux,Elevance Health,16,16,8,40,
2025-09-12,Jane Fraser,Citigroup,13,23,4,40,
2025-09-12,Sarah London,Centene,13,18,9,40,
2025-09-12,Ted Decker,Home Depot,11,25,4,40,
2025-09-12,Maryann Mannen,Marathon Petroleum,8,14,1,23,
2025-09-12,Ron Sargent,Kroger,5,22,13,40,
2025-09-12,Mark Lashier,Phillips 66,11,20,7,38,
2025-09-12,Priscilla Almodovar,Fannie Mae,0,0,0,0,
2025-09-12,Tim Wentworth,Walgreens,8,23,9,40,
2025-09-12,Lane Riggs,Valero Energy,14,8,0,22,
2025-09-12,Mark Zuckerberg,Meta,5,19,16,40,
2025-09-12,Hans Vestberg,Verizon,18,18,4,40,
2025-09-12,John Stankey,AT&T,9,25,6,40,
2025-09-12,Brian Roberts,Comcast,10,28,2,40,
2025-09-12,Charles Scharf,Wells Fargo,27,6,7,40,
2025-09-12,David Solomon,Goldman Sachs,6,19,14,39,
2025-09-12,Michael Hutchins,Freddie Mac,2,10,3,15,
2025-09-12,Michael Fiddelke,Target,10,21,9,40,
2025-09-12,Jim Rechtin,Humana,21,15,4,40,
2025-09-12,Jon Farney,State Farm Insurance,1,13,3,17,
2025-09-12,Elon Musk,Tesla,13,16,11,40,
2025-09-12,Ted Pick,Morgan Stanley,18,19,3,40,
2025-09-12,Joaquin Duato,Johnson & Johnson,12,24,4,40,
2025-09-12,Juan Luciano,Archer Daniels Midland,4,20,14,38,
2025-09-12,Ramon Laguarta,PepsiCo,8,27,5,40,
2025-09-12,Carol Tom√©,UPS,5,24,11,40,
2025-09-12,Rajesh Subramaniam,FedEx,10,27,0,37,
2025-09-12,Bob Iger,Walt Disney,10,28,2,40,
2025-09-12,Michael Dell,Dell Technologies,10,25,5,40,
2025-09-12,Marvin Ellison,Lowes,13,26,1,40,
2025-09-12,Jon Moeller,Procter & Gamble,4,28,8,40,
2025-09-12,Thomas Long,Energy Transfer,9,0,1,10,
2025-09-12,Kelly Ortberg,Boeing,10,26,4,40,
2025-09-12,Susan Morris,Albertsons,14,23,3,40,
2025-09-12,Kevin Hourican,Sysco,9,27,4,40,
2025-09-12,Christopher Calio,RTX,6,11,0,17,
2025-09-12,Larry Culp,General Electric,10,27,3,40,
2025-09-12,James Taiclet,Lockheed Martin,14,18,8,40,
2025-09-12,Stephen Squeri,American Express,14,25,1,40,
2025-09-12,Joe Creed,Caterpillar,10,27,3,40,
2025-09-12,Michel Khalaf,MetLife,11,17,0,28,
2025-09-12,Samuel Hazen,HCA Healthcare,8,5,0,13,
2025-09-12,Tricia Griffith,Progressive Insurance,9,26,5,40,
2025-09-12,Arvind Krishna,IBM,12,22,6,40,
2025-09-12,John May,Deere,8,25,7,40,
2025-09-12,Jensen Huang,Nvidia,13,24,3,40,
2025-09-12,Philip Smith,StoneX,0,9,0,9,
2025-09-12,Robert M Davis,Merck,5,19,0,24,
2025-09-12,Ryan Lance,ConocoPhillips,14,22,4,40,
2025-09-12,Albert Bourla,Pfizer,26,10,4,40,
2025-09-12,Ed Bastian,Delta Air Lines,13,17,10,40,
2025-09-12,Patrick Zammit,TD Synnex,9,13,0,22,
2025-09-12,Kevin Murphy,Publix Super Markets,11,19,1,31,
2025-09-12,Thomas J Wilson,Allstate,1,8,1,10,
2025-09-12,Chuck Robbins,Cisco Systems,11,25,4,40,
2025-09-12,Kirt Walker,Nationwide Insurance,4,6,0,10,
2025-09-12,Christopher Winfrey,Charter Communications,5,13,5,23,
2025-09-12,Bob Michael,AbbVie,0,0,0,0,
2025-09-12,Craig DeSanto,New York Life Insurance,2,20,0,22,
2025-09-12,Lip-Bu Tan,Intel,6,27,7,40,
2025-09-12,Ernie Herrman,TJX,16,22,2,40,
2025-09-12,Andrew Sullivan,Prudential Financial,13,19,0,32,
2025-09-12,Enrique Lores,Hewlett Packard,9,18,6,33,
2025-09-12,Scott Kirby,United Airlines,30,6,4,40,
2025-09-12,George Holm,Performance Food,8,21,2,31,
2025-09-12,Donnie King,Tyson Foods,9,26,5,40,
2025-09-12,Robert Isom,American Airlines,8,24,8,40,
2025-09-12,Timothy M Sweeney,Liberty Mutual Insurance,12,0,0,12,
2025-09-12,Elliott Hill,Nike,12,25,3,40,
2025-09-12,Safra Catz,Oracle,23,14,3,40,
2025-09-12,AJ Jim Teague,Enterprise Products Partners,5,14,0,19,
2025-09-12,Richard Fairbank,Capital One,16,22,2,40,
2025-09-12,Willie Chiang,Plains GP,3,6,1,10,
2025-09-12,Michael Kasbar,World Kinect,2,9,0,11,
2025-09-12,Peter Zaffino,American International Group,8,27,5,40,
2025-09-12,James Quincey,The Coca-Cola Company,10,27,3,40,
2025-09-12,Thasunda Brown Duckett,TIAA,20,19,1,40,
2025-09-12,Jay Debertin,CHS,5,11,4,20,
2025-09-12,Chris Boerner,Bristol-Myers Squibb,9,25,6,40,
2025-09-12,Corie Barry,Best Buy,39,1,0,40,
2025-09-12,Marc Casper,Thermo Fisher Scientific,15,22,3,40,
2025-09-12,Roger Crandall,Mass Mutual,2,8,0,10,
2025-09-12,Juan Andrade,USAA,5,18,0,23,
2025-09-12,Phebe Novakovic,General Dynamics,29,8,3,40,
2025-09-12,Alan Schnitzer,Travelers Insurance,2,4,2,8,
2025-09-12,David Zaslav,Warner Bros Discovery,3,35,2,40,
2025-09-12,Gunjan Kedia,US Bancorp,15,23,2,40,
2025-09-12,Robert Ford,Abbott Laboratories,13,21,6,40,
2025-09-12,Kathy Warden,Northrop Grumman,14,22,4,40,
2025-09-12,Tim Gerend,Northwestern Mutual,14,25,1,40,
2025-09-12,Todd Vasos,Dollar General,7,26,7,40,
2025-09-12,Matthew Lucey,PBF Energy,7,2,0,9,
2025-09-12,Dara Khosrowshahi,Uber,13,22,5,40,
2025-09-12,Vimal Kapur,Honeywell,11,29,0,40,
2025-09-12,Dirk Van de Put,Mondelez,9,28,3,40,
2025-09-12,Brian Niccol,Starbucks,8,26,5,39,
2025-09-12,Cristiano Amon,Qualcomm,11,27,2,40,
2025-09-12,Hock Tan,Broadcom,12,26,2,40,
2025-09-12,David Flitman,US Foods,2,8,0,10,
2025-09-12,Paul Romanowski,DR Horton,6,16,5,27,
2025-09-12,Jacek Olczak,Philip Morris,13,24,3,40,
2025-09-12,Preston Feight,Paccar,7,28,1,36,
2025-09-12,Marc Benioff,Salesforce,8,17,15,40,
2025-09-12,Leon Topalian,Nucor,14,23,3,40,
2025-09-12,Michael Dastoor,Jabil,2,5,0,7,
2025-09-12,Jonathan Jaffe,Lennar,2,6,2,10,
2025-09-12,David Ricks,Eli Lilly,9,21,10,40,
2025-09-12,Joe Zubretsky,Molina Healthcare,9,4,4,17,
2025-09-12,Jennifer Rumsey,Cummins,8,27,5,40,
2025-09-12,Robin Vince,Bank of New York Mellon,19,19,2,40,
2025-09-12,Ted Sarandos,Netflix,13,24,3,40,
2025-09-12,William H Rogers Jr,Truist Financial,3,7,0,10,
2025-09-12,Sean Kerins,Arrow Electronics,1,10,0,11,
2025-09-12,William M Brown,3M,2,8,0,10,
2025-09-12,Ryan McInerney,Visa,12,24,4,40,
2025-09-12,Marc Rowan,Apollo Global Management,15,21,4,40,
2025-09-12,Tim Go,HF Sinclair,6,3,0,9,
2025-09-12,Robert Sulentic,CBRE Group,1,6,1,8,
2025-09-12,William Demchak,PNC Financial Services,14,20,6,40,
2025-09-12,Bryan DeBoer,Lithia Motors,3,35,2,40,
2025-09-12,William Nash,CarMax,4,4,2,10,
2025-09-12,Brian Robbins,Paramount Global,7,30,3,40,
2025-09-12,Michael Creedon,Dollar Tree,7,32,1,40,
2025-09-12,Sandy Douglas,United Natural Foods,34,5,1,40,
2025-09-12,Alex Chriss,PayPal,14,23,3,40,
2025-09-12,Roger Penske,Penske Automotive,17,22,1,40,
2025-09-12,Antonio Neri,Hewlett Packard Enterprise,7,26,7,40,
2025-09-12,Harry Sideris,Duke Energy,36,4,0,40,
2025-09-12,Vicki Hollub,Occidental Petroleum,20,16,4,40,
2025-09-12,Lawrence Coben,NRG Energy,5,3,0,8,
2025-09-12,Robert Bradway,Amgen,10,27,3,40,
2025-09-12,John Ketchum,NextEra Energy,23,17,0,40,
2025-09-12,Rainer Blair,Danaher,5,16,2,23,
2025-09-12,Daniel ODay,Gilead Sciences,1,8,1,10,
2025-09-12,Michael Manley,AutoNation,3,6,1,10,
2025-09-12,Carlos Abrams-Rivera,Kraft Heinz,10,24,6,40,
2025-09-12,Philip Gallagher,Avnet,1,5,0,6,
2025-09-12,Gary Dickerson,Applied Materials,6,20,14,40,
2025-09-12,Bob Jordan,Southwest Airlines,9,23,8,40,
2025-09-12,Rick Wurster,Charles Schwab,15,21,3,39,
2025-09-12,Lorenzo Simonelli,Baker Hughes,16,21,3,40,
2025-09-12,Chris Kempczinski,McDonalds,9,23,8,40,
2025-09-12,Christopher Womack,Southern Company,2,8,0,10,
2025-09-12,Michael Miebach,Mastercard,11,26,3,40,
2025-09-12,Joseph Dominguez,Constellation Energy,14,10,1,25,
2025-09-12,Christopher Swift,The Hartford,15,22,3,40,
2025-09-12,Patricia Poppe,PG&E,8,15,2,25,
2025-09-12,Bom Kim,Coupang,11,28,1,40,
2025-09-12,Ezra Yacob,EOG Resources,25,13,2,40,
2025-09-12,Jim Vena,Union Pacific,22,17,1,40,
2025-09-12,Matt Schroeder,Rite Aid,3,34,3,40,
2025-09-12,Tony Spring,Macys,10,27,3,40,
2025-09-12,Anthony Capuano,Marriott International,13,24,3,40,
2025-09-12,Raymond E Scott,Lear Corporation,4,6,0,10,
2025-09-12,William Stengel II,Genuine Parts,0,4,0,4,
2025-09-12,Heidi Petz,Sherwin-Williams,11,27,2,40,
2025-09-12,Jeff Miller,Halliburton,12,23,5,40,
2025-09-12,Kathleen Quirk,Freeport-McMoRan,13,17,2,32,
2025-09-12,Michael Rapino,Live Nation Entertainment,14,23,3,40,
2025-09-12,John Doyle,Marsh & McLennan,10,6,0,16,
2025-09-12,Lisa Su,Advanced Micro Devices,16,19,5,40,
2025-09-12,Frank Holding,First Citizens BancShares,9,15,2,26,
2025-09-12,John Engel,WESCO International,4,14,1,19,
2025-09-12,David Gitlin,Carrier Global,14,24,2,40,
2025-09-12,Lourenco Goncalves,Cleveland-Cliffs,5,21,14,40,
2025-09-12,Calvin G Butler Jr,Exelon,6,4,0,10,
2025-09-12,Joseph Bae,KKR & Co,8,7,1,16,
2025-09-12,Christine Leahy,CDW,1,7,2,10,
2025-09-12,Glenn Fogel,Booking Holdings,12,22,6,40,
2025-09-12,Brian Doubles,Synchrony Financial,4,7,1,12,
2025-09-12,Earl Austin,Quanta Services,2,5,2,9,
2025-09-12,Christian Ulbrich,Jones Lang LaSalle,7,14,0,21,
2025-09-12,Saumya Sutaria,Tenet Healthcare,6,2,1,9,
2025-09-12,William Gifford,Altria Group,2,7,1,10,
2025-09-12,Kevin Lobo,Stryker,12,25,3,40,
2025-09-12,Michael Hsu,Kimberly-Clark,5,6,1,12,
2025-09-12,Jack Fusco,Cheniere Energy,17,19,4,40,
2025-09-12,James Conroy,Ross Stores,4,14,0,18,
2025-09-12,Anthony Smurfit,Smurfit Westrock,4,6,0,10,
2025-09-12,Jeffrey Harmening,General Mills,3,17,5,25,
2025-09-12,Mark Stewart,Goodyear Tire & Rubber,3,37,0,40,
2025-09-12,Bob Eddy,BJs Wholesale Club,3,19,3,25,
2025-09-12,Peter Arduini,GE HealthCare Technologies,4,8,0,12,
2025-09-12,Noel Wallace,Colgate-Palmolive,10,21,2,33,
2025-09-12,Marc Bitzer,Whirlpool,11,15,14,40,
2025-09-12,Chris Kubasik,L3Harris Technologies,6,12,1,19,
2025-09-12,Shantanu Narayen,Adobe,18,20,1,39,
2025-09-12,Thomas Polen,Becton Dickinson,6,4,0,10,
2025-09-12,Richard P Dealy,Pioneer Natural Resources,7,3,0,10,
2025-09-12,Ravi Kumar S,Cognizant Technology Solutions,10,22,3,35,
2025-09-12,Andrew Clyde,Murphy USA,13,26,1,40,
2025-09-12,Mike Lyons,Fiserv,4,12,0,16,
2025-09-12,Jennifer Parmentier,Parker-Hannifin,2,12,0,14,
2025-09-12,William Fehrman,American Electric Power,2,8,0,10,
2025-09-12,Andrew Silvernail,International Paper,5,24,0,29,
2025-09-12,Jonas Prising,ManpowerGroup,7,22,2,31,
2025-09-12,John Zillmer,Aramark,7,14,2,23,
2025-09-12,Mark Millett,Steel Dynamics,17,2,0,19,
2025-09-12,Dan Amos,Aflac,13,17,10,40,
2025-09-12,Tony Cheng,Reinsurance Group of America,3,9,2,14,
2025-09-12,Karsanbhai,Emerson Electric,8,14,2,24,
2025-09-12,Ronald P OHanley,State Street,0,4,0,4,
2025-09-12,Timothy Knavish,PPG Industries,0,1,0,1,
2025-09-12,David Burritt,United States Steel,9,20,10,39,
2025-09-12,Maria Black,Automatic Data Processing,5,4,0,9,
2025-09-12,Daryl Kenningham,Group 1 Automotive,8,30,2,40,
2025-09-12,Robert Blue,Dominion Energy,26,13,1,40,
2025-09-12,Larry Fink,BlackRock,8,24,8,40,
2025-09-12,Pierce Norton II,Oneok,5,3,1,9,
2025-09-12,David Bozeman,CH Robinson Worldwide,2,8,0,10,
2025-09-12,Haviv Ilan,Texas Instruments,12,25,3,40,
2025-09-12,Michael Bender,Kohls,2,24,14,40,
2025-09-12,Philip Daniele III,AutoZone,0,2,0,2,
2025-09-12,Timothy Archer,Lam Research,2,8,0,10,
2025-09-12,Charles Magro,Corteva,5,3,1,9,
2025-09-12,Rick Lanoha,Peter Kiewit Sons,0,2,0,2,
2025-09-12,Peter Jackson,Builders FirstSource,5,12,1,18,
2025-09-12,Martin Schroeter,Kyndryl,9,30,0,39,
2025-09-12,Hamid Akhavan,EchoStar,6,25,7,38,
2025-09-12,Bill Westrate,American Family Insurance,10,17,2,29,
2025-09-12,Avigal Soreq,Delek US,4,9,5,18,
2025-09-12,Beth Ford,Land OLakes,4,7,1,12,
2025-09-12,Walker Martin,Sempra,0,2,0,2,
2025-09-12,Eric Slifka,Global Partners,12,22,6,40,
2025-09-12,DG Macpherson,WW Grainger,2,6,1,9,
2025-09-12,Bob Pragada,Jacobs Solutions,5,9,0,14,
2025-09-12,Pedro Pizarro,Edison International,17,7,16,40,
2025-09-12,William Hornbuckle,MGM Resorts International,9,25,1,35,
2025-09-12,Andrew McMahon,Guardian Life insurance,5,12,0,17,
2025-09-12,Christopher OHerlihy,Illinois Tool Works,0,1,0,1,
2025-09-12,James Cracchiolo,Ameriprise Financial,2,23,2,27,
2025-09-12,Ryan Marshall,PulteGroup,10,14,10,34,
2025-09-12,Matthew Meloy,Targa Resources,6,4,0,10,
2025-09-12,Michael Rhodes,Ally Financial,7,28,5,40,
2025-09-12,Joseph Fadool,BorgWarner,4,10,0,14,
2025-09-12,St√©phane de La Faverie,Est√©e Lauder,14,23,3,40,
2025-09-12,Benjamin Tisch,Loews,2,7,0,9,
2025-09-12,Brad Beckham,OReilly Automotive,2,8,0,10,
2025-09-12,Thomas Gayner,Markel Group,2,8,0,10,
2025-09-12,Donald Allan,Stanley Black & Decker,9,30,1,40,
2025-09-12,Sanjay Mehrotra,Micron Technology,18,20,2,40,
2025-09-12,James Breuer,Fluor,1,1,1,3,
2025-09-12,Thomas Bell,Leidos,9,19,2,30,
2025-09-12,Scott Smith,Viatris,6,4,0,10,
2025-09-12,Kimberly Dang,Kinder Morgan,11,1,0,12,
2025-09-12,Christophe Beck,Ecolab,20,20,0,40,
2025-09-12,Brent Shafer,Baxter International,1,10,0,11,
2025-09-12,Clay Gaspar,Devon Energy,22,3,0,25,
2025-09-12,Steven Cahillane,Kellanova,1,7,0,8,
2025-09-12,Raul Nicholas Vargas Ochoa,Farmers Insurance Exchange,0,0,0,0,
2025-09-12,Darren Rebelez,Caseys General Stores,4,6,0,10,
2025-09-12,Ari Bousbib,IQVIA,6,15,1,22,
2025-09-12,Jon Vander Ark,Republic Services,11,19,10,40,
2025-09-12,Timothy Cofer,Keurig Dr Pepper,2,6,1,9,
2025-09-12,Karla Lewis,Reliance Inc,4,5,0,9,
2025-09-12,David Hult,Asbury Automotive Group,8,31,1,40,
2025-09-12,Darryl Button,Pacific Life,1,8,0,9,
2025-09-12,James Burke,Vistra,7,3,0,10,
2025-09-12,John Barrett,Western & Southern Financial,10,28,2,40,
2025-09-12,William Krueger,The Andersons Inc,0,2,0,2,
2025-09-12,Erik Nordstrom,Nordstrom,7,28,5,40,
2025-09-12,John Wren,Omnicom Group,14,21,5,40,
2025-09-12,Stephanie Ferris,Fidelity National Information Services,14,24,2,40,
2025-09-12,Timothy Cawley,Consolidated Edison,4,5,0,9,
2025-09-12,Joseph Hinrichs,CSX,6,10,1,17,
2025-09-12,Troy Rudd,AECOM,8,25,4,37,
2025-09-12,Kathleen Johnson,Lumen Technologies,4,5,1,10,
2025-09-12,Harry Lawton III,Tractor Supply,1,0,0,1,
2025-09-12,Raul Fernandez,DXC Technology,4,27,1,32,
2025-09-12,Eric Hansotia,AGCO,14,25,1,40,
2025-09-12,David Bruton Smith,Sonic Automotive,4,7,9,20,
2025-09-12,Sasan Goodarzi,Intuit,12,24,4,40,
2025-09-12,Matthew Flannery,United Rentals,31,1,0,32,
2025-09-12,Marc Miller,Universal Health Services,4,22,3,29,
2025-09-12,Michael Mahoney,Boston Scientific,12,28,0,40,
2025-09-12,Judith Marks,Otis Worldwide,2,3,1,6,
2025-09-12,Robert Frenzel,Xcel Energy,3,3,1,7,
2025-09-12,Penny Pennington,Edward Jones,8,27,5,40,
2025-09-12,Daniel Fisher,Ball,1,21,6,28,
2025-09-12,Justin Jude,LKQ,4,6,1,11,
2025-09-12,James Blackledge,Mutual of Omaha,1,32,1,34,
2025-09-12,Bruce Bodine,Mosaic,3,7,0,10,
2025-09-12,Scott Donnelly,Textron,11,26,3,40,
2025-09-12,Adam Schechter,Labcorp Holdings,3,6,0,9,
2025-09-12,Deanna Strable-Soethout,Principal Financial,1,6,0,7,
2025-09-12,Leonard Schleifer,Regeneron Pharmaceuticals,7,26,7,40,
2025-09-12,Paul Shoukry,Raymond James Financial,15,24,1,40,
2025-09-12,Lauren Hobart,Dicks Sporting Goods,12,25,3,40,
2025-09-12,Jamie Whisnant,Auto-Owners Insurance,0,2,0,2,
2025-09-12,Ariane Gorin,Expedia,10,28,1,39,
2025-09-12,Shelley Simpson,JB Hunt Transport Services,9,27,4,40,
2025-09-12,Ren√© Jones,M&T Bank,0,0,0,0,
2025-09-12,Gerardo Norcia,DTE Energy,6,2,1,9,
2025-09-12,Andr√©s Gluski,AES,15,22,0,37,
2025-09-12,Timothy Spence,Fifth Third Bancorp,5,4,1,10,
2025-09-12,Eduardo Menezes,Air Products & Chemicals,3,6,1,10,
2025-09-12,Wendell Weeks,Corning,15,23,2,40,
2025-09-12,Anthony Guzzi,EMCOR Group,2,4,1,7,
2025-09-12,Adam Norwitt,Amphenol,3,16,0,19,
2025-09-12,Jean-Marc Gilson,Westlake Corporation,2,3,0,5,
2025-09-12,Lori Koch,DuPont,6,20,0,26,
2025-09-12,Derek Chang,Liberty Media,35,4,1,40,
2025-09-12,Martina Cheung,S&P Global,10,27,0,37,
2025-09-12,Tim Hingtgen,Community Health Systems,10,28,2,40,
2025-09-12,Brian Tierney,FirstEnergy,6,21,3,30,
2025-09-12,Rick McKenney,Unum Group,5,3,0,8,
2025-09-12,Stanley Bergman,Henry Schein,12,27,1,40,
2025-09-12,Tiang Yew Tan,Western Digital,0,3,0,3,
2025-09-12,Vincent Roche,Analog Devices,12,23,4,39,
2025-09-12,Sean Connolly,Conagra Brands,8,30,2,40,
2025-09-12,Bruce Van Saun,Citizens Financial Group,13,25,2,40,
2025-09-12,Mark George,Norfolk Southern,17,19,4,40,
2025-09-12,Andrew Marsh,Entergy,3,4,0,7,
2025-09-12,Robert Berkley,WR Berkley,8,28,4,40,
2025-09-12,Javier Rodriguez,DaVita,15,13,1,29,
2025-09-12,Michael OGrady,Northern Trust,3,2,0,5,
2025-09-12,James Snee,Hormel Foods,2,25,1,28,
2025-09-12,Timothy J Donahue,Crown Holdings,3,10,0,13,
2025-09-12,Joseph Ferraro,Avis Budget,3,6,1,10,
2025-09-12,Niraj Shah,Wayfair,6,27,7,40,
2025-09-12,Jos√© Mas,MasTec,6,13,1,20,
2025-09-12,Joseph Nolan,Eversource Energy,4,5,1,10,
2025-09-12,Thomas Palmer,Newmont,5,5,0,10,
2025-09-12,Robert Sanchez,Ryder System,10,8,1,19,
2025-09-12,Michael Nolan,Fidelity National Financial,4,1,0,5,
2025-09-12,Gavin Hattersley,Molson Coors Beverage,5,29,6,40,
2025-09-12,Thomas Reeg,Caesars Entertainment,5,5,0,10,
2025-09-12,Ellen Cooper,Lincoln National,2,7,0,9,
2025-09-12,Bracken Darrell,VF Corporation,6,31,3,40,
2025-09-12,Erik Fyrwald,International Flavors & Fragrances,6,10,4,20,
2025-09-12,Christopher Kastner,Huntington Ingalls Industries,3,5,0,8,
2025-09-12,Shane OKelly,Advance Auto Parts,0,6,0,6,
2025-09-12,Ralph LaRossa,Public Service Enterprise Group,13,16,0,29,
2025-09-12,Kecia Steelman,Ulta Beauty,36,3,1,40,
2025-09-12,Michele Buck,Hershey,6,32,2,40,
2025-09-12,Sumit Singh,Chewy,11,24,5,40,
2025-09-12,Steven Vondran,American Tower,4,6,0,10,
2025-09-12,Jeffrey Lorberbaum,Mohawk Industries,11,6,1,18,
2025-09-12,Keith Demmings,Assurant,5,8,0,13,
2025-09-12,Robert Martin,Thor Industries,4,5,1,10,
2025-09-12,Kathleen Mazzarella,Graybar Electric,1,6,1,8,
2025-09-12,Joey Wat,Yum China,13,24,3,40,
2025-09-12,Scott Richardson,Celanese,6,16,2,24,
2025-09-12,David Rawlinson II,QVC,8,14,2,24,
2025-09-12,Alan Armstrong,Williams,25,11,4,40,
2025-09-12,Philippe Krakowsky,Interpublic Group,13,24,3,40,
2025-09-12,Brendan McCracken,Ovintiv,5,6,0,11,
2025-09-12,Andrew Teno,Icahn Enterprises,5,5,0,10,
2025-09-12,Stephen Steinour,Huntington Bancshares,1,8,0,9,
2025-09-12,Timothy NeCastro,Erie Insurance,3,7,0,10,
2025-09-12,Ernest Garcia III,Carvana,25,11,4,40,
2025-09-12,R Bruce McDonald,Dana Incorporated,3,7,1,11,
2025-09-12,William Oplinger,Alcoa Corporation,1,8,1,10,
2025-09-12,Mark Pearson,Equitable,6,9,0,15,
2025-09-12,Richard Wallace,KLA,2,3,0,5,
2025-09-12,Ricardo Cardenas,Darden Restaurants,4,4,1,9,
2025-09-12,Mikael Bratt,Autoliv,6,7,2,15,
2025-09-12,Benito Minicucci,Alaska Air,1,3,1,5,
2025-09-12,Christopher Gorman,KeyCorp,5,5,0,10,
2025-09-12,Robert Goldstein,Las Vegas Sands,5,29,6,40,
2025-09-12,Edward Pesicka,Owens & Minor,3,29,2,34,
2025-09-12,Christopher Nassetta,Hilton Worldwide,8,15,2,25,
2025-09-12,Jamie Iannone,Ebay,18,18,3,39,
2025-09-12,Patrick Gallagher,Arthur J Gallagher,9,29,2,40,
2025-09-12,Rich Steinmeier,LPL Financial,23,15,2,40,
2025-09-12,Stephen Spray,Cincinnati Financial,1,6,2,9,
2025-09-12,Douglas Yearley,Toll Brothers,10,25,5,40,
2025-09-12,Gregory Brown,Motorola Solutions,2,7,1,10,
2025-09-12,Brian Chesky,Airbnb,2,29,9,40,
2025-09-12,Jeffrey Sprecher,Intercontinental Exchange,14,22,4,40,
2025-09-12,Robert Thomson,News Corp,5,32,3,40,
2025-09-12,Scott Boatwright,Chipotle Mexican Grill,10,27,3,40,
2025-09-12,Reshma Kewalramani,Vertex Pharmaceuticals,21,14,5,40,
2025-09-12,Christopher Viehbacher,Biogen,0,25,2,27,
2025-09-12,Malcolm Wilson,GXO Logistics,6,24,0,30,
2025-09-12,Tony Sarsam,SpartanNash,17,21,2,40,
2025-09-12,Michael O‚ÄôSullivan,Burlington Stores,9,27,4,40,
2025-09-12,Teresa Rasmussen,Thrivent Financial for Lutherans,2,2,0,4,
2025-09-12,Eugene Bredow,NVR,0,4,1,5,
2025-09-12,Brian Chambers,Owens Corning,1,13,0,14,
2025-09-12,Rafael Santana,Westinghouse Air Brake Technologies,3,8,1,12,
2025-09-12,John Pfeifer,Oshkosh Corporation,3,17,0,20,
2025-09-12,Cameron Bready,Global Payments,7,30,3,40,
2025-09-12,Calvin McDonald,Lululemon athletica,9,31,0,40,
2025-09-12,J Kent Masters,Albemarle Corporation,4,5,0,9,
2025-09-12,Joanna Geraghty,JetBlue Airways,15,17,8,40,
2025-09-12,Robert Steer,Seaboard,1,4,0,5,
2025-09-12,William Newlands,Constellation Brands,0,3,2,5,
2025-09-12,Michael Doss,Graphic Packaging,4,8,1,13,
2025-09-12,Gil West,Hertz,6,25,9,40,
2025-09-12,Malcolm C Roberts,FM Global,2,10,2,14,
2025-09-12,Mick Beekhuizen,Campbell Soup,8,22,0,30,
2025-09-12,Daniel Wall,Expeditors International of Washington,2,4,0,6,
2025-09-12,Gregory Roberts,A-Mark Precious Metals,2,4,1,7,
2025-09-12,Horacio Rozanski,Booz Allen Hamilton,16,19,5,40,
2025-09-12,James Davis,Quest Diagnostics,5,5,0,10,
2025-09-12,Dennis Mathew,Altice,4,25,7,36,
2025-09-12,Stefan Larsson,PVH,10,25,5,40,
2025-09-12,Mark Costa,Eastman Chemical,4,14,4,22,
2025-09-12,Joyce Mullen,Insight Enterprises,5,11,0,16,
2025-09-12,John Turner,Regions Financial,21,17,2,40,
2025-09-12,Julian G Francis,Beacon Roofing Supply,0,1,0,1,
2025-09-12,Blake Moret,Rockwell Automation,11,28,1,40,
2025-09-12,Mike Speetzen,Polaris Inc,3,17,2,22,
2025-09-12,William McDermott,ServiceNow,3,6,0,9,
2025-09-12,Jure Sola,Sanmina,3,11,0,14,
2025-09-12,Bob Flexon,UGI Utilities Inc,0,1,0,1,
2025-09-12,Scott Lauber,WEC Energy,14,6,0,20,
2025-09-12,Jon Rousseau,BrightSpring Health Services,20,19,1,40,
2025-09-12,Todd Schneider,Cintas,12,18,1,31,
2025-09-12,Peter Matt,Commercial Metals,4,4,0,8,
2025-09-12,Robert D Lawler,Continental Resources,0,0,0,0,
2025-09-12,Domenic Dell‚ÄôOsso Jr,Expand Energy,4,0,0,4,
2025-09-12,Jason P Wells,CenterPoint Energy,8,4,1,13,
2025-09-12,H Michael Krimbill,NGL Energy Partners,8,1,0,9,
2025-09-12,Tony Xu,DoorDash,18,16,6,40,
2025-09-12,Clay Williams,NOV,8,20,4,32,
2025-09-12,Kristin Peck,Zoetis,12,20,1,33,
2025-09-12,Mark Smucker,JM Smucker,12,22,6,40,
2025-09-12,Steve Sanghi,Microchip Technology,8,28,4,40,
2025-09-12,Richard Tobin,Dover Corporation,2,2,0,4,
2025-09-12,Kaes Van‚Äôt Hof,Diamondback Energy,21,15,3,39,
2025-09-12,Deon Stander,Avery Dennison,0,13,0,13,
2025-09-12,Vincent Sorgi,PPL,8,9,1,18,
2025-09-12,Hassane El-Khoury,ON Semiconductor,2,19,5,26,
2025-09-12,Arie Kotler,ARKO,5,22,1,28,
2025-09-12,William Monteleone,Par Pacific,1,6,2,9,
2025-09-12,John Christmann IV,APA,5,4,1,10,
2025-09-12,Adaire Fox-Martin,Equinix,16,21,3,40,
2025-09-12,Joseph M Otting,Flagstar Financial,2,5,2,9,
2025-09-12,Mary Dillon,Foot Locker,11,24,5,40,
2025-09-12,James Zallie,Ingredion,3,7,0,10,
2025-09-12,Christopher Peterson,Newell Brands,0,9,1,10,
2025-09-12,Scott Salmirs,ABM Industries,6,5,1,12,
2025-09-12,Christopher Hilger,Securian Financial,0,6,0,6,
2025-09-12,Hamid Moghadam,Prologis,7,28,5,40,
2025-09-12,Stephen Schwarzman,Blackstone,16,17,6,39,
2025-09-12,Robert Greenberg,Skechers USA,4,23,3,30,
2025-09-12,Keith Allman,Masco,3,9,1,13,
2025-09-12,Rusty Rush,Rush Enterprises,14,23,3,40,
2025-09-12,Jennifer Johnson,Franklin Resources,1,8,1,10,
2025-09-12,Gerry P Smith,ODP Business Solutions,0,1,0,1,
2025-09-12,Carl Lindner lll,American Financial,0,0,0,0,
2025-09-12,Mark Kowlzan,Packaging Corp of America,0,8,1,9,
2025-09-12,Thomas Hill,Vulcan Materials,4,7,2,13,
2025-09-12,Milan Galik,Interactive Brokers,8,17,2,27,
2025-09-12,Laura Alber,Williams-Sonoma,16,20,4,40,
2025-09-12,Mario Harik,XPO,7,32,1,40,
2025-09-12,Devin Stockfish,Weyerhaeuser,5,5,0,10,
2025-09-12,Thomas J McInerney,Genworth Financial,1,6,0,7,
2025-09-12,Garrick Rochow,CMS Energy,10,3,1,14,
2025-09-12,Toni Townes-Whitley,Science Applications International,11,21,1,33,
2025-09-12,Rich Handler,Jefferies Financial,12,10,2,24,
2025-09-12,Daniel Heaf,Bath & Body Works,13,26,1,40,
2025-09-12,Andrew Wilson,Electronic Arts,12,18,10,40,
2025-09-12,Sheryl Palmer,Taylor Morrison Home,8,9,1,18,
2025-09-12,Ivan Tornos,Zimmer Biomet,10,29,1,40,
2025-09-12,Linda Rendle,Clorox,2,34,2,38,
2025-09-12,Matthew Pine,Xylem Inc,1,9,1,11,
2025-09-12,Heather Lavallee,Voya Financial,6,11,2,19,
2025-09-12,Daniel Florness,Fastenal,4,4,2,10,
2025-09-12,Albert Nahmad,Watsco,2,6,0,8,
2025-09-12,Carl Eschenbach,Workday,12,20,8,40,
2025-09-12,Craig Smiddy,Old Republic International,3,6,1,10,
2025-09-12,Frank C Sullivan,RPM International,2,8,1,11,
2025-09-12,Matthew Missad,UFP Industries,7,3,0,10,
2025-09-12,Martin J Lyons,Ameren,2,4,1,7,
2025-09-12,Adam W Miller,Knight Swift Transportation,1,2,1,4,
2025-09-12,Rodney Sacks,Monster Beverage,14,25,0,39,
2025-09-12,Gary Guthart,Intuitive Surgical,13,22,5,40,
2025-09-12,Charles Liang,Super Micro Computer,36,4,0,40,
2025-09-12,Christopher Caldwell,Concentrix,3,5,0,8,
2025-09-12,Gordon J Hardie,O-I Glass,0,5,0,5,
2025-09-12,David Gibbs,Yum Brands,2,38,0,40,
2025-09-12,Steve Henry,Domtar,5,5,0,10,
2025-09-12,Chuck Treadway,CommScope,8,19,3,30,
2025-09-12,Rob Vitale,Post Holdings,0,0,0,0,
2025-09-12,Steven J Moskowitz,Crown Castle,3,4,3,10,
2025-09-12,Emmanuel Ligner,Avantor,2,10,1,13,
2025-09-12,Stuart Bradie,KBR,11,15,4,30,
2025-09-12,Carrie Wheeler,Opendoor Technologies,10,26,4,40,
2025-09-12,Russell Becker,APi Group,3,5,0,8,
2025-09-12,Toby Rice,EQT,24,13,3,40,
2025-09-12,Jesse Arenivas,EnLink Midstream,8,8,0,16,
2025-09-12,Nikesh Arora,Palo Alto Networks,6,24,10,40,
2025-09-12,Steven Bandrowczak,Xerox,1,8,1,10,
2025-09-12,Vicente Reynal,Ingersoll Rand,8,29,0,37,
2025-09-12,William T Dillard II,Dillards,3,3,2,8,
2025-09-12,C Howard Nye,Martin Marietta Materials,1,5,4,10,
2025-09-12,Giordano Albertazzi,Vertiv,15,19,3,37,
2025-09-12,Stephane Bancel,Moderna,9,21,10,40,
2025-09-12,Nate R Jorgensen,Boise Cascade,0,0,0,0,
2025-09-12,Jack Sinclair,Sprouts Farmers Market,18,22,0,40,
2025-09-12,Padraig McDonnell,Agilent Technologies,11,11,0,22,
2025-09-12,Kenneth T Lane,Olin,0,1,0,1,
2025-09-12,Randall C Stuewe,Darling Ingredients,27,1,0,28,
2025-09-12,R Howard Coker,Sonoco Products,3,6,1,10,
2025-09-12,John Mengucci,CACI International,20,19,1,40,
2025-09-12,Mark Witkowski,Core & Main,2,13,2,17,
2025-09-12,Lee M Tillman,Marathon Oil,4,5,0,9,
2025-09-12,Mark Hoplamazian,Hyatt Hotels,15,20,5,40,
2025-09-12,David S Chernow,Select Medical,0,9,0,9,
2025-09-12,Brendan M Foley,McCormick & Company,0,9,0,9,
2025-09-12,Joanne Crevoiserat,Tapestry,13,24,3,40,
2025-09-12,John Plant,Howmet Aerospace,6,12,3,21,
2025-09-12,Shankh Mitra,Welltower,15,23,2,40,
2025-09-12,W Anthony Will,CF Industries,3,4,0,7,
2025-09-12,David A Zapico,Ametek,3,16,1,20,
2025-09-12,Kevin Stein,TransDigm,10,10,2,22,
2025-09-12,Craig Billings,Wynn Resorts,13,25,2,40,
2025-09-12,William J Way,Southwestern Energy,2,0,0,2,
2025-09-12,Giel Rutten,Amkor Technology,3,6,1,10,
2025-09-12,Paul Sarvadi,Insperity,4,5,0,9,
2025-09-12,Donald Zurbay,Patterson Companies Inc,1,4,0,5,
2025-09-12,Rob Sharps,T Rowe Price,14,21,5,40,
2025-09-12,Patrice Louvet,Ralph Lauren,15,16,9,40,
2025-09-12,Jeffrey Mezger,KB Home,2,30,7,39,
2025-09-12,David M Foulkes,Brunswick,1,8,0,9,
2025-09-12,M Keith Waddell,Robert Half,4,6,0,10,
2025-09-12,Jay Snowden,PENN Entertainment,18,18,4,40,
2025-09-12,George Kurian,NetApp,16,21,3,40,
2025-09-12,Kevin Ali,Organon,9,17,2,28,
2025-09-12,Joel D Anderson,Petco Health and Wellness,2,9,0,11,
2025-09-12,Louis V Pinkham,Regal Rexnord,0,1,0,1,
2025-09-12,Jay Geldmacher,Resideo Technologies,9,6,0,15,
2025-09-12,Marcus Lemonis,Camping World,11,22,7,40,
2025-09-12,Peter R Huntsman,Huntsman,7,11,3,21,
2025-09-12,Hillary Super,Victorias Secret,11,4,8,23,
2025-09-12,Michelle Gass,Levi Strauss,12,24,3,39,
2025-09-12,Neil Hunn,Roper Technologies,2,20,0,22,
2025-09-12,Steven P Lawrence,Academy Sports and Outdoors,1,1,0,2,
2025-09-12,Phillippe Lord,Meritage Homes,8,14,0,22,
2025-09-12,David C Dauch,American Axle & Manufacturing,5,6,2,13,
2025-09-12,Olumide Soroye,Fortive,1,8,1,10,
2025-09-12,Adena Friedman,Nasdaq,13,23,4,40,
2025-09-12,Tim Gokey,Broadridge Financial Solutions,5,12,1,18,
2025-09-12,Patrick M Shanahan,Spirit AeroSystems,1,9,0,10,
2025-09-12,Robert Kyncl,Warner Music Group,11,28,1,40,
2025-09-12,Denise Dignam,Chemours,3,19,3,25,
2025-09-12,Jim DeVries,ADT,10,7,1,18,
2025-09-12,Bernard Zovighian,Edwards Lifesciences,6,7,2,15,
2025-09-12,Mark E Seaton,First American Financial,1,9,0,10,
2025-09-12,John C Roche,Hanover Insurance Group,7,16,1,24,
2025-09-12,Adam J Greenlee,Silgan,0,5,0,5,
2025-09-12,Jayne Hrdlicka,Endeavor Group,0,1,0,1,
2025-09-12,Robert Fauber,Moodys Corporation,1,6,0,7,
2025-09-12,Thomas E Jorden,Coterra Energy,9,0,0,9,
2025-09-12,Eugene A Hall,Gartner,1,8,0,9,
2025-09-12,Kevin Plank,Under Armour,8,28,3,39,
2025-09-12,James W Lanning,Ingles Markets,3,3,0,6,
2025-09-12,Matthew T Farrell,Church & Dwight,7,7,0,14,
2025-09-12,Kevin M Freeman,Old Dominion Freight Line,0,0,0,0,
2025-09-12,Joe Shoen,U-Haul,15,20,4,39,
2025-09-12,Mark Bertolini,Oscar Health,12,19,9,40,
2025-09-12,Jayshree Ullal,Arista Networks,19,20,1,40,
2025-09-12,Sassine Ghazi,Synopsys,11,25,4,40,
2025-09-12,Jochen Zeitz,Harley-Davidson,6,23,11,40,
2025-09-12,Nick Jeffery,Frontier Communications,10,25,0,35,
2025-09-12,Thomas Edward McCormick,Primoris Services,0,4,0,4,
2025-09-12,D Christian Koch,Carlisle Companies,1,4,0,5,
2025-09-12,David E Simon,Simon Property Group,3,6,1,10,
2025-09-12,Stephen Bratspies,Hanesbrands,3,11,1,15,
2025-09-12,Ryan M. Schneider,Anywhere Real Estate Inc,0,1,0,1,
2025-09-12,George Bobb III,Teledyne Technologies,1,4,0,5,
2025-09-12,Terrence A Duffy,CME Group,6,8,1,15,
2025-09-12,Rami Rahim,Juniper Networks,11,26,3,40,
2025-09-12,Sue Nabi,Coty,14,18,8,40,
2025-09-12,Peter D Arvan,Pool Corporation,3,6,0,9,
2025-09-12,David Campbell,Evergy,15,9,0,24,
2025-09-12,Matthew J Murphy,Marvell Technology,2,7,1,10,
2025-09-12,Lloyd Yates,NiSource,6,4,0,10,
2025-09-12,William C Stone,SS&C Technologies,2,5,1,8,
2025-09-12,Mark Rourke,Schneider National,11,16,1,28,
2025-09-12,Andrew Anagnost,Autodesk,8,25,7,40,
2025-09-12,Dustin Semach,Sealed Air Corporation,0,9,0,9,
2025-09-12,William L Meaney,Iron Mountain,3,16,0,19,
2025-09-12,Andy P Power,Digital Realty Trust,0,0,0,0,
2025-09-12,Satish Dhanasekaran,Keysight Technologies,3,10,0,13,
2025-09-12,Frank M Svoboda,Globe Life,3,4,3,10,
2025-09-12,Carey A Smith,Parsons Corporation,0,1,0,1,
2025-09-12,Ynon Kreiz,Mattel,9,25,6,40,
2025-09-12,Karen S Haller,Southwest Gas,2,7,0,9,
2025-09-12,Terrance Williams,TruStage,4,5,1,10,
2025-09-12,Eric W Gerstenberg,Clean Harbors,5,1,1,7,
2025-09-12,Gunner Smith,Cornerstone Building Brands,1,8,1,10,
2025-09-12,Gerben W Bakker,Hubbell,1,4,0,5,
2025-09-12,Dave Davis,Spirit Airlines,5,33,2,40,
2025-09-12,Michael J Smith,Lamb Weston,0,7,3,10,
2025-09-12,Strauss Zelnick,Take-Two Interactive Software,14,16,10,40,
2025-09-12,John C Turner Jr,GMS,2,7,0,9,
2025-09-12,David M OMalley,Penn Mutual Life Insurance,0,1,0,1,
2025-09-12,Frank A Lonegro,Landstar System,1,4,0,5,
2025-09-12,James F Risoleo,Host Hotels & Resorts,5,14,0,19,
2025-09-12,Ken Xie,Fortinet,12,22,6,40,
2025-09-12,Doug Shulman,OneMain,4,5,0,9,
2025-09-12,Ryan Cohen,GameStop,12,22,6,40,
2025-09-12,Mark W Begor,Equifax,3,14,0,17,
2025-09-12,Jay L Schottenstein,American Eagle Outfitters,8,17,1,26,
2025-09-12,Curtis C Farmer,Comerica,3,9,0,12,
2025-09-12,Ole Rosgaard,Greif,2,15,1,18,
2025-09-12,Brian E Lane,Comfort Systems USA,10,0,0,10,
2025-09-12,Robert M Buck,TopBuild,5,5,0,10,
2025-09-12,Ralph Andretta,Bread Financial,3,9,0,12,
2025-09-12,Jim Anderson,Coherent,6,34,0,40,
2025-09-12,Walter C. D. Carlson,Telephone & Data Systems,0,3,0,3,
2025-09-12,Ronald Kruszewski,Stifel Financial,7,3,0,10,
2025-09-12,Richard Hayne,Urban Outfitters,11,21,8,40,
2025-09-12,Simon Meester,Terex,3,7,0,10,
2025-09-12,Edward J Lehner,Ryerson Holding,0,2,0,2,
2025-09-12,Nicholas T Pinchuk,Snap-on,3,6,0,9,
2025-09-12,Ryals McMullian,Flowers Foods,6,29,3,38,
2025-09-12,D Bryan Jordan,First Horizon,3,8,1,12,
2025-09-12,John B Gibson,Paychex,4,4,1,9,
2025-09-12,Chris Cocks,Hasbro,11,19,10,40,
2025-09-12,Pete McPartland,Sentry Insurance Group,0,2,0,2,
2025-09-12,Michael Arougheti,Ares Management,17,21,2,40,
2025-09-12,Alok Maskara,Lennox International,5,3,1,9,
2025-09-12,James C Grech,Peabody Energy,3,1,0,4,
2025-09-12,Joseph P Lacher Jr,Kemper,4,19,3,26,
2025-09-12,Perry A Sook,Nexstar Media Group,8,26,1,35,
2025-09-12,Wade Davis,TelevisaUnivision,14,25,1,40,
2025-09-12,Scott L Thompson,Tempur Sealy International,0,7,0,7,
2025-09-12,Mike Simonds,TriNet Group,0,9,0,9,
2025-09-12,B Andrew Rose,Worthington Enterprises,0,1,0,1,
2025-09-12,Bruce L Caswell,Maximus,3,4,0,7,
2025-09-12,Robert L Reffkin,Compass,1,7,0,8,
2025-09-12,Mark Eubanks,Brinks Company,1,2,1,4,
2025-09-12,Peter Quigley,Kelly Services inc,1,9,0,10,
2025-09-12,David L Yowan,Navient,1,1,0,2,
2025-09-12,Mary E Kipp,Puget Sound Energy,3,1,2,6,
2025-09-12,Adam Aron,AMC Entertainment,16,18,6,40,
2025-09-12,Mark J Tarr,Encompass Health,2,5,1,8,
2025-09-12,Liam K Griffin,Skyworks Solutions,1,9,0,10,
2025-09-12,Richard G Kyle,Timken,2,13,1,16,
2025-09-12,Ron Gusek,Liberty Energy,22,1,0,23,
2025-09-12,John E Geller Jr,Marriott Vacations Worldwide,6,6,0,12,
2025-09-12,Karl G. Glassman,Leggett & Platt,0,4,0,4,
2025-09-12,Bruce K Thorn,Big Lots,2,6,2,10,
2025-09-12,Jonathan H Weis,Weis Markets,11,28,0,39,
2025-09-12,Jeffrey B Guldner,Pinnacle West Capital,1,2,0,3,
2025-09-12,Arkadiy Dobkin,EPAM Systems,10,14,1,25,
2025-09-12,Paul M Rady,Antero Resources,3,7,0,10,
2025-09-12,Michael Spanos,Bloomin Brands,1,8,1,10,
2025-09-12,Nicole A Kivisto,MDU Resources Group,5,2,0,7,
2025-09-12,Gerald L Morgan,Texas Roadhouse,3,2,5,10,
2025-09-12,Gabriel Tirador,Mercury General,4,4,2,10,
2025-09-12,Nicholas I Fink,Fortune Brands Innovations,4,6,0,10,
2025-09-12,Paul E Burdiss,Zions Bancorp,1,1,0,2,
2025-09-12,William J Christensen,JELD-WEN Holding,4,5,0,9,
2025-09-12,Evan Spiegel,Snap Inc,20,18,2,40,
2025-09-12,Bill Burns,Zebra Technologies,6,22,1,29,
2025-09-12,Steven Sell,Agilon Health,0,6,0,6,
2025-09-12,Richard M Olson,Toro Company,1,11,0,12,
2025-09-12,Eric S Yuan,Zoom Video Communications,6,7,0,13,
2025-09-12,Dan L Batrack,Tetra Tech,2,5,1,8,
2025-09-12,Joseph D Russell Jr,Public Storage,0,7,0,7,
2025-09-12,Jacob Thaysen,Illumina inc,5,7,0,12,
2025-09-12,Debra A Cafaro,Ventas inc,6,6,0,12,
2025-09-12,Pierre R Brondeau,FMC Corporation,0,5,0,5,
2025-09-12,Judy R McReynolds,ArcBest,4,15,1,20,
2025-09-12,Russell J Weiner,Dominos Pizza inc,0,0,0,0,
2025-09-12,Theodore S Hanson,ASGN,0,1,0,1,
2025-09-12,RJ Scaringe,Rivian Automotive,9,28,3,40,
2025-09-12,Jeffrey N Simmons,Elanco Animal Health,2,6,1,9,
2025-09-12,Tim O Shaughnessy,Graham Holdings Company,3,7,0,10,
2025-09-12,Thomas V Taylor,Floor & Decor,1,2,2,5,
2025-09-12,Neil A Schrimsher,Applied Industrial Technologies,6,22,1,29,
2025-09-12,Robert E Price,PriceSmart,4,6,0,10,
2025-09-12,John David Risher,Lyft,4,3,1,8,
2025-09-12,Gary B Smith,Ciena,4,8,0,12,
2025-09-12,Joey Levin,IAC,7,30,1,38,
2025-09-12,Jim Jacobs,Country Financial,7,4,2,13,
2025-09-12,Devin B McGranahan,Western Union,1,5,0,6,
2025-09-12,R Scott Rowe,Flowserve,5,4,1,10,
2025-09-12,Kenneth A Vecchione,Western Alliance Bancorp,0,0,1,1,
2025-09-12,John C Rademacher,Option Care Health,6,1,0,7,
2025-09-12,Doug Black,SiteOne Landscape Supply,3,18,2,23,
2025-09-12,Oliver G Brewer III,Topgolf Callaway Brands,1,0,0,1,
2025-09-12,Glenn Sanford,eXp World,16,20,4,40,
2025-09-12,Fran Horowitz,Abercrombie & Fitch,11,22,7,40,
2025-09-12,Kevin Akers,Atmos Energy,7,3,0,10,
2025-09-12,Alessandro Maselli,Catalent,2,11,3,16,
2025-09-12,J Powell Brown,Brown & Brown,13,19,8,40,
2025-09-12,Aman Bhutani,GoDaddy,16,22,2,40,
2025-09-12,John C. Griffith,American Water Works,0,4,0,4,
2025-09-12,John J Marchioni,Selective Insurance Group,5,14,3,22,
2025-09-12,Lawson E Whiting,Brown-Forman,1,7,1,9,
2025-09-12,Dave Peacock,Advantage Solutions,22,8,0,30,
2025-09-12,Mick Farrell,ResMed,17,21,2,40,
2025-09-12,Kamal Hathi,Splunk,2,5,0,7,
2025-09-12,Todd Kelsey,Plexus,3,6,0,9,
2025-09-12,Phillip D Yeager,Hub Group,4,5,0,9,
2025-09-12,Steven B Hedlund,Lincoln Electric,4,6,0,10,
2025-09-12,Timothy C Oliver,NCR Atleos,0,1,0,1,
2025-09-12,Bruce Fleming,Calumet,2,7,0,9,
2025-09-12,Daniel S. Peyovich,Dycom Industries,0,3,0,3,
2025-09-12,Avner M Applbaum,Valmont Industries,0,8,0,8,
2025-09-12,Kimberly A Fields,ATI inc,4,9,0,13,
2025-09-12,Khozema Z Shipchandler,Twilio,0,3,1,4,
2025-09-12,Gary C Bhojwani,CNO Financial Group,1,5,1,7,
2025-09-12,William Andrew Hendricks Jr,Patterson-UTI Energy,0,0,0,0,
2025-09-12,Kevin D Hochman,Brinker International,1,3,0,4,
2025-09-12,James C Foster,Charles River Laboratories International,2,10,0,12,
2025-09-12,Rajiv K Prasad,Hyster-Yale,2,5,0,7,
2025-09-12,Eric T Steigerwalt,Brighthouse Financial,1,1,0,2,
2025-09-12,Thomas L Ryan,Service Corp International,5,4,0,9,
2025-09-12,Charles M Nifong Jr,CrossAmerica Partners,0,0,0,0,
2025-09-12,Anirudh Devgan,Cadence,11,27,2,40,
2025-09-12,Andi Owen,MillerKnoll,16,15,9,40,
2025-09-12,Sumit Roy,Realty Income,16,19,2,37,
2025-09-12,Timothy John Fitzgerald,Middleby,0,0,0,0,
2025-09-12,Robert H Schottenstein,M/I Homes,2,8,0,10,
2025-09-12,Stephen P MacMillan,Hologic,0,8,1,9,
2025-09-12,Lisa M Barton,Alliant Energy,2,0,0,2,
2025-09-12,Aaron P Jagdfeld,Generac,1,6,1,8,
2025-09-12,Erik Gershwind,MSC Industrial Direct,2,6,2,10,
2025-09-12,Varun Krishna,Rocket Companies,8,31,1,40,
2025-09-12,Fahmi Karam,Upbound Group,4,2,0,6,
2025-09-12,NADominic Ng,East West Bancorp,0,0,0,0,
2025-09-12,Mark Wang,Hilton Grand Vacations,38,2,0,40,
2025-09-12,Robert J Sheedy Jr,Grocery Outlet Holding,0,0,0,0,
2025-09-12,Simon D Campion,Dentsply Sirona,0,2,0,2,
2025-09-12,Jeremy Wensinger,V2X,7,8,0,15,
2025-09-12,Andrew Rees,Crocs,15,13,12,40,
2025-09-12,David M Maura,Spectrum Brands,5,0,0,5,
2025-09-12,Sachin S Lawande,Visteon,0,0,0,0,
2025-09-12,Neil M Ashe,Acuity Inc,0,2,0,2,
2025-09-12,Lorie L Tekorius,Greenbrier,1,9,0,10,
2025-09-12,John R Ciulla,Webster Financial,4,5,0,9,
2025-09-12,Sean D Keohane,Cabot Corporation,3,5,0,8,
2025-09-12,Drew M Wilkerson,RXO inc,0,1,0,1,
2025-09-12,Daniel E Brown,Chord Energy,1,0,0,1,
2025-09-12,Javier D Ferrer Fernandez,Popular inc,0,1,0,1,
2025-09-12,Olivier Rabiller,Garrett Motion inc,4,8,0,12,
2025-09-12,Ronald N Tutor,Tutor Perini Corporation,2,5,0,7,
2025-09-12,Jeff Liaw,Copart,4,6,0,10,
2025-09-12,Aman Narang,Toast inc,4,5,1,10,
2025-09-12,Joseph M Hogan,Align Technology,3,5,0,8,
2025-09-12,Kevin J Wheeler,A O Smith,0,17,1,18,
2025-09-12,Christopher A Cartwright,TransUnion,2,0,2,4,
2025-09-12,James Kelly,NCR Voyix,2,12,0,14,
2025-09-12,Tom Leighton,Akamai Technologies,14,14,5,33,
2025-09-12,Robert G Painter,Trimble,6,2,0,8,
2025-09-12,Tony Helton,Medical Mutual of Ohio,2,4,1,7,
2025-09-12,Caroline S Grace,AMN Healthcare Services,0,0,0,0,
2025-09-12,Patrick Kaltenbach,Mettler-Toledo International,1,9,0,10,
2025-09-12,Michael L Baur,ScanSource,0,2,0,2,
2025-09-12,Jason Lippert,LCI Industries,2,12,0,14,
2025-09-12,Fredric J Tomczyk,Cboe Global Markets,1,7,1,9,
2025-09-12,Octavio Marquez,Diebold Nixdorf,5,10,1,16,
2025-09-12,Sivasankaran Somasundaram,ChampionX,5,1,0,6,
2025-09-12,Ronald F Clarke,Corpay,0,0,0,0,
2025-09-12,Robert W Pittman,iHeartMedia,4,4,0,8,
2025-09-12,Patrick Zalupski,Dream Finders Homes,23,15,2,40,
2025-09-12,Keith E Smith,Boyd Gaming,0,6,0,6,
2025-09-12,Mehran Assadi,NLV Financial,1,1,0,2,
2025-09-12,Barry R Port,Ensign Group,2,5,2,9,
2025-09-12,Denise A Paulonis,Sally Beauty,1,1,0,2,
2025-09-12,Clifford A Skelton,Conduent,0,1,0,1,
2025-09-12,Jean-Michel Ribieras,Sylvamo,2,6,0,8,
2025-09-12,Douglas F Bauer,Tri Pointe Homes,0,7,0,7,
2025-09-12,Shawn OConnell,EnerSys,0,1,0,1,
2025-09-12,Bill Meury,Incyte,7,15,0,22,
2025-09-12,Dale Francescon,Century Communities,1,10,3,14,
2025-09-12,Michael Nierenberg,Rithm Capital,10,28,2,40,
2025-09-12,Michael J Brown,Euronet Worldwide,2,7,0,9,
2025-09-12,Scott Seu,Hawaiian Electric Industries,6,15,1,22,
2025-09-12,Jason D Robins,DraftKings,5,2,0,7,
2025-09-12,Jonathan J Mazelsky,IDEXX Laboratories,1,1,1,3,
2025-09-12,Richard S Swartz,MYR Group,0,1,0,1,
2025-09-12,Stefano Caroti,Deckers Outdoor,3,6,1,10,
2025-09-12,Kevin R Sayer,DexCom,2,3,0,5,
2025-09-12,John T C Lee,MKS Instruments,3,8,0,11,
2025-09-12,Edward B Pitoniak,VICI Properties,1,7,0,8,
2025-09-12,Albert White III,Cooper Cos,0,0,0,0,
2025-09-12,Barry L Biffle,Frontier Airlines,1,4,6,11,
2025-09-12,Robert A Bruggeworth,Qorvo,5,4,0,9,
2025-09-12,Winnie Park,Five Below,10,26,4,40,
2025-09-12,Steven Oakland,TreeHouse Foods,2,11,0,13,
2025-09-12,James S Hagedorn,Scotts Miracle-Gro,1,0,0,1,
2025-09-12,Michael Cannon-Brookes,Atlassian,19,20,0,39,
2025-09-12,Bertrand Loy,Entegris,3,9,1,13,
2025-09-12,William E Waltz,Atkore,3,6,0,9,
2025-09-12,Celeste B Mastin,H B Fuller,0,3,0,3,
2025-09-12,Kyle T Larkin,Granite Construction,1,6,0,7,
2025-09-12,Michael J Happe,Winnebago Industries,1,3,0,4,
2025-09-12,Steven H Gunby,FTI Consulting,5,11,0,16,
2025-09-12,Stephan B Tanda,AptarGroup,1,5,2,8,
2025-09-12,Timothy P Boyle,Columbia Sportswear,4,3,2,9,
2025-09-12,Anthony J Wood,Roku,5,2,1,8,
2025-09-12,M Christopher Doyle,Civitas Resources,1,2,0,3,
2025-09-12,Andy Eidson,Alpha Metallurgical Resources,0,6,2,8,
2025-09-12,Andy L Nemeth,Patrick Industries,4,3,0,7,
2025-09-12,Roger W Jenkins,Murphy Oil,4,16,0,20,
2025-09-12,Kevin S Blair,Synovus Financial,6,3,1,10,
2025-09-12,Julie Felss Masino,Cracker Barrel Old Country Store,12,16,12,40,
2025-09-12,David M Overton,Cheesecake Factory,1,9,0,10,
2025-09-12,Nick DeIuliis,CNX Resources,7,1,1,9,
2025-09-12,Christopher Pappas,Chefs Warehouse,4,10,1,15,
2025-09-12,Tod Carpenter,Donaldson Company,1,8,0,9,
2025-09-12,Gregory L Christopher,Mueller Industries,2,6,0,8,
2025-09-12,Rob Saltiel,MRC Global,4,12,1,17,
2025-09-12,Jillian C Evanko,Chart Industries,3,7,0,10,
2025-09-12,Dave Guilmette,Alight Solutions,3,6,0,9,
2025-09-12,Joel Smejkal,Vishay Intertechnology,4,4,1,9,
2025-09-12,Dennis Degner,Range Resources,3,8,0,11,
2025-09-12,Ira D Robbins,Valley National Bancorp,1,2,0,3,
2025-09-12,Bernard Kim,Match Group,14,19,7,40,
2025-09-12,Vincent Pilette,Gen Digital,4,10,0,14,
2025-09-12,Timothy S Crane,Wintrust Financial,2,6,1,9,
2025-09-12,Pat Roche,Moog inc,3,11,2,16,
2025-09-12,Mark R Widmar,First Solar,3,5,2,10,
2025-09-12,Niko Lahanas,Central Garden & Pet,2,12,0,14,
2025-09-12,Chris Osowski,Green Plains inc,5,9,1,15,
2025-09-12,Derek J Leathers,Werner Enterprises,1,7,0,8,
2025-09-12,Adam Foroughi,AppLovin,9,27,4,40,
2025-09-12,Luca Savi,ITT,2,8,0,10,
2025-09-12,Lawrence H Silber,Herc Rentals,0,0,0,0,
2025-09-12,Hilton H Howell Jr,Gray Television,7,21,1,29,
2025-09-12,Eric D Ashleman,IDEX,0,9,1,10,
2025-09-12,Owen D Thomas,Boston Properties,2,8,0,10,
2025-09-12,Kurt Wolf,Pitney Bowes,7,17,1,25,
2025-09-12,Sara E Armbruster,Steelcase,1,0,0,1,
2025-09-12,Charles D. Young,Sun Communities,2,5,0,7,
2025-09-12,Suzanne Foster,AdaptHealth,5,9,1,15,
2025-09-12,Grant E Sims,Genesis Energy,2,2,0,4,
2025-09-12,Laura Prieskorn,Jackson Financial,2,6,2,10,
2025-09-12,Rick L Wessel,FirstCash,3,6,1,10,
2025-09-12,Sherman Miller,Cal-Maine Foods,12,28,0,40,
2025-09-12,Paul A Lang,Arch Resources,4,4,0,8,
2025-09-12,Ashish K Khandpur,Avient,2,7,0,9,
2025-09-12,Shyam K Reddy,BlueLinx,2,6,0,8,
2025-09-12,Christopher S Ripley,Sinclair,1,8,0,9,
2025-09-12,Stacy Kymes,BOK Financial,9,6,0,15,
2025-09-12,James H Walter,Permian Resources,0,0,0,0,
2025-09-12,Jason Murray,PACS Group,4,13,2,19,
2025-09-12,Brian Armstrong,Coinbase Global,13,21,6,40,
2025-09-12,Oscar K Brown,Western Midstream Partners,1,3,0,4,
2025-09-12,Nicholas R Lower,Federated Mutual Insurance,0,1,0,1,
2025-09-12,Morris Goldfarb,G-III Apparel Group,9,26,5,40,
2025-09-12,Mark D Morelli,Vontier,0,3,0,3,
2025-09-12,Matthew J Cox,Matson inc,2,5,0,7,
2025-09-12,David W Grzebinski,Kirby Corporation,1,3,0,4,
2025-09-12,Keith A Harvey,Kaiser Aluminum,5,4,1,10,
2025-09-12,Eric Nyman,Vista Outdoor,3,10,1,14,
2025-09-12,Doug Howe,Designer Brands,5,20,0,25,
2025-09-12,Jerry E Gahlhoff Jr,Rollins inc,0,2,0,2,
2025-09-12,D Scott Barbour,Advanced Drainage Systems,2,2,0,4,
2025-09-12,Sean Gamble,Cinemark,17,21,2,40,
2025-09-12,George Kurtz,CrowdStrike,13,24,3,40,
2025-09-12,Bill Ready,Pinterest,23,17,0,40,
2025-09-12,Fidji Simo,Instacart,8,31,1,40,
2025-09-12,Kimberly K Ryan,Hillenbrand,3,6,0,9,
2025-09-12,David S Graziosi,Allison Transmission,1,19,3,23,
2025-09-12,Gary G Friedman,Restoration Hardware,1,4,0,5,
2025-09-12,Lucinda M Baier,Brookdale Senior Living,4,3,1,8,
2025-09-12,Brian J Blaser,QuidelOrtho,2,8,0,10,
2025-09-12,E Jean Savage,Trinity Industries,0,8,1,9,
2025-09-12,Liam J Kelly,Teleflex,1,3,1,5,
2025-09-12,Laurans A Mendelson,HEICO,7,19,0,26,
2025-09-12,Frank H Laukien,Bruker,2,7,0,9,
2025-09-12,Harvey M Schwartz,Carlyle Group,5,13,0,18,
2025-09-12,Mark S LaVigne,Energizer,2,1,0,3,
2025-09-12,Joel Quadracci,Quad/Graphics,10,23,5,38,
2025-09-12,Amar Maletira,Rackspace Technology,5,11,2,18,
2025-09-12,Udit Batra,Waters Corporation,10,22,0,32,
2025-09-12,Eric M Green,West Pharmaceutical Services,3,7,0,10,
2025-09-12,Doug Palladini,Carters inc,2,2,2,6,
2025-09-12,G Mike Mikan,NeueHealth,4,2,0,6,
2025-09-12,Russell ChipChilds,SkyWest,0,0,0,0,
2025-09-12,Christopher H Hunter,Acadia Healthcare,0,2,0,2,
2025-09-12,Prahlad Singh,Revvity,3,7,0,10,
2025-09-12,Maria M Pope,Portland General Electric,1,2,0,3,
2025-09-12,Charles Chip Blankenship,Woodward inc,0,1,0,1,
2025-09-12,Mike Steib,TEGNA,15,14,1,30,
2025-09-12,Kurt J Ekert,Sabre Corporation,0,0,0,0,
2025-09-12,Matt Wilson,Light & Wonder,15,19,6,40,
2025-09-12,Rob Katz,Vail Resorts,3,12,25,40,
2025-09-12,Schnitzer Steel Industries,Radius Recycling,6,26,5,37,
2025-09-12,David A Spector,PennyMac Financial Services,6,2,0,8,
2025-09-12,Frederick J Holzgrefe III,Saia inc,1,1,0,2,
2025-09-12,Mark J Parrell,Equity Residential,3,7,0,10,
2025-09-12,John W Lindsay,Helmerich & Payne,0,6,0,6,
2025-09-12,Gary D Burnison,Korn Ferry,4,14,0,18,
2025-09-12,Timothy J McGrath,PC Connection Inc,1,2,0,3,
2025-09-12,Lynn M Bamford,Curtiss-Wright,13,9,0,22,
2025-09-12,Jonathan W Witter,Sallie Mae,0,1,0,1,
2025-09-12,Jeff Benck,Benchmark Electronics,4,9,0,13,
2025-09-12,Charles H Giancarlo,Pure Storage,0,4,0,4,
2025-09-12,Brian R Gray,Knife River Corporation,0,1,0,1,
2025-09-12,Jay Schmidt,Caleres inc,3,5,2,10,
2025-09-12,Dale Asplund,BrightView Holdings,1,7,0,8,
2025-09-12,Jeffrey S Edwards,Cooper-Standard,0,7,0,7,
2025-09-12,Glenn J Williams,Primerica,6,2,2,10,
2025-09-12,Francois Locoh-Donou,F5,7,22,2,31,
2025-09-12,Joseph Wm Foran,Matador Resources,7,9,0,16,
2025-09-12,Sridhar Ramaswamy,Snowflake inc,11,18,3,32,
2025-09-12,Mark D Dankberg,Viasat,2,6,2,10,
2025-09-12,Francisco J Leon,California Resources,1,3,1,5,
2025-09-12,Peter Stern,Peloton,19,17,4,40,
2025-09-12,David Baszucki,Roblox,8,22,10,40,
2025-09-12,Jeffrey W Edwards,Installed Building Products,0,1,0,1,
2025-09-12,Clark Lauritzen,First National of Nebraska,1,7,0,8,
2025-09-12,Carlos Alberini,Guess inc,12,27,1,40,
2025-09-12,Shyam P Kambeyanda,ESAB,4,3,0,7,
2025-09-12,Edmund Shallcross III,Amica Mutual Insurance,0,4,0,4,
2025-09-12,Benjamin W Schall,AvalonBay Communities,1,5,1,7,
2025-09-12,Allan C Thygesen,DocuSign,3,5,0,8,
2025-09-12,Bryan J Knutson,Titan Machinery,1,1,0,2,
2025-09-12,Heath Sampson,ModivCare,8,1,1,10,
2025-09-12,Ara K Hovnanian,Hovnanian Enterprises,1,15,2,18,
2025-09-12,Joshua G Silverman,Etsy,1,2,0,3,
2025-09-12,Kevin Roycraft,Adams Resources & Energy,5,4,1,10,
2025-09-12,J Eric Evans,Surgery Partners,0,4,0,4,
2025-09-12,Clint E Stein,Columbia Banking System,1,5,0,6,
2025-09-12,Lee M Shavel,Verisk Analytics,2,7,0,9,
2025-09-12,Dave Banyard Jr,MasterBrand,0,0,0,0,
2025-09-12,Peter R Ingram,Hawaiian Airlines inc,1,0,0,1,
2025-09-12,Kristin A Dolan,AMC Networks,3,2,0,5,
2025-09-12,Brendan T Cavanagh,SBA Communications,1,2,0,3,
2025-09-12,George F Chappelle Jr,Americold Realty Trust,2,3,0,5,
2025-09-12,Thomas E Gottwald,NewMarket Corporation,2,8,0,10,
2025-09-12,Thomas J Baltimore Jr,Park Hotels & Resorts,4,29,1,34,
2025-09-12,Peter M Moglia,Alexandria Real Estate Equities,3,4,0,7,
2025-09-12,Ronald J Kramer,Griffon Corporation,1,7,1,9,
2025-09-12,John L Plueger,Air Lease,2,13,0,15,
2025-09-12,Jennifer F Scanlon,UL Solutions,1,5,0,6,
2025-09-12,Greg Smith,Teradyne,1,7,2,10,
2025-09-12,Sean Trauschke,OGE Energy,18,3,0,21,
2025-09-12,Norman D Schwartz,Bio-Rad Laboratories,0,0,1,1,
2025-09-12,Scott Doyle,Spire inc,4,5,1,10,
2025-09-12,Michael E Reed,Gannett,0,4,2,6,
2025-09-12,Cindy J Miller,Stericycle,2,4,2,8,
2025-09-12,Phillip D Green,Cullen Frost Bankers,1,3,3,7,
2025-09-12,Joseph D Margolis,Extra Space Storage,1,7,1,9,
2025-09-12,Mark A Skonieczny,REV Group,4,6,0,10,
2025-09-12,Ladd Wilks,ProFrac Holding,3,3,0,6,
2025-09-12,Sundaram Nagarajan,Nordson,0,10,0,10,
2025-09-12,Anne P Noonan,Summit Materials,0,1,0,1,
2025-09-12,Lori Flees,Valvoline inc,4,4,1,9,
2025-09-12,Scott H Baxter,Kontoor Brands,2,1,0,3,
2025-09-12,Tim Larson,Skyline Champion,8,0,0,8,
2025-09-12,Chuck Divita,Teladoc Health,11,19,5,35,
2025-09-12,W Bradley Southern,Louisiana-Pacific Corporation,0,0,0,0,
2025-09-12,George C Freeman III,Universal Corporation,2,7,0,9,
2025-09-12,James A Brock,Consol Energy,1,0,0,1,
2025-09-12,Robert Antokol,Playtika Holding,0,7,1,8,
2025-09-12,Joe Craft,Alliance Resource Partners,6,10,2,18,
2025-09-12,Paul Keel,Envista,2,6,1,9,
2025-09-12,Jared Isaacman,Shift4 Payments,7,28,5,40,
2025-09-12,Mark Mac McFarland,Talen Energy,3,0,1,4,
2025-09-12,Tony R Thene,Carpenter Technology,2,7,0,9,
2025-09-12,Melissa D Smith,WEX,2,5,1,8,
2025-09-12,James Jim C Ryan III,Old National Bancorp,1,0,0,1,
2025-09-12,Peter J Federico,AGNC Investment,1,0,0,1,
2025-09-12,Brent L Yeagy,Wabash National,0,1,0,1,
2025-09-12,Henry A Fernandez,MSCI,2,17,0,19,
2025-09-12,Mark Penn,Stagwell,13,22,5,40,
2025-09-12,Julie Schertell,Mativ,2,8,0,10,
2025-09-12,Ashish Chand,Belden,3,6,1,10,
2025-09-12,Greg Anderson,Allegiant Travel Company,5,7,0,12,
2025-09-12,Drew Houston,Dropbox,15,18,7,40,
2025-09-12,Kevin T Conroy,Exact Sciences,2,5,2,9,
2025-09-12,Rex D Geveden,BWX Technologies,2,7,0,9,
2025-09-12,Scott R Wells,Clear Channel Outdoor Hldgs,0,0,0,0,
2025-09-12,Paul Bay,Ingram Micro,10,26,4,40,
2025-09-13,Doug McMillon,Walmart,15,18,7,40,
2025-09-13,Andrew Jassy,Amazon,4,29,6,39,
2025-09-13,Tim Cook,Apple,12,27,1,40,
2025-09-13,Stephen Hemsley,UnitedHealth,8,28,4,40,
2025-09-13,Warren Buffett,Berkshire Hathaway,14,19,6,39,
2025-09-13,David Joyner,CVS Health,6,29,5,40,
2025-09-13,Darren Woods,Exxon Mobil,11,21,7,39,
2025-09-13,Sundar Pichai,Alphabet,16,19,5,40,
2025-09-13,Brian Tyler,McKesson,6,16,5,27,
2025-09-13,Robert Mauch,Cencora,2,8,0,10,
2025-09-13,Ron Vachris,Costco,7,31,2,40,
2025-09-13,Jamie Dimon,JPMorgan Chase,5,21,14,40,
2025-09-13,Satya Nadella,Microsoft,16,20,4,40,
2025-09-13,Jason Hollar,Cardinal Health,15,21,4,40,
2025-09-13,Mike Wirth,Chevron,18,15,7,40,
2025-09-13,David Cordani,Cigna,21,16,3,40,
2025-09-13,Jim Farley,Ford Motor,15,18,7,40,
2025-09-13,Brian Moynihan,Bank of America,7,29,4,40,
2025-09-13,Mary Barra,General Motors,13,25,2,40,
2025-09-13,Gail Boudreaux,Elevance Health,16,16,8,40,
2025-09-13,Jane Fraser,Citigroup,15,21,4,40,
2025-09-13,Sarah London,Centene,13,18,9,40,
2025-09-13,Ted Decker,Home Depot,11,24,5,40,
2025-09-13,Maryann Mannen,Marathon Petroleum,8,14,1,23,
2025-09-13,Ron Sargent,Kroger,5,23,12,40,
2025-09-13,Mark Lashier,Phillips 66,11,20,7,38,
2025-09-13,Priscilla Almodovar,Fannie Mae,10,16,14,40,
2025-09-13,Tim Wentworth,Walgreens,7,24,9,40,
2025-09-13,Lane Riggs,Valero Energy,14,8,0,22,
2025-09-13,Mark Zuckerberg,Meta,6,19,15,40,
2025-09-13,Hans Vestberg,Verizon,16,20,4,40,
2025-09-13,John Stankey,AT&T,9,26,5,40,
2025-09-13,Brian Roberts,Comcast,11,23,6,40,
2025-09-13,Charles Scharf,Wells Fargo,26,6,8,40,
2025-09-13,David Solomon,Goldman Sachs,8,18,14,40,
2025-09-13,Michael Hutchins,Freddie Mac,2,10,3,15,
2025-09-13,Michael Fiddelke,Target,8,25,7,40,
2025-09-13,Jim Rechtin,Humana,20,15,5,40,
2025-09-13,Jon Farney,State Farm Insurance,1,14,3,18,
2025-09-13,Elon Musk,Tesla,4,22,14,40,
2025-09-13,Ted Pick,Morgan Stanley,18,20,2,40,
2025-09-13,Joaquin Duato,Johnson & Johnson,12,25,3,40,
2025-09-13,Juan Luciano,Archer Daniels Midland,4,21,12,37,
2025-09-13,Ramon Laguarta,PepsiCo,8,28,4,40,
2025-09-13,Carol Tom√©,UPS,5,24,11,40,
2025-09-13,Rajesh Subramaniam,FedEx,10,28,0,38,
2025-09-13,Bob Iger,Walt Disney,9,29,2,40,
2025-09-13,Michael Dell,Dell Technologies,10,25,5,40,
2025-09-13,Marvin Ellison,Lowes,13,27,0,40,
2025-09-13,Jon Moeller,Procter & Gamble,4,28,8,40,
2025-09-13,Thomas Long,Energy Transfer,9,0,1,10,
2025-09-13,Kelly Ortberg,Boeing,9,27,4,40,
2025-09-13,Susan Morris,Albertsons,14,22,4,40,
2025-09-13,Kevin Hourican,Sysco,8,28,4,40,
2025-09-13,Christopher Calio,RTX,6,10,0,16,
2025-09-13,Larry Culp,General Electric,10,27,3,40,
2025-09-13,James Taiclet,Lockheed Martin,14,19,7,40,
2025-09-13,Stephen Squeri,American Express,15,24,1,40,
2025-09-13,Joe Creed,Caterpillar,9,28,3,40,
2025-09-13,Michel Khalaf,MetLife,11,17,0,28,
2025-09-13,Samuel Hazen,HCA Healthcare,8,5,0,13,
2025-09-13,Tricia Griffith,Progressive Insurance,9,26,5,40,
2025-09-13,Arvind Krishna,IBM,12,22,6,40,
2025-09-13,John May,Deere,7,25,8,40,
2025-09-13,Jensen Huang,Nvidia,12,24,4,40,
2025-09-13,Philip Smith,StoneX,0,10,0,10,
2025-09-13,Robert M Davis,Merck,4,20,0,24,
2025-09-13,Ryan Lance,ConocoPhillips,16,20,4,40,
2025-09-13,Albert Bourla,Pfizer,21,13,6,40,
2025-09-13,Ed Bastian,Delta Air Lines,13,17,10,40,
2025-09-13,Patrick Zammit,TD Synnex,9,13,0,22,
2025-09-13,Kevin Murphy,Publix Super Markets,10,19,1,30,
2025-09-13,Thomas J Wilson,Allstate,1,7,1,9,
2025-09-13,Chuck Robbins,Cisco Systems,15,22,3,40,
2025-09-13,Kirt Walker,Nationwide Insurance,4,6,0,10,
2025-09-13,Christopher Winfrey,Charter Communications,5,13,5,23,
2025-09-13,Bob Michael,AbbVie,0,0,0,0,
2025-09-13,Craig DeSanto,New York Life Insurance,2,21,0,23,
2025-09-13,Lip-Bu Tan,Intel,7,25,8,40,
2025-09-13,Ernie Herrman,TJX,16,22,2,40,
2025-09-13,Andrew Sullivan,Prudential Financial,13,18,0,31,
2025-09-13,Enrique Lores,Hewlett Packard,9,18,5,32,
2025-09-13,Scott Kirby,United Airlines,30,7,3,40,
2025-09-13,George Holm,Performance Food,8,21,2,31,
2025-09-13,Donnie King,Tyson Foods,9,26,5,40,
2025-09-13,Robert Isom,American Airlines,8,24,8,40,
2025-09-13,Timothy M Sweeney,Liberty Mutual Insurance,11,0,0,11,
2025-09-13,Elliott Hill,Nike,11,28,1,40,
2025-09-13,Safra Catz,Oracle,25,12,3,40,
2025-09-13,AJ Jim Teague,Enterprise Products Partners,5,12,0,17,
2025-09-13,Richard Fairbank,Capital One,16,21,3,40,
2025-09-13,Willie Chiang,Plains GP,3,5,1,9,
2025-09-13,Michael Kasbar,World Kinect,2,8,0,10,
2025-09-13,Peter Zaffino,American International Group,9,26,5,40,
2025-09-13,James Quincey,The Coca-Cola Company,10,27,3,40,
2025-09-13,Thasunda Brown Duckett,TIAA,20,19,1,40,
2025-09-13,Jay Debertin,CHS,5,11,4,20,
2025-09-13,Chris Boerner,Bristol-Myers Squibb,8,25,7,40,
2025-09-13,Corie Barry,Best Buy,39,1,0,40,
2025-09-13,Marc Casper,Thermo Fisher Scientific,15,22,3,40,
2025-09-13,Roger Crandall,Mass Mutual,2,8,0,10,
2025-09-13,Juan Andrade,USAA,5,18,0,23,
2025-09-13,Phebe Novakovic,General Dynamics,29,8,3,40,
2025-09-13,Alan Schnitzer,Travelers Insurance,3,4,2,9,
2025-09-13,David Zaslav,Warner Bros Discovery,4,33,3,40,
2025-09-13,Gunjan Kedia,US Bancorp,15,23,2,40,
2025-09-13,Robert Ford,Abbott Laboratories,13,21,6,40,
2025-09-13,Kathy Warden,Northrop Grumman,13,23,4,40,
2025-09-13,Tim Gerend,Northwestern Mutual,13,26,1,40,
2025-09-13,Todd Vasos,Dollar General,5,26,9,40,
2025-09-13,Matthew Lucey,PBF Energy,7,2,0,9,
2025-09-13,Dara Khosrowshahi,Uber,14,21,5,40,
2025-09-13,Vimal Kapur,Honeywell,11,29,0,40,
2025-09-13,Dirk Van de Put,Mondelez,8,29,3,40,
2025-09-13,Brian Niccol,Starbucks,8,28,4,40,
2025-09-13,Cristiano Amon,Qualcomm,11,27,2,40,
2025-09-13,Hock Tan,Broadcom,13,25,2,40,
2025-09-13,David Flitman,US Foods,3,7,0,10,
2025-09-13,Paul Romanowski,DR Horton,6,16,5,27,
2025-09-13,Jacek Olczak,Philip Morris,13,24,3,40,
2025-09-13,Preston Feight,Paccar,5,27,0,32,
2025-09-13,Marc Benioff,Salesforce,8,19,13,40,
2025-09-13,Leon Topalian,Nucor,14,23,3,40,
2025-09-13,Michael Dastoor,Jabil,3,5,0,8,
2025-09-13,Jonathan Jaffe,Lennar,2,6,2,10,
2025-09-13,David Ricks,Eli Lilly,8,22,10,40,
2025-09-13,Joe Zubretsky,Molina Healthcare,10,3,4,17,
2025-09-13,Jennifer Rumsey,Cummins,7,28,5,40,
2025-09-13,Robin Vince,Bank of New York Mellon,19,20,1,40,
2025-09-13,Ted Sarandos,Netflix,15,23,2,40,
2025-09-13,William H Rogers Jr,Truist Financial,3,7,0,10,
2025-09-13,Sean Kerins,Arrow Electronics,1,10,0,11,
2025-09-13,William M Brown,3M,2,8,0,10,
2025-09-13,Ryan McInerney,Visa,13,23,4,40,
2025-09-13,Marc Rowan,Apollo Global Management,13,22,5,40,
2025-09-13,Tim Go,HF Sinclair,6,3,0,9,
2025-09-13,Robert Sulentic,CBRE Group,1,7,1,9,
2025-09-13,William Demchak,PNC Financial Services,15,20,5,40,
2025-09-13,Bryan DeBoer,Lithia Motors,3,34,3,40,
2025-09-13,William Nash,CarMax,3,5,2,10,
2025-09-13,Brian Robbins,Paramount Global,10,29,1,40,
2025-09-13,Michael Creedon,Dollar Tree,7,32,1,40,
2025-09-13,Sandy Douglas,United Natural Foods,34,5,1,40,
2025-09-13,Alex Chriss,PayPal,13,23,4,40,
2025-09-13,Roger Penske,Penske Automotive,17,22,1,40,
2025-09-13,Antonio Neri,Hewlett Packard Enterprise,9,25,6,40,
2025-09-13,Harry Sideris,Duke Energy,36,4,0,40,
2025-09-13,Vicki Hollub,Occidental Petroleum,19,17,4,40,
2025-09-13,Lawrence Coben,NRG Energy,5,3,0,8,
2025-09-13,Robert Bradway,Amgen,10,27,3,40,
2025-09-13,John Ketchum,NextEra Energy,23,17,0,40,
2025-09-13,Rainer Blair,Danaher,6,15,2,23,
2025-09-13,Daniel ODay,Gilead Sciences,1,8,1,10,
2025-09-13,Michael Manley,AutoNation,3,6,1,10,
2025-09-13,Carlos Abrams-Rivera,Kraft Heinz,10,24,6,40,
2025-09-13,Philip Gallagher,Avnet,1,5,0,6,
2025-09-13,Gary Dickerson,Applied Materials,6,19,15,40,
2025-09-13,Bob Jordan,Southwest Airlines,9,24,7,40,
2025-09-13,Rick Wurster,Charles Schwab,14,22,3,39,
2025-09-13,Lorenzo Simonelli,Baker Hughes,17,20,3,40,
2025-09-13,Chris Kempczinski,McDonalds,9,23,8,40,
2025-09-13,Christopher Womack,Southern Company,2,8,0,10,
2025-09-13,Michael Miebach,Mastercard,12,25,3,40,
2025-09-13,Joseph Dominguez,Constellation Energy,14,10,1,25,
2025-09-13,Christopher Swift,The Hartford,13,24,3,40,
2025-09-13,Patricia Poppe,PG&E,8,14,2,24,
2025-09-13,Bom Kim,Coupang,10,29,1,40,
2025-09-13,Ezra Yacob,EOG Resources,24,14,2,40,
2025-09-13,Jim Vena,Union Pacific,15,24,1,40,
2025-09-13,Matt Schroeder,Rite Aid,4,33,3,40,
2025-09-13,Tony Spring,Macys,10,26,4,40,
2025-09-13,Anthony Capuano,Marriott International,12,26,2,40,
2025-09-13,Raymond E Scott,Lear Corporation,3,6,1,10,
2025-09-13,William Stengel II,Genuine Parts,0,4,0,4,
2025-09-13,Heidi Petz,Sherwin-Williams,10,27,2,39,
2025-09-13,Jeff Miller,Halliburton,13,22,5,40,
2025-09-13,Kathleen Quirk,Freeport-McMoRan,14,18,2,34,
2025-09-13,Michael Rapino,Live Nation Entertainment,15,22,3,40,
2025-09-13,John Doyle,Marsh & McLennan,10,6,1,17,
2025-09-13,Lisa Su,Advanced Micro Devices,15,20,5,40,
2025-09-13,Frank Holding,First Citizens BancShares,9,15,2,26,
2025-09-13,John Engel,WESCO International,4,14,1,19,
2025-09-13,David Gitlin,Carrier Global,14,24,2,40,
2025-09-13,Lourenco Goncalves,Cleveland-Cliffs,5,20,15,40,
2025-09-13,Calvin G Butler Jr,Exelon,6,4,0,10,
2025-09-13,Joseph Bae,KKR & Co,8,7,1,16,
2025-09-13,Christine Leahy,CDW,0,7,2,9,
2025-09-13,Glenn Fogel,Booking Holdings,12,22,6,40,
2025-09-13,Brian Doubles,Synchrony Financial,4,7,2,13,
2025-09-13,Earl Austin,Quanta Services,2,5,2,9,
2025-09-13,Christian Ulbrich,Jones Lang LaSalle,8,14,0,22,
2025-09-13,Saumya Sutaria,Tenet Healthcare,6,2,1,9,
2025-09-13,William Gifford,Altria Group,2,7,1,10,
2025-09-13,Kevin Lobo,Stryker,12,25,3,40,
2025-09-13,Michael Hsu,Kimberly-Clark,5,6,1,12,
2025-09-13,Jack Fusco,Cheniere Energy,18,18,4,40,
2025-09-13,James Conroy,Ross Stores,4,14,0,18,
2025-09-13,Anthony Smurfit,Smurfit Westrock,2,6,0,8,
2025-09-13,Jeffrey Harmening,General Mills,3,18,5,26,
2025-09-13,Mark Stewart,Goodyear Tire & Rubber,3,37,0,40,
2025-09-13,Bob Eddy,BJs Wholesale Club,3,20,3,26,
2025-09-13,Peter Arduini,GE HealthCare Technologies,4,8,0,12,
2025-09-13,Noel Wallace,Colgate-Palmolive,10,20,2,32,
2025-09-13,Marc Bitzer,Whirlpool,12,15,13,40,
2025-09-13,Chris Kubasik,L3Harris Technologies,7,13,1,21,
2025-09-13,Shantanu Narayen,Adobe,19,19,1,39,
2025-09-13,Thomas Polen,Becton Dickinson,6,4,0,10,
2025-09-13,Richard P Dealy,Pioneer Natural Resources,7,3,0,10,
2025-09-13,Ravi Kumar S,Cognizant Technology Solutions,10,20,3,33,
2025-09-13,Andrew Clyde,Murphy USA,14,25,1,40,
2025-09-13,Mike Lyons,Fiserv,4,11,0,15,
2025-09-13,Jennifer Parmentier,Parker-Hannifin,2,12,0,14,
2025-09-13,William Fehrman,American Electric Power,3,7,0,10,
2025-09-13,Andrew Silvernail,International Paper,5,23,0,28,
2025-09-13,Jonas Prising,ManpowerGroup,7,23,2,32,
2025-09-13,John Zillmer,Aramark,7,13,2,22,
2025-09-13,Mark Millett,Steel Dynamics,17,2,0,19,
2025-09-13,Dan Amos,Aflac,13,17,10,40,
2025-09-13,Tony Cheng,Reinsurance Group of America,2,9,2,13,
2025-09-13,Karsanbhai,Emerson Electric,8,15,2,25,
2025-09-13,Ronald P OHanley,State Street,0,4,0,4,
2025-09-13,Timothy Knavish,PPG Industries,0,1,0,1,
2025-09-13,David Burritt,United States Steel,9,20,10,39,
2025-09-13,Maria Black,Automatic Data Processing,6,3,0,9,
2025-09-13,Daryl Kenningham,Group 1 Automotive,8,30,2,40,
2025-09-13,Robert Blue,Dominion Energy,27,12,1,40,
2025-09-13,Larry Fink,BlackRock,10,24,6,40,
2025-09-13,Pierce Norton II,Oneok,5,3,1,9,
2025-09-13,David Bozeman,CH Robinson Worldwide,2,8,0,10,
2025-09-13,Haviv Ilan,Texas Instruments,12,25,3,40,
2025-09-13,Michael Bender,Kohls,0,14,8,22,
2025-09-13,Philip Daniele III,AutoZone,0,2,0,2,
2025-09-13,Timothy Archer,Lam Research,3,7,0,10,
2025-09-13,Charles Magro,Corteva,5,3,1,9,
2025-09-13,Rick Lanoha,Peter Kiewit Sons,0,2,0,2,
2025-09-13,Peter Jackson,Builders FirstSource,4,12,1,17,
2025-09-13,Martin Schroeter,Kyndryl,10,29,0,39,
2025-09-13,Hamid Akhavan,EchoStar,5,26,9,40,
2025-09-13,Bill Westrate,American Family Insurance,10,16,2,28,
2025-09-13,Avigal Soreq,Delek US,4,9,5,18,
2025-09-13,Beth Ford,Land OLakes,4,6,1,11,
2025-09-13,Walker Martin,Sempra,0,2,0,2,
2025-09-13,Eric Slifka,Global Partners,11,23,6,40,
2025-09-13,DG Macpherson,WW Grainger,2,7,1,10,
2025-09-13,Bob Pragada,Jacobs Solutions,5,9,0,14,
2025-09-13,Pedro Pizarro,Edison International,16,7,17,40,
2025-09-13,William Hornbuckle,MGM Resorts International,9,25,1,35,
2025-09-13,Andrew McMahon,Guardian Life insurance,5,12,0,17,
2025-09-13,Christopher OHerlihy,Illinois Tool Works,0,1,0,1,
2025-09-13,James Cracchiolo,Ameriprise Financial,2,22,2,26,
2025-09-13,Ryan Marshall,PulteGroup,9,15,10,34,
2025-09-13,Matthew Meloy,Targa Resources,5,5,0,10,
2025-09-13,Michael Rhodes,Ally Financial,7,28,5,40,
2025-09-13,Joseph Fadool,BorgWarner,4,11,0,15,
2025-09-13,St√©phane de La Faverie,Est√©e Lauder,16,20,4,40,
2025-09-13,Benjamin Tisch,Loews,2,7,0,9,
2025-09-13,Brad Beckham,OReilly Automotive,2,8,0,10,
2025-09-13,Thomas Gayner,Markel Group,2,8,0,10,
2025-09-13,Donald Allan,Stanley Black & Decker,8,30,2,40,
2025-09-13,Sanjay Mehrotra,Micron Technology,18,20,2,40,
2025-09-13,James Breuer,Fluor,0,1,1,2,
2025-09-13,Thomas Bell,Leidos,10,18,2,30,
2025-09-13,Scott Smith,Viatris,6,4,0,10,
2025-09-13,Kimberly Dang,Kinder Morgan,10,1,0,11,
2025-09-13,Christophe Beck,Ecolab,19,21,0,40,
2025-09-13,Brent Shafer,Baxter International,1,10,0,11,
2025-09-13,Clay Gaspar,Devon Energy,21,3,0,24,
2025-09-13,Steven Cahillane,Kellanova,1,7,0,8,
2025-09-13,Raul Nicholas Vargas Ochoa,Farmers Insurance Exchange,0,0,0,0,
2025-09-13,Darren Rebelez,Caseys General Stores,3,6,0,9,
2025-09-13,Ari Bousbib,IQVIA,6,16,0,22,
2025-09-13,Jon Vander Ark,Republic Services,11,19,10,40,
2025-09-13,Timothy Cofer,Keurig Dr Pepper,2,6,1,9,
2025-09-13,Karla Lewis,Reliance Inc,5,5,0,10,
2025-09-13,David Hult,Asbury Automotive Group,6,33,1,40,
2025-09-13,Darryl Button,Pacific Life,0,8,0,8,
2025-09-13,James Burke,Vistra,7,3,0,10,
2025-09-13,John Barrett,Western & Southern Financial,11,27,2,40,
2025-09-13,William Krueger,The Andersons Inc,0,2,0,2,
2025-09-13,Erik Nordstrom,Nordstrom,5,29,6,40,
2025-09-13,John Wren,Omnicom Group,14,20,6,40,
2025-09-13,Stephanie Ferris,Fidelity National Information Services,15,23,2,40,
2025-09-13,Timothy Cawley,Consolidated Edison,4,6,0,10,
2025-09-13,Joseph Hinrichs,CSX,7,9,1,17,
2025-09-13,Troy Rudd,AECOM,7,25,4,36,
2025-09-13,Kathleen Johnson,Lumen Technologies,4,5,1,10,
2025-09-13,Harry Lawton III,Tractor Supply,1,0,0,1,
2025-09-13,Raul Fernandez,DXC Technology,4,21,1,26,
2025-09-13,Eric Hansotia,AGCO,13,26,1,40,
2025-09-13,David Bruton Smith,Sonic Automotive,3,7,9,19,
2025-09-13,Sasan Goodarzi,Intuit,12,24,4,40,
2025-09-13,Matthew Flannery,United Rentals,32,1,0,33,
2025-09-13,Marc Miller,Universal Health Services,4,23,3,30,
2025-09-13,Michael Mahoney,Boston Scientific,12,28,0,40,
2025-09-13,Judith Marks,Otis Worldwide,2,4,0,6,
2025-09-13,Robert Frenzel,Xcel Energy,4,2,1,7,
2025-09-13,Penny Pennington,Edward Jones,6,29,5,40,
2025-09-13,Daniel Fisher,Ball,1,19,6,26,
2025-09-13,Justin Jude,LKQ,4,6,1,11,
2025-09-13,James Blackledge,Mutual of Omaha,1,33,2,36,
2025-09-13,Bruce Bodine,Mosaic,3,7,0,10,
2025-09-13,Scott Donnelly,Textron,11,26,3,40,
2025-09-13,Adam Schechter,Labcorp Holdings,3,5,0,8,
2025-09-13,Deanna Strable-Soethout,Principal Financial,1,6,0,7,
2025-09-13,Leonard Schleifer,Regeneron Pharmaceuticals,7,26,7,40,
2025-09-13,Paul Shoukry,Raymond James Financial,15,24,1,40,
2025-09-13,Lauren Hobart,Dicks Sporting Goods,11,25,4,40,
2025-09-13,Jamie Whisnant,Auto-Owners Insurance,0,2,0,2,
2025-09-13,Ariane Gorin,Expedia,10,28,1,39,
2025-09-13,Shelley Simpson,JB Hunt Transport Services,9,27,4,40,
2025-09-13,Ren√© Jones,M&T Bank,12,25,3,40,
2025-09-13,Gerardo Norcia,DTE Energy,6,2,1,9,
2025-09-13,Andr√©s Gluski,AES,15,22,0,37,
2025-09-13,Timothy Spence,Fifth Third Bancorp,5,4,1,10,
2025-09-13,Eduardo Menezes,Air Products & Chemicals,3,6,1,10,
2025-09-13,Wendell Weeks,Corning,14,24,2,40,
2025-09-13,Anthony Guzzi,EMCOR Group,2,5,2,9,
2025-09-13,Adam Norwitt,Amphenol,3,17,0,20,
2025-09-13,Jean-Marc Gilson,Westlake Corporation,2,4,0,6,
2025-09-13,Lori Koch,DuPont,6,19,0,25,
2025-09-13,Derek Chang,Liberty Media,36,2,2,40,
2025-09-13,Martina Cheung,S&P Global,10,26,0,36,
2025-09-13,Tim Hingtgen,Community Health Systems,10,27,3,40,
2025-09-13,Brian Tierney,FirstEnergy,6,21,3,30,
2025-09-13,Rick McKenney,Unum Group,5,4,0,9,
2025-09-13,Stanley Bergman,Henry Schein,13,26,1,40,
2025-09-13,Tiang Yew Tan,Western Digital,1,3,0,4,
2025-09-13,Vincent Roche,Analog Devices,12,24,4,40,
2025-09-13,Sean Connolly,Conagra Brands,8,30,2,40,
2025-09-13,Bruce Van Saun,Citizens Financial Group,13,25,2,40,
2025-09-13,Mark George,Norfolk Southern,18,18,4,40,
2025-09-13,Andrew Marsh,Entergy,4,4,0,8,
2025-09-13,Robert Berkley,WR Berkley,8,28,4,40,
2025-09-13,Javier Rodriguez,DaVita,15,13,1,29,
2025-09-13,Michael OGrady,Northern Trust,3,1,0,4,
2025-09-13,James Snee,Hormel Foods,3,26,1,30,
2025-09-13,Timothy J Donahue,Crown Holdings,3,10,0,13,
2025-09-13,Joseph Ferraro,Avis Budget,3,6,1,10,
2025-09-13,Niraj Shah,Wayfair,7,26,7,40,
2025-09-13,Jos√© Mas,MasTec,6,13,1,20,
2025-09-13,Joseph Nolan,Eversource Energy,4,5,1,10,
2025-09-13,Thomas Palmer,Newmont,6,4,0,10,
2025-09-13,Robert Sanchez,Ryder System,10,6,1,17,
2025-09-13,Michael Nolan,Fidelity National Financial,4,1,0,5,
2025-09-13,Gavin Hattersley,Molson Coors Beverage,5,29,6,40,
2025-09-13,Thomas Reeg,Caesars Entertainment,5,5,0,10,
2025-09-13,Ellen Cooper,Lincoln National,3,7,0,10,
2025-09-13,Bracken Darrell,VF Corporation,7,30,3,40,
2025-09-13,Erik Fyrwald,International Flavors & Fragrances,7,10,3,20,
2025-09-13,Christopher Kastner,Huntington Ingalls Industries,3,5,0,8,
2025-09-13,Shane OKelly,Advance Auto Parts,0,6,0,6,
2025-09-13,Ralph LaRossa,Public Service Enterprise Group,12,15,0,27,
2025-09-13,Kecia Steelman,Ulta Beauty,37,2,1,40,
2025-09-13,Michele Buck,Hershey,6,32,2,40,
2025-09-13,Sumit Singh,Chewy,12,23,5,40,
2025-09-13,Steven Vondran,American Tower,4,6,0,10,
2025-09-13,Jeffrey Lorberbaum,Mohawk Industries,11,5,1,17,
2025-09-13,Keith Demmings,Assurant,6,7,0,13,
2025-09-13,Robert Martin,Thor Industries,4,5,1,10,
2025-09-13,Kathleen Mazzarella,Graybar Electric,1,6,1,8,
2025-09-13,Joey Wat,Yum China,14,23,3,40,
2025-09-13,Scott Richardson,Celanese,6,15,2,23,
2025-09-13,David Rawlinson II,QVC,8,16,1,25,
2025-09-13,Alan Armstrong,Williams,24,13,3,40,
2025-09-13,Philippe Krakowsky,Interpublic Group,13,24,3,40,
2025-09-13,Brendan McCracken,Ovintiv,6,4,0,10,
2025-09-13,Andrew Teno,Icahn Enterprises,5,5,0,10,
2025-09-13,Stephen Steinour,Huntington Bancshares,1,9,0,10,
2025-09-13,Timothy NeCastro,Erie Insurance,3,7,0,10,
2025-09-13,Ernest Garcia III,Carvana,24,12,4,40,
2025-09-13,R Bruce McDonald,Dana Incorporated,3,7,1,11,
2025-09-13,William Oplinger,Alcoa Corporation,1,8,1,10,
2025-09-13,Mark Pearson,Equitable,7,8,0,15,
2025-09-13,Richard Wallace,KLA,2,2,0,4,
2025-09-13,Ricardo Cardenas,Darden Restaurants,4,4,1,9,
2025-09-13,Mikael Bratt,Autoliv,6,6,2,14,
2025-09-13,Benito Minicucci,Alaska Air,2,3,1,6,
2025-09-13,Christopher Gorman,KeyCorp,5,5,0,10,
2025-09-13,Robert Goldstein,Las Vegas Sands,5,30,5,40,
2025-09-13,Edward Pesicka,Owens & Minor,3,31,1,35,
2025-09-13,Christopher Nassetta,Hilton Worldwide,8,16,2,26,
2025-09-13,Jamie Iannone,Ebay,18,18,3,39,
2025-09-13,Patrick Gallagher,Arthur J Gallagher,8,30,2,40,
2025-09-13,Rich Steinmeier,LPL Financial,22,16,2,40,
2025-09-13,Stephen Spray,Cincinnati Financial,1,6,2,9,
2025-09-13,Douglas Yearley,Toll Brothers,10,25,5,40,
2025-09-13,Gregory Brown,Motorola Solutions,2,7,1,10,
2025-09-13,Brian Chesky,Airbnb,2,30,7,39,
2025-09-13,Jeffrey Sprecher,Intercontinental Exchange,14,21,5,40,
2025-09-13,Robert Thomson,News Corp,5,32,3,40,
2025-09-13,Scott Boatwright,Chipotle Mexican Grill,10,27,3,40,
2025-09-13,Reshma Kewalramani,Vertex Pharmaceuticals,20,15,5,40,
2025-09-13,Christopher Viehbacher,Biogen,0,25,2,27,
2025-09-13,Malcolm Wilson,GXO Logistics,5,23,0,28,
2025-09-13,Tony Sarsam,SpartanNash,17,21,2,40,
2025-09-13,Michael O‚ÄôSullivan,Burlington Stores,9,27,4,40,
2025-09-13,Teresa Rasmussen,Thrivent Financial for Lutherans,3,1,0,4,
2025-09-13,Eugene Bredow,NVR,0,4,1,5,
2025-09-13,Brian Chambers,Owens Corning,2,11,0,13,
2025-09-13,Rafael Santana,Westinghouse Air Brake Technologies,3,10,1,14,
2025-09-13,John Pfeifer,Oshkosh Corporation,3,17,0,20,
2025-09-13,Cameron Bready,Global Payments,8,29,3,40,
2025-09-13,Calvin McDonald,Lululemon athletica,8,31,1,40,
2025-09-13,J Kent Masters,Albemarle Corporation,4,5,0,9,
2025-09-13,Joanna Geraghty,JetBlue Airways,15,17,8,40,
2025-09-13,Robert Steer,Seaboard,1,4,0,5,
2025-09-13,William Newlands,Constellation Brands,0,5,2,7,
2025-09-13,Michael Doss,Graphic Packaging,3,8,1,12,
2025-09-13,Gil West,Hertz,6,23,9,38,
2025-09-13,Malcolm C Roberts,FM Global,2,10,2,14,
2025-09-13,Mick Beekhuizen,Campbell Soup,8,21,0,29,
2025-09-13,Daniel Wall,Expeditors International of Washington,2,4,0,6,
2025-09-13,Gregory Roberts,A-Mark Precious Metals,2,4,1,7,
2025-09-13,Horacio Rozanski,Booz Allen Hamilton,16,19,5,40,
2025-09-13,James Davis,Quest Diagnostics,5,5,0,10,
2025-09-13,Dennis Mathew,Altice,4,24,7,35,
2025-09-13,Stefan Larsson,PVH,10,25,5,40,
2025-09-13,Mark Costa,Eastman Chemical,4,14,4,22,
2025-09-13,Joyce Mullen,Insight Enterprises,6,11,0,17,
2025-09-13,John Turner,Regions Financial,21,17,2,40,
2025-09-13,Julian G Francis,Beacon Roofing Supply,0,1,0,1,
2025-09-13,Blake Moret,Rockwell Automation,11,27,2,40,
2025-09-13,Mike Speetzen,Polaris Inc,3,17,2,22,
2025-09-13,William McDermott,ServiceNow,4,5,0,9,
2025-09-13,Jure Sola,Sanmina,3,11,0,14,
2025-09-13,Bob Flexon,UGI Utilities Inc,0,1,0,1,
2025-09-13,Scott Lauber,WEC Energy,14,6,0,20,
2025-09-13,Jon Rousseau,BrightSpring Health Services,20,19,1,40,
2025-09-13,Todd Schneider,Cintas,11,18,1,30,
2025-09-13,Peter Matt,Commercial Metals,4,5,0,9,
2025-09-13,Robert D Lawler,Continental Resources,0,0,0,0,
2025-09-13,Domenic Dell‚ÄôOsso Jr,Expand Energy,4,0,0,4,
2025-09-13,Jason P Wells,CenterPoint Energy,8,4,1,13,
2025-09-13,H Michael Krimbill,NGL Energy Partners,7,1,0,8,
2025-09-13,Tony Xu,DoorDash,16,17,7,40,
2025-09-13,Clay Williams,NOV,8,19,4,31,
2025-09-13,Kristin Peck,Zoetis,12,20,1,33,
2025-09-13,Mark Smucker,JM Smucker,12,21,7,40,
2025-09-13,Steve Sanghi,Microchip Technology,8,28,4,40,
2025-09-13,Richard Tobin,Dover Corporation,2,3,0,5,
2025-09-13,Kaes Van‚Äôt Hof,Diamondback Energy,20,16,3,39,
2025-09-13,Deon Stander,Avery Dennison,0,13,0,13,
2025-09-13,Vincent Sorgi,PPL,8,9,1,18,
2025-09-13,Hassane El-Khoury,ON Semiconductor,2,17,5,24,
2025-09-13,Arie Kotler,ARKO,5,22,0,27,
2025-09-13,William Monteleone,Par Pacific,1,6,2,9,
2025-09-13,John Christmann IV,APA,6,3,1,10,
2025-09-13,Adaire Fox-Martin,Equinix,15,22,2,39,
2025-09-13,Joseph M Otting,Flagstar Financial,3,5,2,10,
2025-09-13,Mary Dillon,Foot Locker,11,25,4,40,
2025-09-13,James Zallie,Ingredion,3,7,0,10,
2025-09-13,Christopher Peterson,Newell Brands,0,9,1,10,
2025-09-13,Scott Salmirs,ABM Industries,6,5,1,12,
2025-09-13,Christopher Hilger,Securian Financial,0,7,0,7,
2025-09-13,Hamid Moghadam,Prologis,7,27,6,40,
2025-09-13,Stephen Schwarzman,Blackstone,13,20,6,39,
2025-09-13,Robert Greenberg,Skechers USA,5,24,3,32,
2025-09-13,Keith Allman,Masco,3,9,1,13,
2025-09-13,Rusty Rush,Rush Enterprises,15,22,3,40,
2025-09-13,Jennifer Johnson,Franklin Resources,1,8,1,10,
2025-09-13,Gerry P Smith,ODP Business Solutions,0,0,0,0,
2025-09-13,Carl Lindner lll,American Financial,0,0,0,0,
2025-09-13,Mark Kowlzan,Packaging Corp of America,0,8,1,9,
2025-09-13,Thomas Hill,Vulcan Materials,4,7,2,13,
2025-09-13,Milan Galik,Interactive Brokers,8,17,2,27,
2025-09-13,Laura Alber,Williams-Sonoma,16,21,3,40,
2025-09-13,Mario Harik,XPO,7,32,1,40,
2025-09-13,Devin Stockfish,Weyerhaeuser,5,5,0,10,
2025-09-13,Thomas J McInerney,Genworth Financial,1,6,0,7,
2025-09-13,Garrick Rochow,CMS Energy,10,3,1,14,
2025-09-13,Toni Townes-Whitley,Science Applications International,10,20,1,31,
2025-09-13,Rich Handler,Jefferies Financial,12,11,2,25,
2025-09-13,Daniel Heaf,Bath & Body Works,13,26,1,40,
2025-09-13,Andrew Wilson,Electronic Arts,11,19,10,40,
2025-09-13,Sheryl Palmer,Taylor Morrison Home,8,10,1,19,
2025-09-13,Ivan Tornos,Zimmer Biomet,10,27,3,40,
2025-09-13,Linda Rendle,Clorox,1,35,2,38,
2025-09-13,Matthew Pine,Xylem Inc,1,9,1,11,
2025-09-13,Heather Lavallee,Voya Financial,6,11,2,19,
2025-09-13,Daniel Florness,Fastenal,3,5,2,10,
2025-09-13,Albert Nahmad,Watsco,2,7,0,9,
2025-09-13,Carl Eschenbach,Workday,12,19,9,40,
2025-09-13,Craig Smiddy,Old Republic International,3,6,1,10,
2025-09-13,Frank C Sullivan,RPM International,2,8,1,11,
2025-09-13,Matthew Missad,UFP Industries,8,2,0,10,
2025-09-13,Martin J Lyons,Ameren,3,3,1,7,
2025-09-13,Adam W Miller,Knight Swift Transportation,1,2,1,4,
2025-09-13,Rodney Sacks,Monster Beverage,14,25,0,39,
2025-09-13,Gary Guthart,Intuitive Surgical,13,22,5,40,
2025-09-13,Charles Liang,Super Micro Computer,35,5,0,40,
2025-09-13,Christopher Caldwell,Concentrix,3,5,0,8,
2025-09-13,Gordon J Hardie,O-I Glass,0,5,0,5,
2025-09-13,David Gibbs,Yum Brands,2,38,0,40,
2025-09-13,Steve Henry,Domtar,5,5,0,10,
2025-09-13,Chuck Treadway,CommScope,8,19,3,30,
2025-09-13,Rob Vitale,Post Holdings,1,13,5,19,
2025-09-13,Steven J Moskowitz,Crown Castle,3,4,3,10,
2025-09-13,Emmanuel Ligner,Avantor,3,10,1,14,
2025-09-13,Stuart Bradie,KBR,12,15,4,31,
2025-09-13,Carrie Wheeler,Opendoor Technologies,10,26,4,40,
2025-09-13,Russell Becker,APi Group,3,5,0,8,
2025-09-13,Toby Rice,EQT,24,13,3,40,
2025-09-13,Jesse Arenivas,EnLink Midstream,8,9,0,17,
2025-09-13,Nikesh Arora,Palo Alto Networks,7,24,9,40,
2025-09-13,Steven Bandrowczak,Xerox,1,8,1,10,
2025-09-13,Vicente Reynal,Ingersoll Rand,8,28,0,36,
2025-09-13,William T Dillard II,Dillards,3,4,2,9,
2025-09-13,C Howard Nye,Martin Marietta Materials,1,5,4,10,
2025-09-13,Giordano Albertazzi,Vertiv,15,19,3,37,
2025-09-13,Stephane Bancel,Moderna,9,20,11,40,
2025-09-13,Nate R Jorgensen,Boise Cascade,0,0,0,0,
2025-09-13,Jack Sinclair,Sprouts Farmers Market,18,22,0,40,
2025-09-13,Padraig McDonnell,Agilent Technologies,11,11,0,22,
2025-09-13,Kenneth T Lane,Olin,0,1,0,1,
2025-09-13,Randall C Stuewe,Darling Ingredients,27,1,0,28,
2025-09-13,R Howard Coker,Sonoco Products,2,7,1,10,
2025-09-13,John Mengucci,CACI International,21,18,1,40,
2025-09-13,Mark Witkowski,Core & Main,2,13,2,17,
2025-09-13,Lee M Tillman,Marathon Oil,4,5,0,9,
2025-09-13,Mark Hoplamazian,Hyatt Hotels,14,21,5,40,
2025-09-13,David S Chernow,Select Medical,0,9,0,9,
2025-09-13,Brendan M Foley,McCormick & Company,0,8,0,8,
2025-09-13,Joanne Crevoiserat,Tapestry,13,23,4,40,
2025-09-13,John Plant,Howmet Aerospace,4,11,3,18,
2025-09-13,Shankh Mitra,Welltower,14,25,1,40,
2025-09-13,W Anthony Will,CF Industries,3,4,0,7,
2025-09-13,David A Zapico,Ametek,3,16,1,20,
2025-09-13,Kevin Stein,TransDigm,11,10,2,23,
2025-09-13,Craig Billings,Wynn Resorts,13,25,2,40,
2025-09-13,William J Way,Southwestern Energy,2,0,0,2,
2025-09-13,Giel Rutten,Amkor Technology,3,6,1,10,
2025-09-13,Paul Sarvadi,Insperity,4,5,0,9,
2025-09-13,Donald Zurbay,Patterson Companies Inc,1,4,0,5,
2025-09-13,Rob Sharps,T Rowe Price,12,23,5,40,
2025-09-13,Patrice Louvet,Ralph Lauren,15,16,9,40,
2025-09-13,Jeffrey Mezger,KB Home,3,29,7,39,
2025-09-13,David M Foulkes,Brunswick,1,8,0,9,
2025-09-13,M Keith Waddell,Robert Half,4,6,0,10,
2025-09-13,Jay Snowden,PENN Entertainment,19,17,4,40,
2025-09-13,George Kurian,NetApp,16,21,3,40,
2025-09-13,Kevin Ali,Organon,9,17,2,28,
2025-09-13,Joel D Anderson,Petco Health and Wellness,2,9,0,11,
2025-09-13,Louis V Pinkham,Regal Rexnord,0,1,0,1,
2025-09-13,Jay Geldmacher,Resideo Technologies,9,6,0,15,
2025-09-13,Marcus Lemonis,Camping World,10,21,9,40,
2025-09-13,Peter R Huntsman,Huntsman,6,11,3,20,
2025-09-13,Hillary Super,Victorias Secret,11,4,8,23,
2025-09-13,Michelle Gass,Levi Strauss,12,24,3,39,
2025-09-13,Neil Hunn,Roper Technologies,2,21,0,23,
2025-09-13,Steven P Lawrence,Academy Sports and Outdoors,1,1,0,2,
2025-09-13,Phillippe Lord,Meritage Homes,8,15,0,23,
2025-09-13,David C Dauch,American Axle & Manufacturing,5,6,2,13,
2025-09-13,Olumide Soroye,Fortive,1,8,0,9,
2025-09-13,Adena Friedman,Nasdaq,15,21,4,40,
2025-09-13,Tim Gokey,Broadridge Financial Solutions,5,11,1,17,
2025-09-13,Patrick M Shanahan,Spirit AeroSystems,1,9,0,10,
2025-09-13,Robert Kyncl,Warner Music Group,10,28,2,40,
2025-09-13,Denise Dignam,Chemours,3,19,3,25,
2025-09-13,Jim DeVries,ADT,11,6,1,18,
2025-09-13,Bernard Zovighian,Edwards Lifesciences,6,7,2,15,
2025-09-13,Mark E Seaton,First American Financial,1,9,0,10,
2025-09-13,John C Roche,Hanover Insurance Group,7,16,0,23,
2025-09-13,Adam J Greenlee,Silgan,0,5,0,5,
2025-09-13,Jayne Hrdlicka,Endeavor Group,0,1,0,1,
2025-09-13,Robert Fauber,Moodys Corporation,0,6,0,6,
2025-09-13,Thomas E Jorden,Coterra Energy,8,0,0,8,
2025-09-13,Eugene A Hall,Gartner,1,8,0,9,
2025-09-13,Kevin Plank,Under Armour,9,28,2,39,
2025-09-13,James W Lanning,Ingles Markets,3,4,0,7,
2025-09-13,Matthew T Farrell,Church & Dwight,7,7,0,14,
2025-09-13,Kevin M Freeman,Old Dominion Freight Line,0,0,0,0,
2025-09-13,Joe Shoen,U-Haul,15,20,4,39,
2025-09-13,Mark Bertolini,Oscar Health,13,17,9,39,
2025-09-13,Jayshree Ullal,Arista Networks,19,20,1,40,
2025-09-13,Sassine Ghazi,Synopsys,10,26,4,40,
2025-09-13,Jochen Zeitz,Harley-Davidson,6,24,10,40,
2025-09-13,Nick Jeffery,Frontier Communications,10,25,0,35,
2025-09-13,Thomas Edward McCormick,Primoris Services,0,4,0,4,
2025-09-13,D Christian Koch,Carlisle Companies,1,5,0,6,
2025-09-13,David E Simon,Simon Property Group,3,6,1,10,
2025-09-13,Stephen Bratspies,Hanesbrands,3,11,2,16,
2025-09-13,Ryan M. Schneider,Anywhere Real Estate Inc,0,1,0,1,
2025-09-13,George Bobb III,Teledyne Technologies,1,4,0,5,
2025-09-13,Terrence A Duffy,CME Group,6,9,1,16,
2025-09-13,Rami Rahim,Juniper Networks,11,26,3,40,
2025-09-13,Sue Nabi,Coty,13,18,9,40,
2025-09-13,Peter D Arvan,Pool Corporation,3,6,0,9,
2025-09-13,David Campbell,Evergy,15,9,0,24,
2025-09-13,Matthew J Murphy,Marvell Technology,2,7,1,10,
2025-09-13,Lloyd Yates,NiSource,5,5,0,10,
2025-09-13,William C Stone,SS&C Technologies,2,5,1,8,
2025-09-13,Mark Rourke,Schneider National,10,15,1,26,
2025-09-13,Andrew Anagnost,Autodesk,9,24,7,40,
2025-09-13,Dustin Semach,Sealed Air Corporation,0,9,0,9,
2025-09-13,William L Meaney,Iron Mountain,3,16,0,19,
2025-09-13,Andy P Power,Digital Realty Trust,0,0,0,0,
2025-09-13,Satish Dhanasekaran,Keysight Technologies,3,10,0,13,
2025-09-13,Frank M Svoboda,Globe Life,3,4,3,10,
2025-09-13,Carey A Smith,Parsons Corporation,0,2,0,2,
2025-09-13,Ynon Kreiz,Mattel,8,25,7,40,
2025-09-13,Karen S Haller,Southwest Gas,2,7,0,9,
2025-09-13,Terrance Williams,TruStage,4,5,1,10,
2025-09-13,Eric W Gerstenberg,Clean Harbors,6,1,1,8,
2025-09-13,Gunner Smith,Cornerstone Building Brands,1,8,1,10,
2025-09-13,Gerben W Bakker,Hubbell,1,4,0,5,
2025-09-13,Dave Davis,Spirit Airlines,4,34,2,40,
2025-09-13,Michael J Smith,Lamb Weston,0,7,3,10,
2025-09-13,Strauss Zelnick,Take-Two Interactive Software,14,16,10,40,
2025-09-13,John C Turner Jr,GMS,3,7,0,10,
2025-09-13,David M OMalley,Penn Mutual Life Insurance,0,1,0,1,
2025-09-13,Frank A Lonegro,Landstar System,1,4,0,5,
2025-09-13,James F Risoleo,Host Hotels & Resorts,5,13,0,18,
2025-09-13,Ken Xie,Fortinet,11,22,7,40,
2025-09-13,Doug Shulman,OneMain,4,6,0,10,
2025-09-13,Ryan Cohen,GameStop,10,23,7,40,
2025-09-13,Mark W Begor,Equifax,2,13,0,15,
2025-09-13,Jay L Schottenstein,American Eagle Outfitters,8,17,1,26,
2025-09-13,Curtis C Farmer,Comerica,3,9,0,12,
2025-09-13,Ole Rosgaard,Greif,2,14,1,17,
2025-09-13,Brian E Lane,Comfort Systems USA,10,0,0,10,
2025-09-13,Robert M Buck,TopBuild,4,5,1,10,
2025-09-13,Ralph Andretta,Bread Financial,3,9,0,12,
2025-09-13,Jim Anderson,Coherent,6,34,0,40,
2025-09-13,Walter C. D. Carlson,Telephone & Data Systems,0,2,0,2,
2025-09-13,Ronald Kruszewski,Stifel Financial,7,3,0,10,
2025-09-13,Richard Hayne,Urban Outfitters,12,19,8,39,
2025-09-13,Simon Meester,Terex,3,7,0,10,
2025-09-13,Edward J Lehner,Ryerson Holding,0,2,0,2,
2025-09-13,Nicholas T Pinchuk,Snap-on,3,6,0,9,
2025-09-13,Ryals McMullian,Flowers Foods,5,30,3,38,
2025-09-13,D Bryan Jordan,First Horizon,3,8,1,12,
2025-09-13,John B Gibson,Paychex,5,4,1,10,
2025-09-13,Chris Cocks,Hasbro,12,20,8,40,
2025-09-13,Pete McPartland,Sentry Insurance Group,0,2,0,2,
2025-09-13,Michael Arougheti,Ares Management,16,22,2,40,
2025-09-13,Alok Maskara,Lennox International,5,3,1,9,
2025-09-13,James C Grech,Peabody Energy,2,0,0,2,
2025-09-13,Joseph P Lacher Jr,Kemper,4,19,3,26,
2025-09-13,Perry A Sook,Nexstar Media Group,8,26,1,35,
2025-09-13,Wade Davis,TelevisaUnivision,12,27,1,40,
2025-09-13,Scott L Thompson,Tempur Sealy International,0,7,0,7,
2025-09-13,Mike Simonds,TriNet Group,0,9,0,9,
2025-09-13,B Andrew Rose,Worthington Enterprises,0,1,0,1,
2025-09-13,Bruce L Caswell,Maximus,3,4,0,7,
2025-09-13,Robert L Reffkin,Compass,1,7,0,8,
2025-09-13,Mark Eubanks,Brinks Company,1,2,1,4,
2025-09-13,Peter Quigley,Kelly Services inc,1,8,0,9,
2025-09-13,David L Yowan,Navient,1,1,0,2,
2025-09-13,Mary E Kipp,Puget Sound Energy,3,1,2,6,
2025-09-13,Adam Aron,AMC Entertainment,16,18,6,40,
2025-09-13,Mark J Tarr,Encompass Health,2,5,1,8,
2025-09-13,Liam K Griffin,Skyworks Solutions,1,8,0,9,
2025-09-13,Richard G Kyle,Timken,2,13,1,16,
2025-09-13,Ron Gusek,Liberty Energy,23,1,0,24,
2025-09-13,John E Geller Jr,Marriott Vacations Worldwide,6,6,0,12,
2025-09-13,Karl G. Glassman,Leggett & Platt,0,3,0,3,
2025-09-13,Bruce K Thorn,Big Lots,2,6,2,10,
2025-09-13,Jonathan H Weis,Weis Markets,11,28,0,39,
2025-09-13,Jeffrey B Guldner,Pinnacle West Capital,1,2,0,3,
2025-09-13,Arkadiy Dobkin,EPAM Systems,10,13,1,24,
2025-09-13,Paul M Rady,Antero Resources,3,7,0,10,
2025-09-13,Michael Spanos,Bloomin Brands,1,8,1,10,
2025-09-13,Nicole A Kivisto,MDU Resources Group,5,4,0,9,
2025-09-13,Gerald L Morgan,Texas Roadhouse,3,2,4,9,
2025-09-13,Gabriel Tirador,Mercury General,4,4,2,10,
2025-09-13,Nicholas I Fink,Fortune Brands Innovations,2,8,0,10,
2025-09-13,Paul E Burdiss,Zions Bancorp,1,1,0,2,
2025-09-13,William J Christensen,JELD-WEN Holding,4,5,0,9,
2025-09-13,Evan Spiegel,Snap Inc,20,17,3,40,
2025-09-13,Bill Burns,Zebra Technologies,6,21,1,28,
2025-09-13,Steven Sell,Agilon Health,0,8,0,8,
2025-09-13,Richard M Olson,Toro Company,1,11,0,12,
2025-09-13,Eric S Yuan,Zoom Video Communications,5,7,0,12,
2025-09-13,Dan L Batrack,Tetra Tech,2,5,1,8,
2025-09-13,Joseph D Russell Jr,Public Storage,0,7,0,7,
2025-09-13,Jacob Thaysen,Illumina inc,4,7,0,11,
2025-09-13,Debra A Cafaro,Ventas inc,7,6,0,13,
2025-09-13,Pierre R Brondeau,FMC Corporation,0,5,0,5,
2025-09-13,Judy R McReynolds,ArcBest,4,15,1,20,
2025-09-13,Russell J Weiner,Dominos Pizza inc,0,0,0,0,
2025-09-13,Theodore S Hanson,ASGN,0,0,0,0,
2025-09-13,RJ Scaringe,Rivian Automotive,12,25,3,40,
2025-09-13,Jeffrey N Simmons,Elanco Animal Health,2,6,1,9,
2025-09-13,Tim O Shaughnessy,Graham Holdings Company,2,8,0,10,
2025-09-13,Thomas V Taylor,Floor & Decor,1,2,2,5,
2025-09-13,Neil A Schrimsher,Applied Industrial Technologies,6,22,1,29,
2025-09-13,Robert E Price,PriceSmart,4,6,0,10,
2025-09-13,John David Risher,Lyft,3,4,1,8,
2025-09-13,Gary B Smith,Ciena,4,8,0,12,
2025-09-13,Joey Levin,IAC,7,31,1,39,
2025-09-13,Jim Jacobs,Country Financial,7,5,2,14,
2025-09-13,Devin B McGranahan,Western Union,1,5,0,6,
2025-09-13,R Scott Rowe,Flowserve,5,4,1,10,
2025-09-13,Kenneth A Vecchione,Western Alliance Bancorp,0,0,1,1,
2025-09-13,John C Rademacher,Option Care Health,6,1,0,7,
2025-09-13,Doug Black,SiteOne Landscape Supply,3,17,2,22,
2025-09-13,Oliver G Brewer III,Topgolf Callaway Brands,1,0,0,1,
2025-09-13,Glenn Sanford,eXp World,16,20,4,40,
2025-09-13,Fran Horowitz,Abercrombie & Fitch,11,22,7,40,
2025-09-13,Kevin Akers,Atmos Energy,7,3,0,10,
2025-09-13,Alessandro Maselli,Catalent,2,12,2,16,
2025-09-13,J Powell Brown,Brown & Brown,13,21,6,40,
2025-09-13,Aman Bhutani,GoDaddy,16,22,2,40,
2025-09-13,John C. Griffith,American Water Works,1,3,0,4,
2025-09-13,John J Marchioni,Selective Insurance Group,5,13,3,21,
2025-09-13,Lawson E Whiting,Brown-Forman,1,7,1,9,
2025-09-13,Dave Peacock,Advantage Solutions,23,7,0,30,
2025-09-13,Mick Farrell,ResMed,17,21,2,40,
2025-09-13,Kamal Hathi,Splunk,2,5,0,7,
2025-09-13,Todd Kelsey,Plexus,3,6,0,9,
2025-09-13,Phillip D Yeager,Hub Group,4,5,0,9,
2025-09-13,Steven B Hedlund,Lincoln Electric,4,9,0,13,
2025-09-13,Timothy C Oliver,NCR Atleos,0,1,0,1,
2025-09-13,Bruce Fleming,Calumet,2,7,0,9,
2025-09-13,Daniel S. Peyovich,Dycom Industries,0,3,0,3,
2025-09-13,Avner M Applbaum,Valmont Industries,0,7,0,7,
2025-09-13,Kimberly A Fields,ATI inc,4,9,0,13,
2025-09-13,Khozema Z Shipchandler,Twilio,0,3,1,4,
2025-09-13,Gary C Bhojwani,CNO Financial Group,1,5,1,7,
2025-09-13,William Andrew Hendricks Jr,Patterson-UTI Energy,0,0,0,0,
2025-09-13,Kevin D Hochman,Brinker International,1,3,0,4,
2025-09-13,James C Foster,Charles River Laboratories International,2,10,0,12,
2025-09-13,Rajiv K Prasad,Hyster-Yale,2,5,0,7,
2025-09-13,Eric T Steigerwalt,Brighthouse Financial,0,1,0,1,
2025-09-13,Thomas L Ryan,Service Corp International,5,4,0,9,
2025-09-13,Charles M Nifong Jr,CrossAmerica Partners,0,0,0,0,
2025-09-13,Anirudh Devgan,Cadence,10,27,3,40,
2025-09-13,Andi Owen,MillerKnoll,15,16,9,40,
2025-09-13,Sumit Roy,Realty Income,15,18,2,35,
2025-09-13,Timothy John Fitzgerald,Middleby,0,0,0,0,
2025-09-13,Robert H Schottenstein,M/I Homes,1,9,0,10,
2025-09-13,Stephen P MacMillan,Hologic,1,7,1,9,
2025-09-13,Lisa M Barton,Alliant Energy,2,0,0,2,
2025-09-13,Aaron P Jagdfeld,Generac,2,6,1,9,
2025-09-13,Erik Gershwind,MSC Industrial Direct,2,5,2,9,
2025-09-13,Varun Krishna,Rocket Companies,8,31,1,40,
2025-09-13,Fahmi Karam,Upbound Group,4,3,0,7,
2025-09-13,NADominic Ng,East West Bancorp,0,0,0,0,
2025-09-13,Mark Wang,Hilton Grand Vacations,38,2,0,40,
2025-09-13,Robert J Sheedy Jr,Grocery Outlet Holding,0,0,0,0,
2025-09-13,Simon D Campion,Dentsply Sirona,1,1,0,2,
2025-09-13,Jeremy Wensinger,V2X,7,7,0,14,
2025-09-13,Andrew Rees,Crocs,15,13,12,40,
2025-09-13,David M Maura,Spectrum Brands,5,0,0,5,
2025-09-13,Sachin S Lawande,Visteon,0,0,0,0,
2025-09-13,Neil M Ashe,Acuity Inc,0,2,0,2,
2025-09-13,Lorie L Tekorius,Greenbrier,1,9,0,10,
2025-09-13,John R Ciulla,Webster Financial,4,5,0,9,
2025-09-13,Sean D Keohane,Cabot Corporation,3,6,0,9,
2025-09-13,Drew M Wilkerson,RXO inc,0,0,0,0,
2025-09-13,Daniel E Brown,Chord Energy,1,0,0,1,
2025-09-13,Javier D Ferrer Fernandez,Popular inc,0,1,0,1,
2025-09-13,Olivier Rabiller,Garrett Motion inc,4,8,0,12,
2025-09-13,Ronald N Tutor,Tutor Perini Corporation,2,5,0,7,
2025-09-13,Jeff Liaw,Copart,4,6,0,10,
2025-09-13,Aman Narang,Toast inc,4,5,1,10,
2025-09-13,Joseph M Hogan,Align Technology,2,6,0,8,
2025-09-13,Kevin J Wheeler,A O Smith,0,16,1,17,
2025-09-13,Christopher A Cartwright,TransUnion,2,0,1,3,
2025-09-13,James Kelly,NCR Voyix,2,12,0,14,
2025-09-13,Tom Leighton,Akamai Technologies,15,14,5,34,
2025-09-13,Robert G Painter,Trimble,4,2,0,6,
2025-09-13,Tony Helton,Medical Mutual of Ohio,2,3,1,6,
2025-09-13,Caroline S Grace,AMN Healthcare Services,0,0,0,0,
2025-09-13,Patrick Kaltenbach,Mettler-Toledo International,1,9,0,10,
2025-09-13,Michael L Baur,ScanSource,0,2,0,2,
2025-09-13,Jason Lippert,LCI Industries,2,12,0,14,
2025-09-13,Fredric J Tomczyk,Cboe Global Markets,1,6,1,8,
2025-09-13,Octavio Marquez,Diebold Nixdorf,5,10,1,16,
2025-09-13,Sivasankaran Somasundaram,ChampionX,6,1,0,7,
2025-09-13,Ronald F Clarke,Corpay,0,0,0,0,
2025-09-13,Robert W Pittman,iHeartMedia,4,4,0,8,
2025-09-13,Patrick Zalupski,Dream Finders Homes,22,16,2,40,
2025-09-13,Keith E Smith,Boyd Gaming,0,5,0,5,
2025-09-13,Mehran Assadi,NLV Financial,1,1,0,2,
2025-09-13,Barry R Port,Ensign Group,2,5,2,9,
2025-09-13,Denise A Paulonis,Sally Beauty,1,1,0,2,
2025-09-13,Clifford A Skelton,Conduent,0,1,1,2,
2025-09-13,Jean-Michel Ribieras,Sylvamo,2,6,0,8,
2025-09-13,Douglas F Bauer,Tri Pointe Homes,0,7,0,7,
2025-09-13,Shawn OConnell,EnerSys,0,1,0,1,
2025-09-13,Bill Meury,Incyte,7,14,0,21,
2025-09-13,Dale Francescon,Century Communities,1,10,3,14,
2025-09-13,Michael Nierenberg,Rithm Capital,10,23,2,35,
2025-09-13,Michael J Brown,Euronet Worldwide,2,7,0,9,
2025-09-13,Scott Seu,Hawaiian Electric Industries,5,15,1,21,
2025-09-13,Jason D Robins,DraftKings,5,2,0,7,
2025-09-13,Jonathan J Mazelsky,IDEXX Laboratories,1,1,1,3,
2025-09-13,Richard S Swartz,MYR Group,0,0,0,0,
2025-09-13,Stefano Caroti,Deckers Outdoor,2,7,1,10,
2025-09-13,Kevin R Sayer,DexCom,1,3,0,4,
2025-09-13,John T C Lee,MKS Instruments,3,8,0,11,
2025-09-13,Edward B Pitoniak,VICI Properties,1,7,0,8,
2025-09-13,Albert White III,Cooper Cos,0,0,0,0,
2025-09-13,Barry L Biffle,Frontier Airlines,1,5,6,12,
2025-09-13,Robert A Bruggeworth,Qorvo,5,4,0,9,
2025-09-13,Winnie Park,Five Below,10,26,4,40,
2025-09-13,Steven Oakland,TreeHouse Foods,2,12,0,14,
2025-09-13,James S Hagedorn,Scotts Miracle-Gro,1,0,0,1,
2025-09-13,Michael Cannon-Brookes,Atlassian,18,19,0,37,
2025-09-13,Bertrand Loy,Entegris,3,10,1,14,
2025-09-13,William E Waltz,Atkore,3,6,0,9,
2025-09-13,Celeste B Mastin,H B Fuller,0,3,0,3,
2025-09-13,Kyle T Larkin,Granite Construction,1,6,0,7,
2025-09-13,Michael J Happe,Winnebago Industries,1,3,1,5,
2025-09-13,Steven H Gunby,FTI Consulting,5,11,0,16,
2025-09-13,Stephan B Tanda,AptarGroup,1,5,2,8,
2025-09-13,Timothy P Boyle,Columbia Sportswear,4,3,2,9,
2025-09-13,Anthony J Wood,Roku,5,2,1,8,
2025-09-13,M Christopher Doyle,Civitas Resources,1,2,0,3,
2025-09-13,Andy Eidson,Alpha Metallurgical Resources,1,5,3,9,
2025-09-13,Andy L Nemeth,Patrick Industries,4,2,0,6,
2025-09-13,Roger W Jenkins,Murphy Oil,5,13,0,18,
2025-09-13,Kevin S Blair,Synovus Financial,5,4,1,10,
2025-09-13,Julie Felss Masino,Cracker Barrel Old Country Store,11,17,12,40,
2025-09-13,David M Overton,Cheesecake Factory,1,9,0,10,
2025-09-13,Nick DeIuliis,CNX Resources,7,2,1,10,
2025-09-13,Christopher Pappas,Chefs Warehouse,4,11,1,16,
2025-09-13,Tod Carpenter,Donaldson Company,2,8,0,10,
2025-09-13,Gregory L Christopher,Mueller Industries,2,6,0,8,
2025-09-13,Rob Saltiel,MRC Global,4,12,1,17,
2025-09-13,Jillian C Evanko,Chart Industries,4,6,0,10,
2025-09-13,Dave Guilmette,Alight Solutions,3,7,0,10,
2025-09-13,Joel Smejkal,Vishay Intertechnology,4,4,1,9,
2025-09-13,Dennis Degner,Range Resources,3,8,0,11,
2025-09-13,Ira D Robbins,Valley National Bancorp,1,2,0,3,
2025-09-13,Bernard Kim,Match Group,14,19,7,40,
2025-09-13,Vincent Pilette,Gen Digital,4,10,0,14,
2025-09-13,Timothy S Crane,Wintrust Financial,2,6,1,9,
2025-09-13,Pat Roche,Moog inc,3,11,2,16,
2025-09-13,Mark R Widmar,First Solar,3,5,2,10,
2025-09-13,Niko Lahanas,Central Garden & Pet,1,13,0,14,
2025-09-13,Chris Osowski,Green Plains inc,5,8,1,14,
2025-09-13,Derek J Leathers,Werner Enterprises,1,8,0,9,
2025-09-13,Adam Foroughi,AppLovin,10,27,3,40,
2025-09-13,Luca Savi,ITT,2,8,0,10,
2025-09-13,Lawrence H Silber,Herc Rentals,0,0,0,0,
2025-09-13,Hilton H Howell Jr,Gray Television,7,19,1,27,
2025-09-13,Eric D Ashleman,IDEX,0,9,1,10,
2025-09-13,Owen D Thomas,Boston Properties,2,8,0,10,
2025-09-13,Kurt Wolf,Pitney Bowes,8,17,1,26,
2025-09-13,Sara E Armbruster,Steelcase,1,0,0,1,
2025-09-13,Charles D. Young,Sun Communities,3,4,0,7,
2025-09-13,Suzanne Foster,AdaptHealth,5,9,1,15,
2025-09-13,Grant E Sims,Genesis Energy,3,2,0,5,
2025-09-13,Laura Prieskorn,Jackson Financial,2,5,2,9,
2025-09-13,Rick L Wessel,FirstCash,4,5,1,10,
2025-09-13,Sherman Miller,Cal-Maine Foods,12,28,0,40,
2025-09-13,Paul A Lang,Arch Resources,4,5,0,9,
2025-09-13,Ashish K Khandpur,Avient,2,6,0,8,
2025-09-13,Shyam K Reddy,BlueLinx,2,6,0,8,
2025-09-13,Christopher S Ripley,Sinclair,1,8,0,9,
2025-09-13,Stacy Kymes,BOK Financial,9,6,0,15,
2025-09-13,James H Walter,Permian Resources,0,0,0,0,
2025-09-13,Jason Murray,PACS Group,4,13,2,19,
2025-09-13,Brian Armstrong,Coinbase Global,12,22,6,40,
2025-09-13,Oscar K Brown,Western Midstream Partners,1,3,0,4,
2025-09-13,Nicholas R Lower,Federated Mutual Insurance,0,1,0,1,
2025-09-13,Morris Goldfarb,G-III Apparel Group,10,25,5,40,
2025-09-13,Mark D Morelli,Vontier,0,3,0,3,
2025-09-13,Matthew J Cox,Matson inc,2,5,0,7,
2025-09-13,David W Grzebinski,Kirby Corporation,1,3,0,4,
2025-09-13,Keith A Harvey,Kaiser Aluminum,5,4,1,10,
2025-09-13,Eric Nyman,Vista Outdoor,3,9,1,13,
2025-09-13,Doug Howe,Designer Brands,5,21,0,26,
2025-09-13,Jerry E Gahlhoff Jr,Rollins inc,0,2,0,2,
2025-09-13,D Scott Barbour,Advanced Drainage Systems,3,2,0,5,
2025-09-13,Sean Gamble,Cinemark,17,21,2,40,
2025-09-13,George Kurtz,CrowdStrike,12,24,4,40,
2025-09-13,Bill Ready,Pinterest,25,15,0,40,
2025-09-13,Fidji Simo,Instacart,9,30,1,40,
2025-09-13,Kimberly K Ryan,Hillenbrand,3,6,0,9,
2025-09-13,David S Graziosi,Allison Transmission,1,19,1,21,
2025-09-13,Gary G Friedman,Restoration Hardware,1,4,0,5,
2025-09-13,Lucinda M Baier,Brookdale Senior Living,4,3,1,8,
2025-09-13,Brian J Blaser,QuidelOrtho,1,9,0,10,
2025-09-13,E Jean Savage,Trinity Industries,0,9,1,10,
2025-09-13,Liam J Kelly,Teleflex,1,3,1,5,
2025-09-13,Laurans A Mendelson,HEICO,7,18,0,25,
2025-09-13,Frank H Laukien,Bruker,2,7,0,9,
2025-09-13,Harvey M Schwartz,Carlyle Group,5,13,0,18,
2025-09-13,Mark S LaVigne,Energizer,1,1,0,2,
2025-09-13,Joel Quadracci,Quad/Graphics,10,25,5,40,
2025-09-13,Amar Maletira,Rackspace Technology,5,10,2,17,
2025-09-13,Udit Batra,Waters Corporation,10,23,0,33,
2025-09-13,Eric M Green,West Pharmaceutical Services,2,8,0,10,
2025-09-13,Doug Palladini,Carters inc,2,2,2,6,
2025-09-13,G Mike Mikan,NeueHealth,4,1,0,5,
2025-09-13,Russell ChipChilds,SkyWest,0,0,0,0,
2025-09-13,Christopher H Hunter,Acadia Healthcare,0,2,0,2,
2025-09-13,Prahlad Singh,Revvity,3,7,0,10,
2025-09-13,Maria M Pope,Portland General Electric,1,3,0,4,
2025-09-13,Charles Chip Blankenship,Woodward inc,0,2,0,2,
2025-09-13,Mike Steib,TEGNA,15,13,1,29,
2025-09-13,Kurt J Ekert,Sabre Corporation,0,1,0,1,
2025-09-13,Matt Wilson,Light & Wonder,18,18,4,40,
2025-09-13,Rob Katz,Vail Resorts,3,11,26,40,
2025-09-13,Schnitzer Steel Industries,Radius Recycling,6,25,6,37,
2025-09-13,David A Spector,PennyMac Financial Services,6,1,0,7,
2025-09-13,Frederick J Holzgrefe III,Saia inc,0,1,0,1,
2025-09-13,Mark J Parrell,Equity Residential,3,7,0,10,
2025-09-13,John W Lindsay,Helmerich & Payne,0,6,0,6,
2025-09-13,Gary D Burnison,Korn Ferry,4,14,0,18,
2025-09-13,Timothy J McGrath,PC Connection Inc,1,2,0,3,
2025-09-13,Lynn M Bamford,Curtiss-Wright,11,9,0,20,
2025-09-13,Jonathan W Witter,Sallie Mae,0,1,0,1,
2025-09-13,Jeff Benck,Benchmark Electronics,4,8,0,12,
2025-09-13,Charles H Giancarlo,Pure Storage,0,4,0,4,
2025-09-13,Brian R Gray,Knife River Corporation,0,1,0,1,
2025-09-13,Jay Schmidt,Caleres inc,3,5,2,10,
2025-09-13,Dale Asplund,BrightView Holdings,1,7,0,8,
2025-09-13,Jeffrey S Edwards,Cooper-Standard,0,7,0,7,
2025-09-13,Glenn J Williams,Primerica,5,3,2,10,
2025-09-13,Francois Locoh-Donou,F5,7,23,2,32,
2025-09-13,Joseph Wm Foran,Matador Resources,7,9,0,16,
2025-09-13,Sridhar Ramaswamy,Snowflake inc,13,18,4,35,
2025-09-13,Mark D Dankberg,Viasat,2,6,2,10,
2025-09-13,Francisco J Leon,California Resources,1,3,1,5,
2025-09-13,Peter Stern,Peloton,18,18,4,40,
2025-09-13,David Baszucki,Roblox,8,22,10,40,
2025-09-13,Jeffrey W Edwards,Installed Building Products,0,1,0,1,
2025-09-13,Clark Lauritzen,First National of Nebraska,1,7,0,8,
2025-09-13,Carlos Alberini,Guess inc,13,26,1,40,
2025-09-13,Shyam P Kambeyanda,ESAB,4,3,0,7,
2025-09-13,Edmund Shallcross III,Amica Mutual Insurance,0,4,0,4,
2025-09-13,Benjamin W Schall,AvalonBay Communities,2,5,1,8,
2025-09-13,Allan C Thygesen,DocuSign,2,6,0,8,
2025-09-13,Bryan J Knutson,Titan Machinery,1,1,1,3,
2025-09-13,Heath Sampson,ModivCare,9,0,1,10,
2025-09-13,Ara K Hovnanian,Hovnanian Enterprises,1,15,2,18,
2025-09-13,Joshua G Silverman,Etsy,1,2,0,3,
2025-09-13,Kevin Roycraft,Adams Resources & Energy,5,4,1,10,
2025-09-13,J Eric Evans,Surgery Partners,0,4,0,4,
2025-09-13,Clint E Stein,Columbia Banking System,1,5,0,6,
2025-09-13,Lee M Shavel,Verisk Analytics,2,7,0,9,
2025-09-13,Dave Banyard Jr,MasterBrand,0,0,0,0,
2025-09-13,Peter R Ingram,Hawaiian Airlines inc,1,0,0,1,
2025-09-13,Kristin A Dolan,AMC Networks,3,2,0,5,
2025-09-13,Brendan T Cavanagh,SBA Communications,1,3,0,4,
2025-09-13,George F Chappelle Jr,Americold Realty Trust,2,3,0,5,
2025-09-13,Thomas E Gottwald,NewMarket Corporation,2,8,0,10,
2025-09-13,Thomas J Baltimore Jr,Park Hotels & Resorts,4,28,1,33,
2025-09-13,Peter M Moglia,Alexandria Real Estate Equities,3,4,0,7,
2025-09-13,Ronald J Kramer,Griffon Corporation,1,7,1,9,
2025-09-13,John L Plueger,Air Lease,2,12,0,14,
2025-09-13,Jennifer F Scanlon,UL Solutions,1,5,0,6,
2025-09-13,Greg Smith,Teradyne,2,7,2,11,
2025-09-13,Sean Trauschke,OGE Energy,18,3,0,21,
2025-09-13,Norman D Schwartz,Bio-Rad Laboratories,0,0,1,1,
2025-09-13,Scott Doyle,Spire inc,3,6,1,10,
2025-09-13,Michael E Reed,Gannett,0,4,2,6,
2025-09-13,Cindy J Miller,Stericycle,2,3,4,9,
2025-09-13,Phillip D Green,Cullen Frost Bankers,1,3,3,7,
2025-09-13,Joseph D Margolis,Extra Space Storage,1,8,1,10,
2025-09-13,Mark A Skonieczny,REV Group,3,4,0,7,
2025-09-13,Ladd Wilks,ProFrac Holding,4,2,0,6,
2025-09-13,Sundaram Nagarajan,Nordson,0,9,1,10,
2025-09-13,Anne P Noonan,Summit Materials,0,1,0,1,
2025-09-13,Lori Flees,Valvoline inc,4,4,1,9,
2025-09-13,Scott H Baxter,Kontoor Brands,3,1,0,4,
2025-09-13,Tim Larson,Skyline Champion,6,0,0,6,
2025-09-13,Chuck Divita,Teladoc Health,11,19,5,35,
2025-09-13,W Bradley Southern,Louisiana-Pacific Corporation,0,0,0,0,
2025-09-13,George C Freeman III,Universal Corporation,2,7,0,9,
2025-09-13,James A Brock,Consol Energy,1,0,0,1,
2025-09-13,Robert Antokol,Playtika Holding,0,8,1,9,
2025-09-13,Joe Craft,Alliance Resource Partners,6,10,2,18,
2025-09-13,Paul Keel,Envista,2,6,1,9,
2025-09-13,Jared Isaacman,Shift4 Payments,8,26,6,40,
2025-09-13,Mark Mac McFarland,Talen Energy,3,0,1,4,
2025-09-13,Tony R Thene,Carpenter Technology,1,8,0,9,
2025-09-13,Melissa D Smith,WEX,2,5,1,8,
2025-09-13,James Jim C Ryan III,Old National Bancorp,1,0,0,1,
2025-09-13,Peter J Federico,AGNC Investment,1,0,0,1,
2025-09-13,Brent L Yeagy,Wabash National,0,1,0,1,
2025-09-13,Henry A Fernandez,MSCI,2,17,0,19,
2025-09-13,Mark Penn,Stagwell,11,23,6,40,
2025-09-13,Julie Schertell,Mativ,2,8,0,10,
2025-09-13,Ashish Chand,Belden,3,6,1,10,
2025-09-13,Greg Anderson,Allegiant Travel Company,5,7,0,12,
2025-09-13,Drew Houston,Dropbox,14,19,7,40,
2025-09-13,Kevin T Conroy,Exact Sciences,2,5,2,9,
2025-09-13,Rex D Geveden,BWX Technologies,2,7,0,9,
2025-09-13,Scott R Wells,Clear Channel Outdoor Hldgs,0,0,0,0,
2025-09-13,Paul Bay,Ingram Micro,10,25,5,40,
2025-09-14,Doug McMillon,Walmart,16,17,7,40,
2025-09-14,Andrew Jassy,Amazon,3,32,5,40,
2025-09-14,Tim Cook,Apple,13,24,3,40,
2025-09-14,Stephen Hemsley,UnitedHealth,8,28,4,40,
2025-09-14,Warren Buffett,Berkshire Hathaway,10,19,11,40,
2025-09-14,David Joyner,CVS Health,5,30,5,40,
2025-09-14,Darren Woods,Exxon Mobil,10,23,6,39,
2025-09-14,Sundar Pichai,Alphabet,16,19,5,40,
2025-09-14,Brian Tyler,McKesson,6,15,5,26,
2025-09-14,Robert Mauch,Cencora,2,8,0,10,
2025-09-14,Ron Vachris,Costco,6,31,3,40,
2025-09-14,Jamie Dimon,JPMorgan Chase,7,19,14,40,
2025-09-14,Satya Nadella,Microsoft,17,19,4,40,
2025-09-14,Jason Hollar,Cardinal Health,15,21,4,40,
2025-09-14,Mike Wirth,Chevron,17,14,9,40,
2025-09-14,David Cordani,Cigna,20,17,3,40,
2025-09-14,Jim Farley,Ford Motor,13,20,7,40,
2025-09-14,Brian Moynihan,Bank of America,7,29,4,40,
2025-09-14,Mary Barra,General Motors,12,24,4,40,
2025-09-14,Gail Boudreaux,Elevance Health,16,15,9,40,
2025-09-14,Jane Fraser,Citigroup,14,22,4,40,
2025-09-14,Sarah London,Centene,13,18,9,40,
2025-09-14,Ted Decker,Home Depot,12,23,5,40,
2025-09-14,Maryann Mannen,Marathon Petroleum,7,15,1,23,
2025-09-14,Ron Sargent,Kroger,5,23,12,40,
2025-09-14,Mark Lashier,Phillips 66,11,20,7,38,
2025-09-14,Priscilla Almodovar,Fannie Mae,10,16,14,40,
2025-09-14,Tim Wentworth,Walgreens,7,24,9,40,
2025-09-14,Lane Riggs,Valero Energy,14,8,0,22,
2025-09-14,Mark Zuckerberg,Meta,7,18,15,40,
2025-09-14,Hans Vestberg,Verizon,16,21,3,40,
2025-09-14,John Stankey,AT&T,10,25,5,40,
2025-09-14,Brian Roberts,Comcast,11,23,6,40,
2025-09-14,Charles Scharf,Wells Fargo,27,6,7,40,
2025-09-14,David Solomon,Goldman Sachs,12,16,12,40,
2025-09-14,Michael Hutchins,Freddie Mac,2,11,4,17,
2025-09-14,Michael Fiddelke,Target,9,24,7,40,
2025-09-14,Jim Rechtin,Humana,20,16,4,40,
2025-09-14,Jon Farney,State Farm Insurance,1,15,3,19,
2025-09-14,Elon Musk,Tesla,6,22,12,40,
2025-09-14,Ted Pick,Morgan Stanley,16,21,3,40,
2025-09-14,Joaquin Duato,Johnson & Johnson,11,24,5,40,
2025-09-14,Juan Luciano,Archer Daniels Midland,4,20,11,35,
2025-09-14,Ramon Laguarta,PepsiCo,8,27,5,40,
2025-09-14,Carol Tom√©,UPS,6,21,13,40,
2025-09-14,Rajesh Subramaniam,FedEx,10,29,0,39,
2025-09-14,Bob Iger,Walt Disney,11,27,2,40,
2025-09-14,Michael Dell,Dell Technologies,10,25,5,40,
2025-09-14,Marvin Ellison,Lowes,13,25,2,40,
2025-09-14,Jon Moeller,Procter & Gamble,4,29,7,40,
2025-09-14,Thomas Long,Energy Transfer,8,0,1,9,
2025-09-14,Kelly Ortberg,Boeing,10,25,4,39,
2025-09-14,Susan Morris,Albertsons,14,22,4,40,
2025-09-14,Kevin Hourican,Sysco,8,28,4,40,
2025-09-14,Christopher Calio,RTX,6,11,0,17,
2025-09-14,Larry Culp,General Electric,10,27,3,40,
2025-09-14,James Taiclet,Lockheed Martin,16,17,7,40,
2025-09-14,Stephen Squeri,American Express,14,25,1,40,
2025-09-14,Joe Creed,Caterpillar,8,29,3,40,
2025-09-14,Michel Khalaf,MetLife,11,17,0,28,
2025-09-14,Samuel Hazen,HCA Healthcare,7,6,0,13,
2025-09-14,Tricia Griffith,Progressive Insurance,9,25,5,39,
2025-09-14,Arvind Krishna,IBM,13,21,6,40,
2025-09-14,John May,Deere,8,25,7,40,
2025-09-14,Jensen Huang,Nvidia,10,28,2,40,
2025-09-14,Philip Smith,StoneX,0,10,0,10,
2025-09-14,Robert M Davis,Merck,4,19,0,23,
2025-09-14,Ryan Lance,ConocoPhillips,14,21,5,40,
2025-09-14,Albert Bourla,Pfizer,21,11,8,40,
2025-09-14,Ed Bastian,Delta Air Lines,12,15,13,40,
2025-09-14,Patrick Zammit,TD Synnex,9,13,0,22,
2025-09-14,Kevin Murphy,Publix Super Markets,10,19,1,30,
2025-09-14,Thomas J Wilson,Allstate,1,8,1,10,
2025-09-14,Chuck Robbins,Cisco Systems,15,22,3,40,
2025-09-14,Kirt Walker,Nationwide Insurance,5,5,0,10,
2025-09-14,Christopher Winfrey,Charter Communications,5,14,5,24,
2025-09-14,Bob Michael,AbbVie,0,0,0,0,
2025-09-14,Craig DeSanto,New York Life Insurance,2,21,0,23,
2025-09-14,Lip-Bu Tan,Intel,8,21,11,40,
2025-09-14,Ernie Herrman,TJX,16,22,2,40,
2025-09-14,Andrew Sullivan,Prudential Financial,13,19,0,32,
2025-09-14,Enrique Lores,Hewlett Packard,9,17,6,32,
2025-09-14,Scott Kirby,United Airlines,29,8,3,40,
2025-09-14,George Holm,Performance Food,8,22,2,32,
2025-09-14,Donnie King,Tyson Foods,7,27,6,40,
2025-09-14,Robert Isom,American Airlines,7,25,8,40,
2025-09-14,Timothy M Sweeney,Liberty Mutual Insurance,11,0,0,11,
2025-09-14,Elliott Hill,Nike,13,24,3,40,
2025-09-14,Safra Catz,Oracle,24,11,5,40,
2025-09-14,AJ Jim Teague,Enterprise Products Partners,4,12,0,16,
2025-09-14,Richard Fairbank,Capital One,17,20,3,40,
2025-09-14,Willie Chiang,Plains GP,3,5,1,9,
2025-09-14,Michael Kasbar,World Kinect,2,8,0,10,
2025-09-14,Peter Zaffino,American International Group,8,26,6,40,
2025-09-14,James Quincey,The Coca-Cola Company,10,27,3,40,
2025-09-14,Thasunda Brown Duckett,TIAA,21,19,0,40,
2025-09-14,Jay Debertin,CHS,5,11,4,20,
2025-09-14,Chris Boerner,Bristol-Myers Squibb,10,25,5,40,
2025-09-14,Corie Barry,Best Buy,39,1,0,40,
2025-09-14,Marc Casper,Thermo Fisher Scientific,15,22,3,40,
2025-09-14,Roger Crandall,Mass Mutual,2,8,0,10,
2025-09-14,Juan Andrade,USAA,5,18,0,23,
2025-09-14,Phebe Novakovic,General Dynamics,28,9,3,40,
2025-09-14,Alan Schnitzer,Travelers Insurance,3,4,2,9,
2025-09-14,David Zaslav,Warner Bros Discovery,3,32,5,40,
2025-09-14,Gunjan Kedia,US Bancorp,16,22,2,40,
2025-09-14,Robert Ford,Abbott Laboratories,12,21,7,40,
2025-09-14,Kathy Warden,Northrop Grumman,15,19,6,40,
2025-09-14,Tim Gerend,Northwestern Mutual,12,27,1,40,
2025-09-14,Todd Vasos,Dollar General,7,25,8,40,
2025-09-14,Matthew Lucey,PBF Energy,7,2,0,9,
2025-09-14,Dara Khosrowshahi,Uber,15,20,5,40,
2025-09-14,Vimal Kapur,Honeywell,11,29,0,40,
2025-09-14,Dirk Van de Put,Mondelez,8,29,3,40,
2025-09-14,Brian Niccol,Starbucks,10,26,4,40,
2025-09-14,Cristiano Amon,Qualcomm,11,28,1,40,
2025-09-14,Hock Tan,Broadcom,12,27,1,40,
2025-09-14,David Flitman,US Foods,3,7,0,10,
2025-09-14,Paul Romanowski,DR Horton,6,15,5,26,
2025-09-14,Jacek Olczak,Philip Morris,11,25,4,40,
2025-09-14,Preston Feight,Paccar,9,27,1,37,
2025-09-14,Marc Benioff,Salesforce,8,20,12,40,
2025-09-14,Leon Topalian,Nucor,14,23,3,40,
2025-09-14,Michael Dastoor,Jabil,3,5,0,8,
2025-09-14,Jonathan Jaffe,Lennar,1,7,2,10,
2025-09-14,David Ricks,Eli Lilly,9,21,10,40,
2025-09-14,Joe Zubretsky,Molina Healthcare,10,2,3,15,
2025-09-14,Jennifer Rumsey,Cummins,8,27,5,40,
2025-09-14,Robin Vince,Bank of New York Mellon,20,19,1,40,
2025-09-14,Ted Sarandos,Netflix,12,26,2,40,
2025-09-14,William H Rogers Jr,Truist Financial,3,7,0,10,
2025-09-14,Sean Kerins,Arrow Electronics,1,10,0,11,
2025-09-14,William M Brown,3M,2,8,0,10,
2025-09-14,Ryan McInerney,Visa,13,23,4,40,
2025-09-14,Marc Rowan,Apollo Global Management,13,22,5,40,
2025-09-14,Tim Go,HF Sinclair,5,2,0,7,
2025-09-14,Robert Sulentic,CBRE Group,1,6,1,8,
2025-09-14,William Demchak,PNC Financial Services,14,21,5,40,
2025-09-14,Bryan DeBoer,Lithia Motors,6,33,1,40,
2025-09-14,William Nash,CarMax,3,5,2,10,
2025-09-14,Brian Robbins,Paramount Global,10,30,0,40,
2025-09-14,Michael Creedon,Dollar Tree,6,32,2,40,
2025-09-14,Sandy Douglas,United Natural Foods,33,5,2,40,
2025-09-14,Alex Chriss,PayPal,13,23,4,40,
2025-09-14,Roger Penske,Penske Automotive,16,23,1,40,
2025-09-14,Antonio Neri,Hewlett Packard Enterprise,8,25,7,40,
2025-09-14,Harry Sideris,Duke Energy,36,4,0,40,
2025-09-14,Vicki Hollub,Occidental Petroleum,20,17,3,40,
2025-09-14,Lawrence Coben,NRG Energy,5,3,0,8,
2025-09-14,Robert Bradway,Amgen,10,28,2,40,
2025-09-14,John Ketchum,NextEra Energy,24,16,0,40,
2025-09-14,Rainer Blair,Danaher,6,15,2,23,
2025-09-14,Daniel ODay,Gilead Sciences,1,8,1,10,
2025-09-14,Michael Manley,AutoNation,3,6,1,10,
2025-09-14,Carlos Abrams-Rivera,Kraft Heinz,10,23,7,40,
2025-09-14,Philip Gallagher,Avnet,1,5,0,6,
2025-09-14,Gary Dickerson,Applied Materials,6,21,13,40,
2025-09-14,Bob Jordan,Southwest Airlines,9,24,7,40,
2025-09-14,Rick Wurster,Charles Schwab,13,22,4,39,
2025-09-14,Lorenzo Simonelli,Baker Hughes,16,21,3,40,
2025-09-14,Chris Kempczinski,McDonalds,10,22,8,40,
2025-09-14,Christopher Womack,Southern Company,3,7,0,10,
2025-09-14,Michael Miebach,Mastercard,13,24,3,40,
2025-09-14,Joseph Dominguez,Constellation Energy,14,9,1,24,
2025-09-14,Christopher Swift,The Hartford,14,23,3,40,
2025-09-14,Patricia Poppe,PG&E,8,13,2,23,
2025-09-14,Bom Kim,Coupang,9,30,1,40,
2025-09-14,Ezra Yacob,EOG Resources,25,13,2,40,
2025-09-14,Jim Vena,Union Pacific,12,26,2,40,
2025-09-14,Matt Schroeder,Rite Aid,3,34,3,40,
2025-09-14,Tony Spring,Macys,10,25,5,40,
2025-09-14,Anthony Capuano,Marriott International,12,26,2,40,
2025-09-14,Raymond E Scott,Lear Corporation,2,8,0,10,
2025-09-14,William Stengel II,Genuine Parts,0,4,0,4,
2025-09-14,Heidi Petz,Sherwin-Williams,9,28,2,39,
2025-09-14,Jeff Miller,Halliburton,12,23,5,40,
2025-09-14,Kathleen Quirk,Freeport-McMoRan,13,17,2,32,
2025-09-14,Michael Rapino,Live Nation Entertainment,15,22,3,40,
2025-09-14,John Doyle,Marsh & McLennan,9,6,1,16,
2025-09-14,Lisa Su,Advanced Micro Devices,16,19,5,40,
2025-09-14,Frank Holding,First Citizens BancShares,9,16,2,27,
2025-09-14,John Engel,WESCO International,3,15,1,19,
2025-09-14,David Gitlin,Carrier Global,14,25,1,40,
2025-09-14,Lourenco Goncalves,Cleveland-Cliffs,5,21,14,40,
2025-09-14,Calvin G Butler Jr,Exelon,6,4,0,10,
2025-09-14,Joseph Bae,KKR & Co,8,7,1,16,
2025-09-14,Christine Leahy,CDW,0,8,2,10,
2025-09-14,Glenn Fogel,Booking Holdings,12,23,5,40,
2025-09-14,Brian Doubles,Synchrony Financial,5,7,2,14,
2025-09-14,Earl Austin,Quanta Services,2,5,1,8,
2025-09-14,Christian Ulbrich,Jones Lang LaSalle,7,16,0,23,
2025-09-14,Saumya Sutaria,Tenet Healthcare,6,2,1,9,
2025-09-14,William Gifford,Altria Group,1,7,1,9,
2025-09-14,Kevin Lobo,Stryker,12,25,3,40,
2025-09-14,Michael Hsu,Kimberly-Clark,5,7,0,12,
2025-09-14,Jack Fusco,Cheniere Energy,18,18,4,40,
2025-09-14,James Conroy,Ross Stores,4,14,0,18,
2025-09-14,Anthony Smurfit,Smurfit Westrock,3,5,0,8,
2025-09-14,Jeffrey Harmening,General Mills,3,17,5,25,
2025-09-14,Mark Stewart,Goodyear Tire & Rubber,3,36,1,40,
2025-09-14,Bob Eddy,BJs Wholesale Club,4,21,3,28,
2025-09-14,Peter Arduini,GE HealthCare Technologies,4,8,0,12,
2025-09-14,Noel Wallace,Colgate-Palmolive,10,20,2,32,
2025-09-14,Marc Bitzer,Whirlpool,12,14,14,40,
2025-09-14,Chris Kubasik,L3Harris Technologies,7,12,1,20,
2025-09-14,Shantanu Narayen,Adobe,18,20,1,39,
2025-09-14,Thomas Polen,Becton Dickinson,6,4,0,10,
2025-09-14,Richard P Dealy,Pioneer Natural Resources,7,3,0,10,
2025-09-14,Ravi Kumar S,Cognizant Technology Solutions,11,21,3,35,
2025-09-14,Andrew Clyde,Murphy USA,14,25,1,40,
2025-09-14,Mike Lyons,Fiserv,4,11,0,15,
2025-09-14,Jennifer Parmentier,Parker-Hannifin,3,14,0,17,
2025-09-14,William Fehrman,American Electric Power,3,7,0,10,
2025-09-14,Andrew Silvernail,International Paper,5,24,0,29,
2025-09-14,Jonas Prising,ManpowerGroup,7,23,2,32,
2025-09-14,John Zillmer,Aramark,7,13,2,22,
2025-09-14,Mark Millett,Steel Dynamics,16,2,0,18,
2025-09-14,Dan Amos,Aflac,13,17,10,40,
2025-09-14,Tony Cheng,Reinsurance Group of America,2,10,2,14,
2025-09-14,Karsanbhai,Emerson Electric,8,14,2,24,
2025-09-14,Ronald P OHanley,State Street,0,4,0,4,
2025-09-14,Timothy Knavish,PPG Industries,0,1,0,1,
2025-09-14,David Burritt,United States Steel,9,20,10,39,
2025-09-14,Maria Black,Automatic Data Processing,4,5,0,9,
2025-09-14,Daryl Kenningham,Group 1 Automotive,10,27,3,40,
2025-09-14,Robert Blue,Dominion Energy,27,11,2,40,
2025-09-14,Larry Fink,BlackRock,8,25,7,40,
2025-09-14,Pierce Norton II,Oneok,5,4,1,10,
2025-09-14,David Bozeman,CH Robinson Worldwide,2,8,0,10,
2025-09-14,Haviv Ilan,Texas Instruments,12,25,3,40,
2025-09-14,Michael Bender,Kohls,0,15,8,23,
2025-09-14,Philip Daniele III,AutoZone,0,2,0,2,
2025-09-14,Timothy Archer,Lam Research,3,7,0,10,
2025-09-14,Charles Magro,Corteva,5,3,1,9,
2025-09-14,Rick Lanoha,Peter Kiewit Sons,0,2,0,2,
2025-09-14,Peter Jackson,Builders FirstSource,3,12,1,16,
2025-09-14,Martin Schroeter,Kyndryl,10,30,0,40,
2025-09-14,Hamid Akhavan,EchoStar,5,27,8,40,
2025-09-14,Bill Westrate,American Family Insurance,10,16,2,28,
2025-09-14,Avigal Soreq,Delek US,5,8,5,18,
2025-09-14,Beth Ford,Land OLakes,4,6,1,11,
2025-09-14,Walker Martin,Sempra,0,2,0,2,
2025-09-14,Eric Slifka,Global Partners,11,23,6,40,
2025-09-14,DG Macpherson,WW Grainger,2,7,1,10,
2025-09-14,Bob Pragada,Jacobs Solutions,4,9,0,13,
2025-09-14,Pedro Pizarro,Edison International,16,7,17,40,
2025-09-14,William Hornbuckle,MGM Resorts International,8,25,1,34,
2025-09-14,Andrew McMahon,Guardian Life insurance,5,12,0,17,
2025-09-14,Christopher OHerlihy,Illinois Tool Works,0,1,0,1,
2025-09-14,James Cracchiolo,Ameriprise Financial,2,23,2,27,
2025-09-14,Ryan Marshall,PulteGroup,9,15,10,34,
2025-09-14,Matthew Meloy,Targa Resources,5,5,0,10,
2025-09-14,Michael Rhodes,Ally Financial,8,28,4,40,
2025-09-14,Joseph Fadool,BorgWarner,4,10,0,14,
2025-09-14,St√©phane de La Faverie,Est√©e Lauder,14,22,4,40,
2025-09-14,Benjamin Tisch,Loews,2,7,0,9,
2025-09-14,Brad Beckham,OReilly Automotive,2,7,0,9,
2025-09-14,Thomas Gayner,Markel Group,2,8,0,10,
2025-09-14,Donald Allan,Stanley Black & Decker,8,30,2,40,
2025-09-14,Sanjay Mehrotra,Micron Technology,16,22,2,40,
2025-09-14,James Breuer,Fluor,1,1,1,3,
2025-09-14,Thomas Bell,Leidos,9,18,2,29,
2025-09-14,Scott Smith,Viatris,7,4,0,11,
2025-09-14,Kimberly Dang,Kinder Morgan,9,1,0,10,
2025-09-14,Christophe Beck,Ecolab,19,21,0,40,
2025-09-14,Brent Shafer,Baxter International,1,10,0,11,
2025-09-14,Clay Gaspar,Devon Energy,22,3,0,25,
2025-09-14,Steven Cahillane,Kellanova,1,7,0,8,
2025-09-14,Raul Nicholas Vargas Ochoa,Farmers Insurance Exchange,0,0,0,0,
2025-09-14,Darren Rebelez,Caseys General Stores,3,6,0,9,
2025-09-14,Ari Bousbib,IQVIA,6,16,0,22,
2025-09-14,Jon Vander Ark,Republic Services,12,18,10,40,
2025-09-14,Timothy Cofer,Keurig Dr Pepper,2,6,1,9,
2025-09-14,Karla Lewis,Reliance Inc,5,5,0,10,
2025-09-14,David Hult,Asbury Automotive Group,7,32,1,40,
2025-09-14,Darryl Button,Pacific Life,0,8,0,8,
2025-09-14,James Burke,Vistra,8,2,0,10,
2025-09-14,John Barrett,Western & Southern Financial,11,27,2,40,
2025-09-14,William Krueger,The Andersons Inc,0,2,0,2,
2025-09-14,Erik Nordstrom,Nordstrom,7,28,5,40,
2025-09-14,John Wren,Omnicom Group,14,20,6,40,
2025-09-14,Stephanie Ferris,Fidelity National Information Services,15,22,3,40,
2025-09-14,Timothy Cawley,Consolidated Edison,4,6,0,10,
2025-09-14,Joseph Hinrichs,CSX,6,9,1,16,
2025-09-14,Troy Rudd,AECOM,7,24,4,35,
2025-09-14,Kathleen Johnson,Lumen Technologies,4,5,1,10,
2025-09-14,Harry Lawton III,Tractor Supply,1,0,0,1,
2025-09-14,Raul Fernandez,DXC Technology,4,27,1,32,
2025-09-14,Eric Hansotia,AGCO,12,21,1,34,
2025-09-14,David Bruton Smith,Sonic Automotive,3,7,9,19,
2025-09-14,Sasan Goodarzi,Intuit,11,25,4,40,
2025-09-14,Matthew Flannery,United Rentals,34,1,0,35,
2025-09-14,Marc Miller,Universal Health Services,2,23,3,28,
2025-09-14,Michael Mahoney,Boston Scientific,11,29,0,40,
2025-09-14,Judith Marks,Otis Worldwide,3,4,0,7,
2025-09-14,Robert Frenzel,Xcel Energy,4,3,1,8,
2025-09-14,Penny Pennington,Edward Jones,6,29,5,40,
2025-09-14,Daniel Fisher,Ball,1,19,6,26,
2025-09-14,Justin Jude,LKQ,4,5,1,10,
2025-09-14,James Blackledge,Mutual of Omaha,1,32,2,35,
2025-09-14,Bruce Bodine,Mosaic,3,6,0,9,
2025-09-14,Scott Donnelly,Textron,10,27,3,40,
2025-09-14,Adam Schechter,Labcorp Holdings,2,6,0,8,
2025-09-14,Deanna Strable-Soethout,Principal Financial,1,7,0,8,
2025-09-14,Leonard Schleifer,Regeneron Pharmaceuticals,6,27,7,40,
2025-09-14,Paul Shoukry,Raymond James Financial,15,24,1,40,
2025-09-14,Lauren Hobart,Dicks Sporting Goods,12,25,3,40,
2025-09-14,Jamie Whisnant,Auto-Owners Insurance,0,2,0,2,
2025-09-14,Ariane Gorin,Expedia,10,28,1,39,
2025-09-14,Shelley Simpson,JB Hunt Transport Services,8,28,4,40,
2025-09-14,Ren√© Jones,M&T Bank,12,23,5,40,
2025-09-14,Gerardo Norcia,DTE Energy,6,2,1,9,
2025-09-14,Andr√©s Gluski,AES,13,17,0,30,
2025-09-14,Timothy Spence,Fifth Third Bancorp,5,4,1,10,
2025-09-14,Eduardo Menezes,Air Products & Chemicals,3,6,1,10,
2025-09-14,Wendell Weeks,Corning,14,24,2,40,
2025-09-14,Anthony Guzzi,EMCOR Group,2,5,2,9,
2025-09-14,Adam Norwitt,Amphenol,3,17,0,20,
2025-09-14,Jean-Marc Gilson,Westlake Corporation,2,3,1,6,
2025-09-14,Lori Koch,DuPont,7,19,0,26,
2025-09-14,Derek Chang,Liberty Media,36,3,1,40,
2025-09-14,Martina Cheung,S&P Global,10,26,0,36,
2025-09-14,Tim Hingtgen,Community Health Systems,9,28,3,40,
2025-09-14,Brian Tierney,FirstEnergy,6,21,3,30,
2025-09-14,Rick McKenney,Unum Group,6,4,0,10,
2025-09-14,Stanley Bergman,Henry Schein,13,26,1,40,
2025-09-14,Tiang Yew Tan,Western Digital,1,3,0,4,
2025-09-14,Vincent Roche,Analog Devices,14,22,4,40,
2025-09-14,Sean Connolly,Conagra Brands,8,30,2,40,
2025-09-14,Bruce Van Saun,Citizens Financial Group,14,24,2,40,
2025-09-14,Mark George,Norfolk Southern,18,18,4,40,
2025-09-14,Andrew Marsh,Entergy,4,4,0,8,
2025-09-14,Robert Berkley,WR Berkley,8,28,4,40,
2025-09-14,Javier Rodriguez,DaVita,15,13,1,29,
2025-09-14,Michael OGrady,Northern Trust,3,1,0,4,
2025-09-14,James Snee,Hormel Foods,4,27,1,32,
2025-09-14,Timothy J Donahue,Crown Holdings,2,9,0,11,
2025-09-14,Joseph Ferraro,Avis Budget,2,7,1,10,
2025-09-14,Niraj Shah,Wayfair,7,26,7,40,
2025-09-14,Jos√© Mas,MasTec,6,13,0,19,
2025-09-14,Joseph Nolan,Eversource Energy,5,4,1,10,
2025-09-14,Thomas Palmer,Newmont,5,5,0,10,
2025-09-14,Robert Sanchez,Ryder System,9,6,1,16,
2025-09-14,Michael Nolan,Fidelity National Financial,4,1,0,5,
2025-09-14,Gavin Hattersley,Molson Coors Beverage,5,29,6,40,
2025-09-14,Thomas Reeg,Caesars Entertainment,5,5,0,10,
2025-09-14,Ellen Cooper,Lincoln National,3,7,0,10,
2025-09-14,Bracken Darrell,VF Corporation,5,33,2,40,
2025-09-14,Erik Fyrwald,International Flavors & Fragrances,7,9,3,19,
2025-09-14,Christopher Kastner,Huntington Ingalls Industries,3,4,1,8,
2025-09-14,Shane OKelly,Advance Auto Parts,0,6,0,6,
2025-09-14,Ralph LaRossa,Public Service Enterprise Group,12,15,0,27,
2025-09-14,Kecia Steelman,Ulta Beauty,35,4,1,40,
2025-09-14,Michele Buck,Hershey,4,34,2,40,
2025-09-14,Sumit Singh,Chewy,12,24,4,40,
2025-09-14,Steven Vondran,American Tower,4,6,0,10,
2025-09-14,Jeffrey Lorberbaum,Mohawk Industries,11,5,1,17,
2025-09-14,Keith Demmings,Assurant,4,9,0,13,
2025-09-14,Robert Martin,Thor Industries,4,5,1,10,
2025-09-14,Kathleen Mazzarella,Graybar Electric,1,6,1,8,
2025-09-14,Joey Wat,Yum China,16,21,3,40,
2025-09-14,Scott Richardson,Celanese,6,15,2,23,
2025-09-14,David Rawlinson II,QVC,8,16,2,26,
2025-09-14,Alan Armstrong,Williams,23,13,4,40,
2025-09-14,Philippe Krakowsky,Interpublic Group,13,24,3,40,
2025-09-14,Brendan McCracken,Ovintiv,6,4,0,10,
2025-09-14,Andrew Teno,Icahn Enterprises,4,6,0,10,
2025-09-14,Stephen Steinour,Huntington Bancshares,1,9,0,10,
2025-09-14,Timothy NeCastro,Erie Insurance,3,7,0,10,
2025-09-14,Ernest Garcia III,Carvana,26,10,4,40,
2025-09-14,R Bruce McDonald,Dana Incorporated,3,8,1,12,
2025-09-14,William Oplinger,Alcoa Corporation,1,7,1,9,
2025-09-14,Mark Pearson,Equitable,7,8,0,15,
2025-09-14,Richard Wallace,KLA,2,2,0,4,
2025-09-14,Ricardo Cardenas,Darden Restaurants,4,4,1,9,
2025-09-14,Mikael Bratt,Autoliv,6,6,2,14,
2025-09-14,Benito Minicucci,Alaska Air,2,3,2,7,
2025-09-14,Christopher Gorman,KeyCorp,5,5,0,10,
2025-09-14,Robert Goldstein,Las Vegas Sands,5,30,5,40,
2025-09-14,Edward Pesicka,Owens & Minor,3,32,1,36,
2025-09-14,Christopher Nassetta,Hilton Worldwide,8,16,2,26,
2025-09-14,Jamie Iannone,Ebay,19,18,3,40,
2025-09-14,Patrick Gallagher,Arthur J Gallagher,9,29,2,40,
2025-09-14,Rich Steinmeier,LPL Financial,23,15,2,40,
2025-09-14,Stephen Spray,Cincinnati Financial,1,6,2,9,
2025-09-14,Douglas Yearley,Toll Brothers,10,25,5,40,
2025-09-14,Gregory Brown,Motorola Solutions,2,6,1,9,
2025-09-14,Brian Chesky,Airbnb,2,31,7,40,
2025-09-14,Jeffrey Sprecher,Intercontinental Exchange,15,21,4,40,
2025-09-14,Robert Thomson,News Corp,5,32,3,40,
2025-09-14,Scott Boatwright,Chipotle Mexican Grill,9,28,3,40,
2025-09-14,Reshma Kewalramani,Vertex Pharmaceuticals,20,15,5,40,
2025-09-14,Christopher Viehbacher,Biogen,0,25,2,27,
2025-09-14,Malcolm Wilson,GXO Logistics,5,23,0,28,
2025-09-14,Tony Sarsam,SpartanNash,17,21,2,40,
2025-09-14,Michael O‚ÄôSullivan,Burlington Stores,9,27,4,40,
2025-09-14,Teresa Rasmussen,Thrivent Financial for Lutherans,4,1,0,5,
2025-09-14,Eugene Bredow,NVR,0,4,1,5,
2025-09-14,Brian Chambers,Owens Corning,3,12,0,15,
2025-09-14,Rafael Santana,Westinghouse Air Brake Technologies,3,10,1,14,
2025-09-14,John Pfeifer,Oshkosh Corporation,3,17,0,20,
2025-09-14,Cameron Bready,Global Payments,8,29,3,40,
2025-09-14,Calvin McDonald,Lululemon athletica,9,31,0,40,
2025-09-14,J Kent Masters,Albemarle Corporation,4,5,0,9,
2025-09-14,Joanna Geraghty,JetBlue Airways,15,18,7,40,
2025-09-14,Robert Steer,Seaboard,1,5,0,6,
2025-09-14,William Newlands,Constellation Brands,0,5,2,7,
2025-09-14,Michael Doss,Graphic Packaging,4,8,1,13,
2025-09-14,Gil West,Hertz,6,23,9,38,
2025-09-14,Malcolm C Roberts,FM Global,2,10,2,14,
2025-09-14,Mick Beekhuizen,Campbell Soup,8,24,0,32,
2025-09-14,Daniel Wall,Expeditors International of Washington,2,4,0,6,
2025-09-14,Gregory Roberts,A-Mark Precious Metals,2,4,1,7,
2025-09-14,Horacio Rozanski,Booz Allen Hamilton,15,20,5,40,
2025-09-14,James Davis,Quest Diagnostics,5,5,0,10,
2025-09-14,Dennis Mathew,Altice,4,26,7,37,
2025-09-14,Stefan Larsson,PVH,11,24,5,40,
2025-09-14,Mark Costa,Eastman Chemical,4,14,5,23,
2025-09-14,Joyce Mullen,Insight Enterprises,6,11,0,17,
2025-09-14,John Turner,Regions Financial,21,17,2,40,
2025-09-14,Julian G Francis,Beacon Roofing Supply,0,1,0,1,
2025-09-14,Blake Moret,Rockwell Automation,12,26,2,40,
2025-09-14,Mike Speetzen,Polaris Inc,3,17,2,22,
2025-09-14,William McDermott,ServiceNow,4,4,0,8,
2025-09-14,Jure Sola,Sanmina,3,11,0,14,
2025-09-14,Bob Flexon,UGI Utilities Inc,0,1,0,1,
2025-09-14,Scott Lauber,WEC Energy,14,7,0,21,
2025-09-14,Jon Rousseau,BrightSpring Health Services,20,19,1,40,
2025-09-14,Todd Schneider,Cintas,11,18,1,30,
2025-09-14,Peter Matt,Commercial Metals,4,5,0,9,
2025-09-14,Robert D Lawler,Continental Resources,0,0,0,0,
2025-09-14,Domenic Dell‚ÄôOsso Jr,Expand Energy,4,0,0,4,
2025-09-14,Jason P Wells,CenterPoint Energy,8,4,1,13,
2025-09-14,H Michael Krimbill,NGL Energy Partners,7,1,0,8,
2025-09-14,Tony Xu,DoorDash,15,18,7,40,
2025-09-14,Clay Williams,NOV,8,18,3,29,
2025-09-14,Kristin Peck,Zoetis,12,20,1,33,
2025-09-14,Mark Smucker,JM Smucker,12,22,6,40,
2025-09-14,Steve Sanghi,Microchip Technology,8,28,4,40,
2025-09-14,Richard Tobin,Dover Corporation,2,4,0,6,
2025-09-14,Kaes Van‚Äôt Hof,Diamondback Energy,20,16,3,39,
2025-09-14,Deon Stander,Avery Dennison,0,13,0,13,
2025-09-14,Vincent Sorgi,PPL,9,9,1,19,
2025-09-14,Hassane El-Khoury,ON Semiconductor,1,17,5,23,
2025-09-14,Arie Kotler,ARKO,5,21,0,26,
2025-09-14,William Monteleone,Par Pacific,1,6,2,9,
2025-09-14,John Christmann IV,APA,6,3,1,10,
2025-09-14,Adaire Fox-Martin,Equinix,16,22,2,40,
2025-09-14,Joseph M Otting,Flagstar Financial,2,5,2,9,
2025-09-14,Mary Dillon,Foot Locker,10,25,5,40,
2025-09-14,James Zallie,Ingredion,4,6,0,10,
2025-09-14,Christopher Peterson,Newell Brands,0,9,1,10,
2025-09-14,Scott Salmirs,ABM Industries,5,5,1,11,
2025-09-14,Christopher Hilger,Securian Financial,0,7,0,7,
2025-09-14,Hamid Moghadam,Prologis,8,27,5,40,
2025-09-14,Stephen Schwarzman,Blackstone,12,20,8,40,
2025-09-14,Robert Greenberg,Skechers USA,5,23,3,31,
2025-09-14,Keith Allman,Masco,3,9,1,13,
2025-09-14,Rusty Rush,Rush Enterprises,15,22,3,40,
2025-09-14,Jennifer Johnson,Franklin Resources,1,8,1,10,
2025-09-14,Gerry P Smith,ODP Business Solutions,0,0,0,0,
2025-09-14,Carl Lindner lll,American Financial,0,0,0,0,
2025-09-14,Mark Kowlzan,Packaging Corp of America,0,8,1,9,
2025-09-14,Thomas Hill,Vulcan Materials,4,7,2,13,
2025-09-14,Milan Galik,Interactive Brokers,8,17,2,27,
2025-09-14,Laura Alber,Williams-Sonoma,15,21,4,40,
2025-09-14,Mario Harik,XPO,7,32,1,40,
2025-09-14,Devin Stockfish,Weyerhaeuser,5,5,0,10,
2025-09-14,Thomas J McInerney,Genworth Financial,1,6,0,7,
2025-09-14,Garrick Rochow,CMS Energy,10,3,1,14,
2025-09-14,Toni Townes-Whitley,Science Applications International,10,19,1,30,
2025-09-14,Rich Handler,Jefferies Financial,12,12,2,26,
2025-09-14,Daniel Heaf,Bath & Body Works,14,24,2,40,
2025-09-14,Andrew Wilson,Electronic Arts,12,19,9,40,
2025-09-14,Sheryl Palmer,Taylor Morrison Home,9,10,1,20,
2025-09-14,Ivan Tornos,Zimmer Biomet,10,28,2,40,
2025-09-14,Linda Rendle,Clorox,1,34,3,38,
2025-09-14,Matthew Pine,Xylem Inc,1,9,1,11,
2025-09-14,Heather Lavallee,Voya Financial,6,10,2,18,
2025-09-14,Daniel Florness,Fastenal,3,5,2,10,
2025-09-14,Albert Nahmad,Watsco,2,7,0,9,
2025-09-14,Carl Eschenbach,Workday,13,18,9,40,
2025-09-14,Craig Smiddy,Old Republic International,3,5,1,9,
2025-09-14,Frank C Sullivan,RPM International,3,7,1,11,
2025-09-14,Matthew Missad,UFP Industries,8,2,0,10,
2025-09-14,Martin J Lyons,Ameren,3,3,1,7,
2025-09-14,Adam W Miller,Knight Swift Transportation,1,2,1,4,
2025-09-14,Rodney Sacks,Monster Beverage,13,25,1,39,
2025-09-14,Gary Guthart,Intuitive Surgical,13,22,5,40,
2025-09-14,Charles Liang,Super Micro Computer,34,6,0,40,
2025-09-14,Christopher Caldwell,Concentrix,3,4,0,7,
2025-09-14,Gordon J Hardie,O-I Glass,0,4,0,4,
2025-09-14,David Gibbs,Yum Brands,3,37,0,40,
2025-09-14,Steve Henry,Domtar,4,5,0,9,
2025-09-14,Chuck Treadway,CommScope,8,18,3,29,
2025-09-14,Rob Vitale,Post Holdings,1,13,5,19,
2025-09-14,Steven J Moskowitz,Crown Castle,2,5,3,10,
2025-09-14,Emmanuel Ligner,Avantor,2,10,1,13,
2025-09-14,Stuart Bradie,KBR,13,13,4,30,
2025-09-14,Carrie Wheeler,Opendoor Technologies,11,25,4,40,
2025-09-14,Russell Becker,APi Group,3,5,0,8,
2025-09-14,Toby Rice,EQT,25,13,2,40,
2025-09-14,Jesse Arenivas,EnLink Midstream,8,9,0,17,
2025-09-14,Nikesh Arora,Palo Alto Networks,6,24,10,40,
2025-09-14,Steven Bandrowczak,Xerox,2,7,1,10,
2025-09-14,Vicente Reynal,Ingersoll Rand,8,28,0,36,
2025-09-14,William T Dillard II,Dillards,4,3,1,8,
2025-09-14,C Howard Nye,Martin Marietta Materials,3,4,3,10,
2025-09-14,Giordano Albertazzi,Vertiv,15,17,3,35,
2025-09-14,Stephane Bancel,Moderna,8,21,11,40,
2025-09-14,Nate R Jorgensen,Boise Cascade,0,0,0,0,
2025-09-14,Jack Sinclair,Sprouts Farmers Market,18,22,0,40,
2025-09-14,Padraig McDonnell,Agilent Technologies,10,11,0,21,
2025-09-14,Kenneth T Lane,Olin,0,0,0,0,
2025-09-14,Randall C Stuewe,Darling Ingredients,27,1,0,28,
2025-09-14,R Howard Coker,Sonoco Products,2,7,1,10,
2025-09-14,John Mengucci,CACI International,21,18,1,40,
2025-09-14,Mark Witkowski,Core & Main,2,14,2,18,
2025-09-14,Lee M Tillman,Marathon Oil,4,5,0,9,
2025-09-14,Mark Hoplamazian,Hyatt Hotels,15,20,5,40,
2025-09-14,David S Chernow,Select Medical,0,9,1,10,
2025-09-14,Brendan M Foley,McCormick & Company,0,8,0,8,
2025-09-14,Joanne Crevoiserat,Tapestry,13,24,3,40,
2025-09-14,John Plant,Howmet Aerospace,4,11,3,18,
2025-09-14,Shankh Mitra,Welltower,15,24,1,40,
2025-09-14,W Anthony Will,CF Industries,4,5,0,9,
2025-09-14,David A Zapico,Ametek,2,16,1,19,
2025-09-14,Kevin Stein,TransDigm,11,9,2,22,
2025-09-14,Craig Billings,Wynn Resorts,12,25,3,40,
2025-09-14,William J Way,Southwestern Energy,2,0,0,2,
2025-09-14,Giel Rutten,Amkor Technology,3,6,1,10,
2025-09-14,Paul Sarvadi,Insperity,4,5,0,9,
2025-09-14,Donald Zurbay,Patterson Companies Inc,1,4,0,5,
2025-09-14,Rob Sharps,T Rowe Price,13,22,5,40,
2025-09-14,Patrice Louvet,Ralph Lauren,14,17,9,40,
2025-09-14,Jeffrey Mezger,KB Home,4,28,7,39,
2025-09-14,David M Foulkes,Brunswick,1,8,0,9,
2025-09-14,M Keith Waddell,Robert Half,4,6,0,10,
2025-09-14,Jay Snowden,PENN Entertainment,18,18,4,40,
2025-09-14,George Kurian,NetApp,17,20,3,40,
2025-09-14,Kevin Ali,Organon,9,16,2,27,
2025-09-14,Joel D Anderson,Petco Health and Wellness,1,9,0,10,
2025-09-14,Louis V Pinkham,Regal Rexnord,0,1,0,1,
2025-09-14,Jay Geldmacher,Resideo Technologies,9,6,0,15,
2025-09-14,Marcus Lemonis,Camping World,10,22,8,40,
2025-09-14,Peter R Huntsman,Huntsman,6,10,2,18,
2025-09-14,Hillary Super,Victorias Secret,11,4,8,23,
2025-09-14,Michelle Gass,Levi Strauss,12,24,3,39,
2025-09-14,Neil Hunn,Roper Technologies,3,23,0,26,
2025-09-14,Steven P Lawrence,Academy Sports and Outdoors,1,1,0,2,
2025-09-14,Phillippe Lord,Meritage Homes,9,16,0,25,
2025-09-14,David C Dauch,American Axle & Manufacturing,5,7,2,14,
2025-09-14,Olumide Soroye,Fortive,1,7,1,9,
2025-09-14,Adena Friedman,Nasdaq,15,21,4,40,
2025-09-14,Tim Gokey,Broadridge Financial Solutions,4,12,1,17,
2025-09-14,Patrick M Shanahan,Spirit AeroSystems,1,9,0,10,
2025-09-14,Robert Kyncl,Warner Music Group,10,29,1,40,
2025-09-14,Denise Dignam,Chemours,3,19,3,25,
2025-09-14,Jim DeVries,ADT,10,6,1,17,
2025-09-14,Bernard Zovighian,Edwards Lifesciences,6,7,2,15,
2025-09-14,Mark E Seaton,First American Financial,1,9,0,10,
2025-09-14,John C Roche,Hanover Insurance Group,7,16,0,23,
2025-09-14,Adam J Greenlee,Silgan,0,5,0,5,
2025-09-14,Jayne Hrdlicka,Endeavor Group,0,1,0,1,
2025-09-14,Robert Fauber,Moodys Corporation,0,6,0,6,
2025-09-14,Thomas E Jorden,Coterra Energy,8,0,0,8,
2025-09-14,Eugene A Hall,Gartner,1,9,0,10,
2025-09-14,Kevin Plank,Under Armour,7,28,3,38,
2025-09-14,James W Lanning,Ingles Markets,3,4,0,7,
2025-09-14,Matthew T Farrell,Church & Dwight,7,7,0,14,
2025-09-14,Kevin M Freeman,Old Dominion Freight Line,0,0,0,0,
2025-09-14,Joe Shoen,U-Haul,15,20,4,39,
2025-09-14,Mark Bertolini,Oscar Health,15,16,8,39,
2025-09-14,Jayshree Ullal,Arista Networks,18,21,1,40,
2025-09-14,Sassine Ghazi,Synopsys,11,25,4,40,
2025-09-14,Jochen Zeitz,Harley-Davidson,5,24,11,40,
2025-09-14,Nick Jeffery,Frontier Communications,9,25,0,34,
2025-09-14,Thomas Edward McCormick,Primoris Services,0,6,0,6,
2025-09-14,D Christian Koch,Carlisle Companies,1,5,0,6,
2025-09-14,David E Simon,Simon Property Group,3,6,1,10,
2025-09-14,Stephen Bratspies,Hanesbrands,3,11,2,16,
2025-09-14,Ryan M. Schneider,Anywhere Real Estate Inc,0,1,0,1,
2025-09-14,George Bobb III,Teledyne Technologies,1,4,0,5,
2025-09-14,Terrence A Duffy,CME Group,6,9,1,16,
2025-09-14,Rami Rahim,Juniper Networks,11,26,3,40,
2025-09-14,Sue Nabi,Coty,14,17,9,40,
2025-09-14,Peter D Arvan,Pool Corporation,3,6,0,9,
2025-09-14,David Campbell,Evergy,14,9,0,23,
2025-09-14,Matthew J Murphy,Marvell Technology,2,7,1,10,
2025-09-14,Lloyd Yates,NiSource,5,5,0,10,
2025-09-14,William C Stone,SS&C Technologies,2,5,1,8,
2025-09-14,Mark Rourke,Schneider National,11,14,1,26,
2025-09-14,Andrew Anagnost,Autodesk,9,24,7,40,
2025-09-14,Dustin Semach,Sealed Air Corporation,0,8,0,8,
2025-09-14,William L Meaney,Iron Mountain,3,15,0,18,
2025-09-14,Andy P Power,Digital Realty Trust,0,0,0,0,
2025-09-14,Satish Dhanasekaran,Keysight Technologies,3,10,0,13,
2025-09-14,Frank M Svoboda,Globe Life,3,4,3,10,
2025-09-14,Carey A Smith,Parsons Corporation,0,2,0,2,
2025-09-14,Ynon Kreiz,Mattel,8,26,6,40,
2025-09-14,Karen S Haller,Southwest Gas,3,6,0,9,
2025-09-14,Terrance Williams,TruStage,5,5,1,11,
2025-09-14,Eric W Gerstenberg,Clean Harbors,6,1,1,8,
2025-09-14,Gunner Smith,Cornerstone Building Brands,1,8,1,10,
2025-09-14,Gerben W Bakker,Hubbell,1,4,0,5,
2025-09-14,Dave Davis,Spirit Airlines,4,35,1,40,
2025-09-14,Michael J Smith,Lamb Weston,0,7,3,10,
2025-09-14,Strauss Zelnick,Take-Two Interactive Software,14,16,10,40,
2025-09-14,John C Turner Jr,GMS,3,8,0,11,
2025-09-14,David M OMalley,Penn Mutual Life Insurance,0,1,0,1,
2025-09-14,Frank A Lonegro,Landstar System,1,4,0,5,
2025-09-14,James F Risoleo,Host Hotels & Resorts,5,14,0,19,
2025-09-14,Ken Xie,Fortinet,12,21,7,40,
2025-09-14,Doug Shulman,OneMain,4,6,0,10,
2025-09-14,Ryan Cohen,GameStop,9,24,7,40,
2025-09-14,Mark W Begor,Equifax,2,13,0,15,
2025-09-14,Jay L Schottenstein,American Eagle Outfitters,8,19,1,28,
2025-09-14,Curtis C Farmer,Comerica,4,8,0,12,
2025-09-14,Ole Rosgaard,Greif,2,15,1,18,
2025-09-14,Brian E Lane,Comfort Systems USA,9,1,0,10,
2025-09-14,Robert M Buck,TopBuild,5,4,1,10,
2025-09-14,Ralph Andretta,Bread Financial,3,9,0,12,
2025-09-14,Jim Anderson,Coherent,5,33,1,39,
2025-09-14,Walter C. D. Carlson,Telephone & Data Systems,0,2,0,2,
2025-09-14,Ronald Kruszewski,Stifel Financial,6,3,0,9,
2025-09-14,Richard Hayne,Urban Outfitters,11,20,8,39,
2025-09-14,Simon Meester,Terex,4,6,0,10,
2025-09-14,Edward J Lehner,Ryerson Holding,0,2,0,2,
2025-09-14,Nicholas T Pinchuk,Snap-on,4,6,0,10,
2025-09-14,Ryals McMullian,Flowers Foods,5,29,3,37,
2025-09-14,D Bryan Jordan,First Horizon,3,8,1,12,
2025-09-14,John B Gibson,Paychex,4,4,1,9,
2025-09-14,Chris Cocks,Hasbro,13,19,8,40,
2025-09-14,Pete McPartland,Sentry Insurance Group,0,2,0,2,
2025-09-14,Michael Arougheti,Ares Management,16,23,1,40,
2025-09-14,Alok Maskara,Lennox International,5,3,1,9,
2025-09-14,James C Grech,Peabody Energy,4,0,0,4,
2025-09-14,Joseph P Lacher Jr,Kemper,4,17,3,24,
2025-09-14,Perry A Sook,Nexstar Media Group,8,26,1,35,
2025-09-14,Wade Davis,TelevisaUnivision,12,27,1,40,
2025-09-14,Scott L Thompson,Tempur Sealy International,0,7,0,7,
2025-09-14,Mike Simonds,TriNet Group,0,9,0,9,
2025-09-14,B Andrew Rose,Worthington Enterprises,0,1,0,1,
2025-09-14,Bruce L Caswell,Maximus,2,4,0,6,
2025-09-14,Robert L Reffkin,Compass,1,8,0,9,
2025-09-14,Mark Eubanks,Brinks Company,1,2,1,4,
2025-09-14,Peter Quigley,Kelly Services inc,1,8,0,9,
2025-09-14,David L Yowan,Navient,1,1,0,2,
2025-09-14,Mary E Kipp,Puget Sound Energy,3,0,2,5,
2025-09-14,Adam Aron,AMC Entertainment,16,18,6,40,
2025-09-14,Mark J Tarr,Encompass Health,2,5,1,8,
2025-09-14,Liam K Griffin,Skyworks Solutions,1,6,1,8,
2025-09-14,Richard G Kyle,Timken,2,13,1,16,
2025-09-14,Ron Gusek,Liberty Energy,23,1,0,24,
2025-09-14,John E Geller Jr,Marriott Vacations Worldwide,6,6,0,12,
2025-09-14,Karl G. Glassman,Leggett & Platt,0,3,0,3,
2025-09-14,Bruce K Thorn,Big Lots,2,6,2,10,
2025-09-14,Jonathan H Weis,Weis Markets,11,28,0,39,
2025-09-14,Jeffrey B Guldner,Pinnacle West Capital,1,1,0,2,
2025-09-14,Arkadiy Dobkin,EPAM Systems,10,13,1,24,
2025-09-14,Paul M Rady,Antero Resources,3,8,0,11,
2025-09-14,Michael Spanos,Bloomin Brands,1,8,1,10,
2025-09-14,Nicole A Kivisto,MDU Resources Group,5,4,0,9,
2025-09-14,Gerald L Morgan,Texas Roadhouse,3,2,3,8,
2025-09-14,Gabriel Tirador,Mercury General,5,3,2,10,
2025-09-14,Nicholas I Fink,Fortune Brands Innovations,2,8,0,10,
2025-09-14,Paul E Burdiss,Zions Bancorp,1,1,0,2,
2025-09-14,William J Christensen,JELD-WEN Holding,4,5,0,9,
2025-09-14,Evan Spiegel,Snap Inc,20,16,4,40,
2025-09-14,Bill Burns,Zebra Technologies,7,21,1,29,
2025-09-14,Steven Sell,Agilon Health,1,7,0,8,
2025-09-14,Richard M Olson,Toro Company,1,11,0,12,
2025-09-14,Eric S Yuan,Zoom Video Communications,5,7,0,12,
2025-09-14,Dan L Batrack,Tetra Tech,2,5,1,8,
2025-09-14,Joseph D Russell Jr,Public Storage,0,7,0,7,
2025-09-14,Jacob Thaysen,Illumina inc,4,7,0,11,
2025-09-14,Debra A Cafaro,Ventas inc,7,6,0,13,
2025-09-14,Pierre R Brondeau,FMC Corporation,0,5,0,5,
2025-09-14,Judy R McReynolds,ArcBest,5,13,1,19,
2025-09-14,Russell J Weiner,Dominos Pizza inc,0,0,0,0,
2025-09-14,Theodore S Hanson,ASGN,0,0,0,0,
2025-09-14,RJ Scaringe,Rivian Automotive,10,27,3,40,
2025-09-14,Jeffrey N Simmons,Elanco Animal Health,2,6,1,9,
2025-09-14,Tim O Shaughnessy,Graham Holdings Company,2,8,0,10,
2025-09-14,Thomas V Taylor,Floor & Decor,1,2,2,5,
2025-09-14,Neil A Schrimsher,Applied Industrial Technologies,7,21,1,29,
2025-09-14,Robert E Price,PriceSmart,4,6,0,10,
2025-09-14,John David Risher,Lyft,4,4,1,9,
2025-09-14,Gary B Smith,Ciena,4,8,0,12,
2025-09-14,Joey Levin,IAC,6,31,1,38,
2025-09-14,Jim Jacobs,Country Financial,6,6,2,14,
2025-09-14,Devin B McGranahan,Western Union,1,6,0,7,
2025-09-14,R Scott Rowe,Flowserve,5,4,1,10,
2025-09-14,Kenneth A Vecchione,Western Alliance Bancorp,0,0,1,1,
2025-09-14,John C Rademacher,Option Care Health,6,1,0,7,
2025-09-14,Doug Black,SiteOne Landscape Supply,3,15,2,20,
2025-09-14,Oliver G Brewer III,Topgolf Callaway Brands,1,0,0,1,
2025-09-14,Glenn Sanford,eXp World,16,20,4,40,
2025-09-14,Fran Horowitz,Abercrombie & Fitch,11,19,10,40,
2025-09-14,Kevin Akers,Atmos Energy,7,3,0,10,
2025-09-14,Alessandro Maselli,Catalent,2,13,2,17,
2025-09-14,J Powell Brown,Brown & Brown,11,22,7,40,
2025-09-14,Aman Bhutani,GoDaddy,16,22,2,40,
2025-09-14,John C. Griffith,American Water Works,1,4,0,5,
2025-09-14,John J Marchioni,Selective Insurance Group,5,13,3,21,
2025-09-14,Lawson E Whiting,Brown-Forman,2,7,0,9,
2025-09-14,Dave Peacock,Advantage Solutions,23,6,0,29,
2025-09-14,Mick Farrell,ResMed,16,23,1,40,
2025-09-14,Kamal Hathi,Splunk,3,5,0,8,
2025-09-14,Todd Kelsey,Plexus,2,6,0,8,
2025-09-14,Phillip D Yeager,Hub Group,4,5,0,9,
2025-09-14,Steven B Hedlund,Lincoln Electric,4,9,0,13,
2025-09-14,Timothy C Oliver,NCR Atleos,0,1,0,1,
2025-09-14,Bruce Fleming,Calumet,3,6,0,9,
2025-09-14,Daniel S. Peyovich,Dycom Industries,0,3,0,3,
2025-09-14,Avner M Applbaum,Valmont Industries,0,8,0,8,
2025-09-14,Kimberly A Fields,ATI inc,4,9,0,13,
2025-09-14,Khozema Z Shipchandler,Twilio,0,2,1,3,
2025-09-14,Gary C Bhojwani,CNO Financial Group,1,5,1,7,
2025-09-14,William Andrew Hendricks Jr,Patterson-UTI Energy,0,0,0,0,
2025-09-14,Kevin D Hochman,Brinker International,1,3,0,4,
2025-09-14,James C Foster,Charles River Laboratories International,2,10,0,12,
2025-09-14,Rajiv K Prasad,Hyster-Yale,2,5,0,7,
2025-09-14,Eric T Steigerwalt,Brighthouse Financial,0,1,0,1,
2025-09-14,Thomas L Ryan,Service Corp International,4,6,0,10,
2025-09-14,Charles M Nifong Jr,CrossAmerica Partners,0,0,0,0,
2025-09-14,Anirudh Devgan,Cadence,8,24,2,34,
2025-09-14,Andi Owen,MillerKnoll,16,16,8,40,
2025-09-14,Sumit Roy,Realty Income,15,19,2,36,
2025-09-14,Timothy John Fitzgerald,Middleby,0,0,0,0,
2025-09-14,Robert H Schottenstein,M/I Homes,1,10,0,11,
2025-09-14,Stephen P MacMillan,Hologic,1,7,1,9,
2025-09-14,Lisa M Barton,Alliant Energy,2,0,0,2,
2025-09-14,Aaron P Jagdfeld,Generac,2,6,1,9,
2025-09-14,Erik Gershwind,MSC Industrial Direct,3,5,2,10,
2025-09-14,Varun Krishna,Rocket Companies,8,31,1,40,
2025-09-14,Fahmi Karam,Upbound Group,4,2,0,6,
2025-09-14,NADominic Ng,East West Bancorp,0,0,0,0,
2025-09-14,Mark Wang,Hilton Grand Vacations,38,2,0,40,
2025-09-14,Robert J Sheedy Jr,Grocery Outlet Holding,0,0,0,0,
2025-09-14,Simon D Campion,Dentsply Sirona,1,2,0,3,
2025-09-14,Jeremy Wensinger,V2X,7,6,0,13,
2025-09-14,Andrew Rees,Crocs,15,13,12,40,
2025-09-14,David M Maura,Spectrum Brands,6,0,0,6,
2025-09-14,Sachin S Lawande,Visteon,0,0,0,0,
2025-09-14,Neil M Ashe,Acuity Inc,0,2,0,2,
2025-09-14,Lorie L Tekorius,Greenbrier,1,9,0,10,
2025-09-14,John R Ciulla,Webster Financial,4,5,0,9,
2025-09-14,Sean D Keohane,Cabot Corporation,4,5,1,10,
2025-09-14,Drew M Wilkerson,RXO inc,0,0,0,0,
2025-09-14,Daniel E Brown,Chord Energy,1,0,0,1,
2025-09-14,Javier D Ferrer Fernandez,Popular inc,0,0,0,0,
2025-09-14,Olivier Rabiller,Garrett Motion inc,3,8,0,11,
2025-09-14,Ronald N Tutor,Tutor Perini Corporation,2,5,0,7,
2025-09-14,Jeff Liaw,Copart,4,6,0,10,
2025-09-14,Aman Narang,Toast inc,4,5,1,10,
2025-09-14,Joseph M Hogan,Align Technology,2,6,0,8,
2025-09-14,Kevin J Wheeler,A O Smith,0,16,1,17,
2025-09-14,Christopher A Cartwright,TransUnion,2,0,1,3,
2025-09-14,James Kelly,NCR Voyix,2,12,0,14,
2025-09-14,Tom Leighton,Akamai Technologies,16,14,5,35,
2025-09-14,Robert G Painter,Trimble,3,2,0,5,
2025-09-14,Tony Helton,Medical Mutual of Ohio,2,3,1,6,
2025-09-14,Caroline S Grace,AMN Healthcare Services,0,0,0,0,
2025-09-14,Patrick Kaltenbach,Mettler-Toledo International,1,9,0,10,
2025-09-14,Michael L Baur,ScanSource,0,2,0,2,
2025-09-14,Jason Lippert,LCI Industries,4,12,0,16,
2025-09-14,Fredric J Tomczyk,Cboe Global Markets,1,7,1,9,
2025-09-14,Octavio Marquez,Diebold Nixdorf,5,10,1,16,
2025-09-14,Sivasankaran Somasundaram,ChampionX,6,1,0,7,
2025-09-14,Ronald F Clarke,Corpay,0,0,0,0,
2025-09-14,Robert W Pittman,iHeartMedia,4,4,0,8,
2025-09-14,Patrick Zalupski,Dream Finders Homes,21,17,2,40,
2025-09-14,Keith E Smith,Boyd Gaming,0,5,0,5,
2025-09-14,Mehran Assadi,NLV Financial,1,1,0,2,
2025-09-14,Barry R Port,Ensign Group,2,5,2,9,
2025-09-14,Denise A Paulonis,Sally Beauty,0,1,0,1,
2025-09-14,Clifford A Skelton,Conduent,0,2,1,3,
2025-09-14,Jean-Michel Ribieras,Sylvamo,2,6,0,8,
2025-09-14,Douglas F Bauer,Tri Pointe Homes,0,7,0,7,
2025-09-14,Shawn OConnell,EnerSys,0,1,0,1,
2025-09-14,Bill Meury,Incyte,7,14,0,21,
2025-09-14,Dale Francescon,Century Communities,1,10,3,14,
2025-09-14,Michael Nierenberg,Rithm Capital,11,27,2,40,
2025-09-14,Michael J Brown,Euronet Worldwide,2,7,0,9,
2025-09-14,Scott Seu,Hawaiian Electric Industries,5,15,1,21,
2025-09-14,Jason D Robins,DraftKings,5,2,0,7,
2025-09-14,Jonathan J Mazelsky,IDEXX Laboratories,1,1,1,3,
2025-09-14,Richard S Swartz,MYR Group,0,0,0,0,
2025-09-14,Stefano Caroti,Deckers Outdoor,2,7,1,10,
2025-09-14,Kevin R Sayer,DexCom,1,3,0,4,
2025-09-14,John T C Lee,MKS Instruments,3,7,0,10,
2025-09-14,Edward B Pitoniak,VICI Properties,1,7,0,8,
2025-09-14,Albert White III,Cooper Cos,0,0,0,0,
2025-09-14,Barry L Biffle,Frontier Airlines,1,5,6,12,
2025-09-14,Robert A Bruggeworth,Qorvo,5,4,0,9,
2025-09-14,Winnie Park,Five Below,9,28,3,40,
2025-09-14,Steven Oakland,TreeHouse Foods,2,13,0,15,
2025-09-14,James S Hagedorn,Scotts Miracle-Gro,1,0,0,1,
2025-09-14,Michael Cannon-Brookes,Atlassian,18,21,0,39,
2025-09-14,Bertrand Loy,Entegris,2,10,1,13,
2025-09-14,William E Waltz,Atkore,3,6,0,9,
2025-09-14,Celeste B Mastin,H B Fuller,0,3,0,3,
2025-09-14,Kyle T Larkin,Granite Construction,1,5,0,6,
2025-09-14,Michael J Happe,Winnebago Industries,1,4,1,6,
2025-09-14,Steven H Gunby,FTI Consulting,5,11,0,16,
2025-09-14,Stephan B Tanda,AptarGroup,1,5,2,8,
2025-09-14,Timothy P Boyle,Columbia Sportswear,5,3,2,10,
2025-09-14,Anthony J Wood,Roku,5,3,1,9,
2025-09-14,M Christopher Doyle,Civitas Resources,1,2,0,3,
2025-09-14,Andy Eidson,Alpha Metallurgical Resources,1,5,3,9,
2025-09-14,Andy L Nemeth,Patrick Industries,4,2,0,6,
2025-09-14,Roger W Jenkins,Murphy Oil,5,13,0,18,
2025-09-14,Kevin S Blair,Synovus Financial,7,2,1,10,
2025-09-14,Julie Felss Masino,Cracker Barrel Old Country Store,11,16,13,40,
2025-09-14,David M Overton,Cheesecake Factory,1,9,0,10,
2025-09-14,Nick DeIuliis,CNX Resources,7,2,1,10,
2025-09-14,Christopher Pappas,Chefs Warehouse,4,10,1,15,
2025-09-14,Tod Carpenter,Donaldson Company,2,8,0,10,
2025-09-14,Gregory L Christopher,Mueller Industries,2,6,0,8,
2025-09-14,Rob Saltiel,MRC Global,3,12,1,16,
2025-09-14,Jillian C Evanko,Chart Industries,4,6,0,10,
2025-09-14,Dave Guilmette,Alight Solutions,3,6,0,9,
2025-09-14,Joel Smejkal,Vishay Intertechnology,5,4,0,9,
2025-09-14,Dennis Degner,Range Resources,4,8,0,12,
2025-09-14,Ira D Robbins,Valley National Bancorp,0,2,0,2,
2025-09-14,Bernard Kim,Match Group,14,19,7,40,
2025-09-14,Vincent Pilette,Gen Digital,3,10,0,13,
2025-09-14,Timothy S Crane,Wintrust Financial,2,6,1,9,
2025-09-14,Pat Roche,Moog inc,3,10,2,15,
2025-09-14,Mark R Widmar,First Solar,3,5,2,10,
2025-09-14,Niko Lahanas,Central Garden & Pet,2,11,0,13,
2025-09-14,Chris Osowski,Green Plains inc,5,7,2,14,
2025-09-14,Derek J Leathers,Werner Enterprises,1,9,0,10,
2025-09-14,Adam Foroughi,AppLovin,10,26,4,40,
2025-09-14,Luca Savi,ITT,2,8,0,10,
2025-09-14,Lawrence H Silber,Herc Rentals,0,0,0,0,
2025-09-14,Hilton H Howell Jr,Gray Television,7,19,1,27,
2025-09-14,Eric D Ashleman,IDEX,0,9,1,10,
2025-09-14,Owen D Thomas,Boston Properties,2,7,0,9,
2025-09-14,Kurt Wolf,Pitney Bowes,5,19,1,25,
2025-09-14,Sara E Armbruster,Steelcase,1,0,0,1,
2025-09-14,Charles D. Young,Sun Communities,3,5,0,8,
2025-09-14,Suzanne Foster,AdaptHealth,4,9,1,14,
2025-09-14,Grant E Sims,Genesis Energy,3,2,0,5,
2025-09-14,Laura Prieskorn,Jackson Financial,2,5,2,9,
2025-09-14,Rick L Wessel,FirstCash,4,5,1,10,
2025-09-14,Sherman Miller,Cal-Maine Foods,12,28,0,40,
2025-09-14,Paul A Lang,Arch Resources,4,5,0,9,
2025-09-14,Ashish K Khandpur,Avient,2,6,0,8,
2025-09-14,Shyam K Reddy,BlueLinx,2,7,0,9,
2025-09-14,Christopher S Ripley,Sinclair,1,8,0,9,
2025-09-14,Stacy Kymes,BOK Financial,10,6,0,16,
2025-09-14,James H Walter,Permian Resources,0,0,0,0,
2025-09-14,Jason Murray,PACS Group,5,12,2,19,
2025-09-14,Brian Armstrong,Coinbase Global,13,22,5,40,
2025-09-14,Oscar K Brown,Western Midstream Partners,1,3,0,4,
2025-09-14,Nicholas R Lower,Federated Mutual Insurance,0,0,0,0,
2025-09-14,Morris Goldfarb,G-III Apparel Group,10,25,5,40,
2025-09-14,Mark D Morelli,Vontier,0,3,0,3,
2025-09-14,Matthew J Cox,Matson inc,2,5,0,7,
2025-09-14,David W Grzebinski,Kirby Corporation,1,3,0,4,
2025-09-14,Keith A Harvey,Kaiser Aluminum,5,4,1,10,
2025-09-14,Eric Nyman,Vista Outdoor,3,9,1,13,
2025-09-14,Doug Howe,Designer Brands,5,20,0,25,
2025-09-14,Jerry E Gahlhoff Jr,Rollins inc,0,2,0,2,
2025-09-14,D Scott Barbour,Advanced Drainage Systems,3,2,0,5,
2025-09-14,Sean Gamble,Cinemark,17,21,2,40,
2025-09-14,George Kurtz,CrowdStrike,13,24,3,40,
2025-09-14,Bill Ready,Pinterest,26,14,0,40,
2025-09-14,Fidji Simo,Instacart,9,30,1,40,
2025-09-14,Kimberly K Ryan,Hillenbrand,3,6,0,9,
2025-09-14,David S Graziosi,Allison Transmission,1,19,1,21,
2025-09-14,Gary G Friedman,Restoration Hardware,1,4,0,5,
2025-09-14,Lucinda M Baier,Brookdale Senior Living,4,3,1,8,
2025-09-14,Brian J Blaser,QuidelOrtho,1,9,0,10,
2025-09-14,E Jean Savage,Trinity Industries,0,9,1,10,
2025-09-14,Liam J Kelly,Teleflex,1,3,1,5,
2025-09-14,Laurans A Mendelson,HEICO,6,16,0,22,
2025-09-14,Frank H Laukien,Bruker,2,6,1,9,
2025-09-14,Harvey M Schwartz,Carlyle Group,5,13,0,18,
2025-09-14,Mark S LaVigne,Energizer,1,1,0,2,
2025-09-14,Joel Quadracci,Quad/Graphics,10,25,5,40,
2025-09-14,Amar Maletira,Rackspace Technology,5,10,2,17,
2025-09-14,Udit Batra,Waters Corporation,10,21,0,31,
2025-09-14,Eric M Green,West Pharmaceutical Services,2,8,0,10,
2025-09-14,Doug Palladini,Carters inc,2,2,2,6,
2025-09-14,G Mike Mikan,NeueHealth,4,1,0,5,
2025-09-14,Russell ChipChilds,SkyWest,0,0,0,0,
2025-09-14,Christopher H Hunter,Acadia Healthcare,0,2,0,2,
2025-09-14,Prahlad Singh,Revvity,3,7,0,10,
2025-09-14,Maria M Pope,Portland General Electric,1,4,0,5,
2025-09-14,Charles Chip Blankenship,Woodward inc,0,2,0,2,
2025-09-14,Mike Steib,TEGNA,15,13,1,29,
2025-09-14,Kurt J Ekert,Sabre Corporation,0,1,0,1,
2025-09-14,Matt Wilson,Light & Wonder,18,18,4,40,
2025-09-14,Rob Katz,Vail Resorts,3,11,26,40,
2025-09-14,Schnitzer Steel Industries,Radius Recycling,6,26,6,38,
2025-09-14,David A Spector,PennyMac Financial Services,6,1,0,7,
2025-09-14,Frederick J Holzgrefe III,Saia inc,0,1,0,1,
2025-09-14,Mark J Parrell,Equity Residential,3,6,0,9,
2025-09-14,John W Lindsay,Helmerich & Payne,0,6,0,6,
2025-09-14,Gary D Burnison,Korn Ferry,4,14,0,18,
2025-09-14,Timothy J McGrath,PC Connection Inc,1,2,0,3,
2025-09-14,Lynn M Bamford,Curtiss-Wright,10,10,0,20,
2025-09-14,Jonathan W Witter,Sallie Mae,0,1,0,1,
2025-09-14,Jeff Benck,Benchmark Electronics,4,8,0,12,
2025-09-14,Charles H Giancarlo,Pure Storage,0,4,0,4,
2025-09-14,Brian R Gray,Knife River Corporation,0,1,0,1,
2025-09-14,Jay Schmidt,Caleres inc,3,5,2,10,
2025-09-14,Dale Asplund,BrightView Holdings,1,7,0,8,
2025-09-14,Jeffrey S Edwards,Cooper-Standard,0,7,0,7,
2025-09-14,Glenn J Williams,Primerica,5,1,2,8,
2025-09-14,Francois Locoh-Donou,F5,6,23,2,31,
2025-09-14,Joseph Wm Foran,Matador Resources,7,9,0,16,
2025-09-14,Sridhar Ramaswamy,Snowflake inc,13,19,3,35,
2025-09-14,Mark D Dankberg,Viasat,1,6,3,10,
2025-09-14,Francisco J Leon,California Resources,1,3,1,5,
2025-09-14,Peter Stern,Peloton,18,18,4,40,
2025-09-14,David Baszucki,Roblox,8,23,9,40,
2025-09-14,Jeffrey W Edwards,Installed Building Products,0,0,0,0,
2025-09-14,Clark Lauritzen,First National of Nebraska,1,7,0,8,
2025-09-14,Carlos Alberini,Guess inc,13,26,1,40,
2025-09-14,Shyam P Kambeyanda,ESAB,3,5,0,8,
2025-09-14,Edmund Shallcross III,Amica Mutual Insurance,0,4,0,4,
2025-09-14,Benjamin W Schall,AvalonBay Communities,2,5,1,8,
2025-09-14,Allan C Thygesen,DocuSign,2,5,0,7,
2025-09-14,Bryan J Knutson,Titan Machinery,1,1,0,2,
2025-09-14,Heath Sampson,ModivCare,8,1,1,10,
2025-09-14,Ara K Hovnanian,Hovnanian Enterprises,1,14,2,17,
2025-09-14,Joshua G Silverman,Etsy,1,2,0,3,
2025-09-14,Kevin Roycraft,Adams Resources & Energy,5,4,1,10,
2025-09-14,J Eric Evans,Surgery Partners,0,5,0,5,
2025-09-14,Clint E Stein,Columbia Banking System,1,4,0,5,
2025-09-14,Lee M Shavel,Verisk Analytics,2,7,0,9,
2025-09-14,Dave Banyard Jr,MasterBrand,0,0,0,0,
2025-09-14,Peter R Ingram,Hawaiian Airlines inc,1,0,0,1,
2025-09-14,Kristin A Dolan,AMC Networks,3,2,0,5,
2025-09-14,Brendan T Cavanagh,SBA Communications,1,3,0,4,
2025-09-14,George F Chappelle Jr,Americold Realty Trust,2,3,0,5,
2025-09-14,Thomas E Gottwald,NewMarket Corporation,2,8,0,10,
2025-09-14,Thomas J Baltimore Jr,Park Hotels & Resorts,4,29,1,34,
2025-09-14,Peter M Moglia,Alexandria Real Estate Equities,3,4,0,7,
2025-09-14,Ronald J Kramer,Griffon Corporation,1,7,1,9,
2025-09-14,John L Plueger,Air Lease,2,12,0,14,
2025-09-14,Jennifer F Scanlon,UL Solutions,1,3,0,4,
2025-09-14,Greg Smith,Teradyne,1,8,2,11,
2025-09-14,Sean Trauschke,OGE Energy,18,2,0,20,
2025-09-14,Norman D Schwartz,Bio-Rad Laboratories,0,0,1,1,
2025-09-14,Scott Doyle,Spire inc,4,5,1,10,
2025-09-14,Michael E Reed,Gannett,0,4,1,5,
2025-09-14,Cindy J Miller,Stericycle,2,4,2,8,
2025-09-14,Phillip D Green,Cullen Frost Bankers,1,3,3,7,
2025-09-14,Joseph D Margolis,Extra Space Storage,1,8,1,10,
2025-09-14,Mark A Skonieczny,REV Group,1,3,0,4,
2025-09-14,Ladd Wilks,ProFrac Holding,4,2,0,6,
2025-09-14,Sundaram Nagarajan,Nordson,0,9,1,10,
2025-09-14,Anne P Noonan,Summit Materials,0,1,0,1,
2025-09-14,Lori Flees,Valvoline inc,4,4,1,9,
2025-09-14,Scott H Baxter,Kontoor Brands,2,1,0,3,
2025-09-14,Tim Larson,Skyline Champion,6,0,0,6,
2025-09-14,Chuck Divita,Teladoc Health,11,19,5,35,
2025-09-14,W Bradley Southern,Louisiana-Pacific Corporation,0,0,0,0,
2025-09-14,George C Freeman III,Universal Corporation,2,7,0,9,
2025-09-14,James A Brock,Consol Energy,1,0,0,1,
2025-09-14,Robert Antokol,Playtika Holding,0,7,1,8,
2025-09-14,Joe Craft,Alliance Resource Partners,6,10,2,18,
2025-09-14,Paul Keel,Envista,2,6,1,9,
2025-09-14,Jared Isaacman,Shift4 Payments,7,27,6,40,
2025-09-14,Mark Mac McFarland,Talen Energy,3,1,1,5,
2025-09-14,Tony R Thene,Carpenter Technology,1,9,0,10,
2025-09-14,Melissa D Smith,WEX,1,6,1,8,
2025-09-14,James Jim C Ryan III,Old National Bancorp,1,0,0,1,
2025-09-14,Peter J Federico,AGNC Investment,1,0,0,1,
2025-09-14,Brent L Yeagy,Wabash National,0,1,0,1,
2025-09-14,Henry A Fernandez,MSCI,2,17,0,19,
2025-09-14,Mark Penn,Stagwell,11,23,6,40,
2025-09-14,Julie Schertell,Mativ,2,7,0,9,
2025-09-14,Ashish Chand,Belden,3,6,1,10,
2025-09-14,Greg Anderson,Allegiant Travel Company,5,7,0,12,
2025-09-14,Drew Houston,Dropbox,15,18,7,40,
2025-09-14,Kevin T Conroy,Exact Sciences,1,5,3,9,
2025-09-14,Rex D Geveden,BWX Technologies,2,7,0,9,
2025-09-14,Scott R Wells,Clear Channel Outdoor Hldgs,0,0,0,0,
2025-09-14,Paul Bay,Ingram Micro,10,25,5,40,
2025-09-15,Doug McMillon,Walmart,16,18,6,40,
2025-09-15,Andrew Jassy,Amazon,4,30,5,39,
2025-09-15,Tim Cook,Apple,12,26,2,40,
2025-09-15,Stephen Hemsley,UnitedHealth,8,28,4,40,
2025-09-15,Warren Buffett,Berkshire Hathaway,11,15,13,39,
2025-09-15,David Joyner,CVS Health,5,30,5,40,
2025-09-15,Darren Woods,Exxon Mobil,11,23,5,39,
2025-09-15,Sundar Pichai,Alphabet,16,19,5,40,
2025-09-15,Brian Tyler,McKesson,6,14,6,26,
2025-09-15,Robert Mauch,Cencora,2,8,0,10,
2025-09-15,Ron Vachris,Costco,7,31,2,40,
2025-09-15,Jamie Dimon,JPMorgan Chase,8,18,14,40,
2025-09-15,Satya Nadella,Microsoft,16,18,6,40,
2025-09-15,Jason Hollar,Cardinal Health,15,21,4,40,
2025-09-15,Mike Wirth,Chevron,18,13,9,40,
2025-09-15,David Cordani,Cigna,20,17,3,40,
2025-09-15,Jim Farley,Ford Motor,15,18,7,40,
2025-09-15,Brian Moynihan,Bank of America,7,30,3,40,
2025-09-15,Mary Barra,General Motors,12,25,3,40,
2025-09-15,Gail Boudreaux,Elevance Health,17,14,9,40,
2025-09-15,Jane Fraser,Citigroup,13,22,5,40,
2025-09-15,Sarah London,Centene,13,17,9,39,
2025-09-15,Ted Decker,Home Depot,12,24,4,40,
2025-09-15,Maryann Mannen,Marathon Petroleum,6,15,1,22,
2025-09-15,Ron Sargent,Kroger,5,24,11,40,
2025-09-15,Mark Lashier,Phillips 66,10,20,8,38,
2025-09-15,Priscilla Almodovar,Fannie Mae,10,17,13,40,
2025-09-15,Tim Wentworth,Walgreens,6,25,9,40,
2025-09-15,Lane Riggs,Valero Energy,14,7,0,21,
2025-09-15,Mark Zuckerberg,Meta,9,17,14,40,
2025-09-15,Hans Vestberg,Verizon,16,20,4,40,
2025-09-15,John Stankey,AT&T,9,25,6,40,
2025-09-15,Brian Roberts,Comcast,12,22,6,40,
2025-09-15,Charles Scharf,Wells Fargo,26,6,8,40,
2025-09-15,David Solomon,Goldman Sachs,10,18,12,40,
2025-09-15,Michael Hutchins,Freddie Mac,2,11,4,17,
2025-09-15,Michael Fiddelke,Target,8,25,7,40,
2025-09-15,Jim Rechtin,Humana,20,16,4,40,
2025-09-15,Jon Farney,State Farm Insurance,1,14,3,18,
2025-09-15,Elon Musk,Tesla,24,8,8,40,
2025-09-15,Ted Pick,Morgan Stanley,17,20,3,40,
2025-09-15,Joaquin Duato,Johnson & Johnson,12,24,4,40,
2025-09-15,Juan Luciano,Archer Daniels Midland,4,20,11,35,
2025-09-15,Ramon Laguarta,PepsiCo,7,28,5,40,
2025-09-15,Carol Tom√©,UPS,5,23,12,40,
2025-09-15,Rajesh Subramaniam,FedEx,10,29,0,39,
2025-09-15,Bob Iger,Walt Disney,12,27,1,40,
2025-09-15,Michael Dell,Dell Technologies,14,20,6,40,
2025-09-15,Marvin Ellison,Lowes,13,24,2,39,
2025-09-15,Jon Moeller,Procter & Gamble,4,30,6,40,
2025-09-15,Thomas Long,Energy Transfer,9,0,1,10,
2025-09-15,Kelly Ortberg,Boeing,7,28,4,39,
2025-09-15,Susan Morris,Albertsons,14,22,4,40,
2025-09-15,Kevin Hourican,Sysco,9,27,4,40,
2025-09-15,Christopher Calio,RTX,6,11,0,17,
2025-09-15,Larry Culp,General Electric,10,27,3,40,
2025-09-15,James Taiclet,Lockheed Martin,14,20,6,40,
2025-09-15,Stephen Squeri,American Express,15,24,1,40,
2025-09-15,Joe Creed,Caterpillar,8,29,3,40,
2025-09-15,Michel Khalaf,MetLife,11,18,0,29,
2025-09-15,Samuel Hazen,HCA Healthcare,9,5,0,14,
2025-09-15,Tricia Griffith,Progressive Insurance,8,26,5,39,
2025-09-15,Arvind Krishna,IBM,13,21,6,40,
2025-09-15,John May,Deere,8,26,6,40,
2025-09-15,Jensen Huang,Nvidia,13,22,5,40,
2025-09-15,Philip Smith,StoneX,0,9,0,9,
2025-09-15,Robert M Davis,Merck,4,18,0,22,
2025-09-15,Ryan Lance,ConocoPhillips,15,20,5,40,
2025-09-15,Albert Bourla,Pfizer,20,12,8,40,
2025-09-15,Ed Bastian,Delta Air Lines,12,15,13,40,
2025-09-15,Patrick Zammit,TD Synnex,9,13,0,22,
2025-09-15,Kevin Murphy,Publix Super Markets,10,20,1,31,
2025-09-15,Thomas J Wilson,Allstate,1,7,1,9,
2025-09-15,Chuck Robbins,Cisco Systems,14,22,4,40,
2025-09-15,Kirt Walker,Nationwide Insurance,5,5,0,10,
2025-09-15,Christopher Winfrey,Charter Communications,5,13,5,23,
2025-09-15,Bob Michael,AbbVie,0,0,0,0,
2025-09-15,Craig DeSanto,New York Life Insurance,2,21,0,23,
2025-09-15,Lip-Bu Tan,Intel,8,22,10,40,
2025-09-15,Ernie Herrman,TJX,16,23,1,40,
2025-09-15,Andrew Sullivan,Prudential Financial,13,19,0,32,
2025-09-15,Enrique Lores,Hewlett Packard,9,17,6,32,
2025-09-15,Scott Kirby,United Airlines,28,7,5,40,
2025-09-15,George Holm,Performance Food,7,22,2,31,
2025-09-15,Donnie King,Tyson Foods,7,27,6,40,
2025-09-15,Robert Isom,American Airlines,5,26,9,40,
2025-09-15,Timothy M Sweeney,Liberty Mutual Insurance,11,0,0,11,
2025-09-15,Elliott Hill,Nike,12,25,3,40,
2025-09-15,Safra Catz,Oracle,26,11,3,40,
2025-09-15,AJ Jim Teague,Enterprise Products Partners,4,12,0,16,
2025-09-15,Richard Fairbank,Capital One,17,21,2,40,
2025-09-15,Willie Chiang,Plains GP,3,5,1,9,
2025-09-15,Michael Kasbar,World Kinect,2,8,0,10,
2025-09-15,Peter Zaffino,American International Group,9,26,5,40,
2025-09-15,James Quincey,The Coca-Cola Company,10,28,2,40,
2025-09-15,Thasunda Brown Duckett,TIAA,20,20,0,40,
2025-09-15,Jay Debertin,CHS,5,11,4,20,
2025-09-15,Chris Boerner,Bristol-Myers Squibb,10,25,5,40,
2025-09-15,Corie Barry,Best Buy,38,2,0,40,
2025-09-15,Marc Casper,Thermo Fisher Scientific,15,22,3,40,
2025-09-15,Roger Crandall,Mass Mutual,2,8,0,10,
2025-09-15,Juan Andrade,USAA,5,18,0,23,
2025-09-15,Phebe Novakovic,General Dynamics,29,8,3,40,
2025-09-15,Alan Schnitzer,Travelers Insurance,3,4,2,9,
2025-09-15,David Zaslav,Warner Bros Discovery,1,34,5,40,
2025-09-15,Gunjan Kedia,US Bancorp,17,21,2,40,
2025-09-15,Robert Ford,Abbott Laboratories,12,21,7,40,
2025-09-15,Kathy Warden,Northrop Grumman,16,19,5,40,
2025-09-15,Tim Gerend,Northwestern Mutual,12,27,1,40,
2025-09-15,Todd Vasos,Dollar General,8,25,7,40,
2025-09-15,Matthew Lucey,PBF Energy,7,2,0,9,
2025-09-15,Dara Khosrowshahi,Uber,14,21,5,40,
2025-09-15,Vimal Kapur,Honeywell,11,29,0,40,
2025-09-15,Dirk Van de Put,Mondelez,7,29,4,40,
2025-09-15,Brian Niccol,Starbucks,8,28,4,40,
2025-09-15,Cristiano Amon,Qualcomm,11,26,3,40,
2025-09-15,Hock Tan,Broadcom,12,27,1,40,
2025-09-15,David Flitman,US Foods,3,7,0,10,
2025-09-15,Paul Romanowski,DR Horton,6,13,5,24,
2025-09-15,Jacek Olczak,Philip Morris,13,23,4,40,
2025-09-15,Preston Feight,Paccar,9,26,1,36,
2025-09-15,Marc Benioff,Salesforce,9,17,14,40,
2025-09-15,Leon Topalian,Nucor,14,23,3,40,
2025-09-15,Michael Dastoor,Jabil,2,5,0,7,
2025-09-15,Jonathan Jaffe,Lennar,1,7,2,10,
2025-09-15,David Ricks,Eli Lilly,9,21,10,40,
2025-09-15,Joe Zubretsky,Molina Healthcare,11,3,4,18,
2025-09-15,Jennifer Rumsey,Cummins,8,27,5,40,
2025-09-15,Robin Vince,Bank of New York Mellon,20,19,1,40,
2025-09-15,Ted Sarandos,Netflix,12,26,2,40,
2025-09-15,William H Rogers Jr,Truist Financial,3,7,0,10,
2025-09-15,Sean Kerins,Arrow Electronics,1,10,0,11,
2025-09-15,William M Brown,3M,2,8,0,10,
2025-09-15,Ryan McInerney,Visa,13,23,4,40,
2025-09-15,Marc Rowan,Apollo Global Management,12,23,5,40,
2025-09-15,Tim Go,HF Sinclair,5,2,0,7,
2025-09-15,Robert Sulentic,CBRE Group,1,8,1,10,
2025-09-15,William Demchak,PNC Financial Services,14,21,5,40,
2025-09-15,Bryan DeBoer,Lithia Motors,9,30,1,40,
2025-09-15,William Nash,CarMax,3,5,2,10,
2025-09-15,Brian Robbins,Paramount Global,8,32,0,40,
2025-09-15,Michael Creedon,Dollar Tree,6,33,1,40,
2025-09-15,Sandy Douglas,United Natural Foods,33,5,2,40,
2025-09-15,Alex Chriss,PayPal,12,24,4,40,
2025-09-15,Roger Penske,Penske Automotive,16,23,1,40,
2025-09-15,Antonio Neri,Hewlett Packard Enterprise,8,24,8,40,
2025-09-15,Harry Sideris,Duke Energy,36,4,0,40,
2025-09-15,Vicki Hollub,Occidental Petroleum,20,17,3,40,
2025-09-15,Lawrence Coben,NRG Energy,6,3,0,9,
2025-09-15,Robert Bradway,Amgen,10,28,2,40,
2025-09-15,John Ketchum,NextEra Energy,22,18,0,40,
2025-09-15,Rainer Blair,Danaher,6,15,2,23,
2025-09-15,Daniel ODay,Gilead Sciences,1,8,1,10,
2025-09-15,Michael Manley,AutoNation,3,6,1,10,
2025-09-15,Carlos Abrams-Rivera,Kraft Heinz,11,22,7,40,
2025-09-15,Philip Gallagher,Avnet,1,5,0,6,
2025-09-15,Gary Dickerson,Applied Materials,6,20,14,40,
2025-09-15,Bob Jordan,Southwest Airlines,8,26,6,40,
2025-09-15,Rick Wurster,Charles Schwab,15,20,4,39,
2025-09-15,Lorenzo Simonelli,Baker Hughes,16,20,4,40,
2025-09-15,Chris Kempczinski,McDonalds,10,21,9,40,
2025-09-15,Christopher Womack,Southern Company,2,7,0,9,
2025-09-15,Michael Miebach,Mastercard,13,24,3,40,
2025-09-15,Joseph Dominguez,Constellation Energy,14,9,1,24,
2025-09-15,Christopher Swift,The Hartford,15,22,3,40,
2025-09-15,Patricia Poppe,PG&E,8,14,2,24,
2025-09-15,Bom Kim,Coupang,10,29,1,40,
2025-09-15,Ezra Yacob,EOG Resources,25,13,2,40,
2025-09-15,Jim Vena,Union Pacific,11,28,1,40,
2025-09-15,Matt Schroeder,Rite Aid,3,34,3,40,
2025-09-15,Tony Spring,Macys,10,26,4,40,
2025-09-15,Anthony Capuano,Marriott International,12,26,2,40,
2025-09-15,Raymond E Scott,Lear Corporation,3,7,0,10,
2025-09-15,William Stengel II,Genuine Parts,0,4,0,4,
2025-09-15,Heidi Petz,Sherwin-Williams,10,27,2,39,
2025-09-15,Jeff Miller,Halliburton,11,24,5,40,
2025-09-15,Kathleen Quirk,Freeport-McMoRan,13,16,2,31,
2025-09-15,Michael Rapino,Live Nation Entertainment,14,23,3,40,
2025-09-15,John Doyle,Marsh & McLennan,9,6,1,16,
2025-09-15,Lisa Su,Advanced Micro Devices,14,20,6,40,
2025-09-15,Frank Holding,First Citizens BancShares,9,16,2,27,
2025-09-15,John Engel,WESCO International,4,15,1,20,
2025-09-15,David Gitlin,Carrier Global,14,24,2,40,
2025-09-15,Lourenco Goncalves,Cleveland-Cliffs,6,23,11,40,
2025-09-15,Calvin G Butler Jr,Exelon,6,4,0,10,
2025-09-15,Joseph Bae,KKR & Co,8,7,1,16,
2025-09-15,Christine Leahy,CDW,1,9,2,12,
2025-09-15,Glenn Fogel,Booking Holdings,11,23,6,40,
2025-09-15,Brian Doubles,Synchrony Financial,5,7,2,14,
2025-09-15,Earl Austin,Quanta Services,2,5,1,8,
2025-09-15,Christian Ulbrich,Jones Lang LaSalle,7,17,0,24,
2025-09-15,Saumya Sutaria,Tenet Healthcare,5,2,1,8,
2025-09-15,William Gifford,Altria Group,2,7,1,10,
2025-09-15,Kevin Lobo,Stryker,13,24,3,40,
2025-09-15,Michael Hsu,Kimberly-Clark,5,7,1,13,
2025-09-15,Jack Fusco,Cheniere Energy,18,18,4,40,
2025-09-15,James Conroy,Ross Stores,4,14,0,18,
2025-09-15,Anthony Smurfit,Smurfit Westrock,3,5,0,8,
2025-09-15,Jeffrey Harmening,General Mills,3,17,5,25,
2025-09-15,Mark Stewart,Goodyear Tire & Rubber,4,35,1,40,
2025-09-15,Bob Eddy,BJs Wholesale Club,5,21,3,29,
2025-09-15,Peter Arduini,GE HealthCare Technologies,3,8,0,11,
2025-09-15,Noel Wallace,Colgate-Palmolive,10,20,2,32,
2025-09-15,Marc Bitzer,Whirlpool,11,14,15,40,
2025-09-15,Chris Kubasik,L3Harris Technologies,7,13,1,21,
2025-09-15,Shantanu Narayen,Adobe,18,20,1,39,
2025-09-15,Thomas Polen,Becton Dickinson,6,4,0,10,
2025-09-15,Richard P Dealy,Pioneer Natural Resources,7,3,0,10,
2025-09-15,Ravi Kumar S,Cognizant Technology Solutions,11,18,3,32,
2025-09-15,Andrew Clyde,Murphy USA,14,25,1,40,
2025-09-15,Mike Lyons,Fiserv,4,11,0,15,
2025-09-15,Jennifer Parmentier,Parker-Hannifin,3,14,0,17,
2025-09-15,William Fehrman,American Electric Power,4,6,0,10,
2025-09-15,Andrew Silvernail,International Paper,5,23,0,28,
2025-09-15,Jonas Prising,ManpowerGroup,7,22,2,31,
2025-09-15,John Zillmer,Aramark,7,13,2,22,
2025-09-15,Mark Millett,Steel Dynamics,16,2,0,18,
2025-09-15,Dan Amos,Aflac,13,17,10,40,
2025-09-15,Tony Cheng,Reinsurance Group of America,2,10,2,14,
2025-09-15,Karsanbhai,Emerson Electric,8,14,2,24,
2025-09-15,Ronald P OHanley,State Street,0,4,0,4,
2025-09-15,Timothy Knavish,PPG Industries,0,1,0,1,
2025-09-15,David Burritt,United States Steel,9,21,9,39,
2025-09-15,Maria Black,Automatic Data Processing,4,5,0,9,
2025-09-15,Daryl Kenningham,Group 1 Automotive,12,25,3,40,
2025-09-15,Robert Blue,Dominion Energy,26,12,2,40,
2025-09-15,Larry Fink,BlackRock,10,22,8,40,
2025-09-15,Pierce Norton II,Oneok,5,3,1,9,
2025-09-15,David Bozeman,CH Robinson Worldwide,2,8,0,10,
2025-09-15,Haviv Ilan,Texas Instruments,11,26,3,40,
2025-09-15,Michael Bender,Kohls,2,24,14,40,
2025-09-15,Philip Daniele III,AutoZone,0,2,0,2,
2025-09-15,Timothy Archer,Lam Research,3,7,0,10,
2025-09-15,Charles Magro,Corteva,5,3,1,9,
2025-09-15,Rick Lanoha,Peter Kiewit Sons,0,2,0,2,
2025-09-15,Peter Jackson,Builders FirstSource,5,12,1,18,
2025-09-15,Martin Schroeter,Kyndryl,10,30,0,40,
2025-09-15,Hamid Akhavan,EchoStar,5,27,8,40,
2025-09-15,Bill Westrate,American Family Insurance,10,17,2,29,
2025-09-15,Avigal Soreq,Delek US,5,8,5,18,
2025-09-15,Beth Ford,Land OLakes,4,6,1,11,
2025-09-15,Walker Martin,Sempra,0,2,0,2,
2025-09-15,Eric Slifka,Global Partners,11,23,6,40,
2025-09-15,DG Macpherson,WW Grainger,2,7,1,10,
2025-09-15,Bob Pragada,Jacobs Solutions,5,9,0,14,
2025-09-15,Pedro Pizarro,Edison International,16,7,17,40,
2025-09-15,William Hornbuckle,MGM Resorts International,9,24,1,34,
2025-09-15,Andrew McMahon,Guardian Life insurance,5,12,0,17,
2025-09-15,Christopher OHerlihy,Illinois Tool Works,0,1,0,1,
2025-09-15,James Cracchiolo,Ameriprise Financial,2,23,2,27,
2025-09-15,Ryan Marshall,PulteGroup,7,13,9,29,
2025-09-15,Matthew Meloy,Targa Resources,4,6,0,10,
2025-09-15,Michael Rhodes,Ally Financial,9,27,4,40,
2025-09-15,Joseph Fadool,BorgWarner,4,11,0,15,
2025-09-15,St√©phane de La Faverie,Est√©e Lauder,16,21,3,40,
2025-09-15,Benjamin Tisch,Loews,2,7,0,9,
2025-09-15,Brad Beckham,OReilly Automotive,2,7,0,9,
2025-09-15,Thomas Gayner,Markel Group,2,8,0,10,
2025-09-15,Donald Allan,Stanley Black & Decker,9,29,2,40,
2025-09-15,Sanjay Mehrotra,Micron Technology,19,18,3,40,
2025-09-15,James Breuer,Fluor,1,1,1,3,
2025-09-15,Thomas Bell,Leidos,9,18,2,29,
2025-09-15,Scott Smith,Viatris,6,4,0,10,
2025-09-15,Kimberly Dang,Kinder Morgan,9,1,0,10,
2025-09-15,Christophe Beck,Ecolab,19,21,0,40,
2025-09-15,Brent Shafer,Baxter International,1,11,0,12,
2025-09-15,Clay Gaspar,Devon Energy,21,2,0,23,
2025-09-15,Steven Cahillane,Kellanova,1,7,0,8,
2025-09-15,Raul Nicholas Vargas Ochoa,Farmers Insurance Exchange,0,0,0,0,
2025-09-15,Darren Rebelez,Caseys General Stores,4,6,0,10,
2025-09-15,Ari Bousbib,IQVIA,6,15,0,21,
2025-09-15,Jon Vander Ark,Republic Services,12,18,10,40,
2025-09-15,Timothy Cofer,Keurig Dr Pepper,2,5,1,8,
2025-09-15,Karla Lewis,Reliance Inc,5,5,0,10,
2025-09-15,David Hult,Asbury Automotive Group,8,31,1,40,
2025-09-15,Darryl Button,Pacific Life,0,8,0,8,
2025-09-15,James Burke,Vistra,8,2,0,10,
2025-09-15,John Barrett,Western & Southern Financial,11,27,2,40,
2025-09-15,William Krueger,The Andersons Inc,0,2,0,2,
2025-09-15,Erik Nordstrom,Nordstrom,6,29,5,40,
2025-09-15,John Wren,Omnicom Group,13,21,6,40,
2025-09-15,Stephanie Ferris,Fidelity National Information Services,15,22,3,40,
2025-09-15,Timothy Cawley,Consolidated Edison,4,5,0,9,
2025-09-15,Joseph Hinrichs,CSX,6,9,1,16,
2025-09-15,Troy Rudd,AECOM,8,23,4,35,
2025-09-15,Kathleen Johnson,Lumen Technologies,4,5,1,10,
2025-09-15,Harry Lawton III,Tractor Supply,1,0,0,1,
2025-09-15,Raul Fernandez,DXC Technology,3,28,1,32,
2025-09-15,Eric Hansotia,AGCO,12,25,3,40,
2025-09-15,David Bruton Smith,Sonic Automotive,3,6,9,18,
2025-09-15,Sasan Goodarzi,Intuit,11,25,4,40,
2025-09-15,Matthew Flannery,United Rentals,34,1,0,35,
2025-09-15,Marc Miller,Universal Health Services,3,22,3,28,
2025-09-15,Michael Mahoney,Boston Scientific,11,29,0,40,
2025-09-15,Judith Marks,Otis Worldwide,3,4,0,7,
2025-09-15,Robert Frenzel,Xcel Energy,5,2,1,8,
2025-09-15,Penny Pennington,Edward Jones,6,29,5,40,
2025-09-15,Daniel Fisher,Ball,1,18,6,25,
2025-09-15,Justin Jude,LKQ,4,5,1,10,
2025-09-15,James Blackledge,Mutual of Omaha,1,31,2,34,
2025-09-15,Bruce Bodine,Mosaic,3,7,0,10,
2025-09-15,Scott Donnelly,Textron,10,27,3,40,
2025-09-15,Adam Schechter,Labcorp Holdings,1,6,0,7,
2025-09-15,Deanna Strable-Soethout,Principal Financial,1,8,0,9,
2025-09-15,Leonard Schleifer,Regeneron Pharmaceuticals,6,27,7,40,
2025-09-15,Paul Shoukry,Raymond James Financial,15,24,1,40,
2025-09-15,Lauren Hobart,Dicks Sporting Goods,13,24,3,40,
2025-09-15,Jamie Whisnant,Auto-Owners Insurance,0,2,0,2,
2025-09-15,Ariane Gorin,Expedia,10,29,1,40,
2025-09-15,Shelley Simpson,JB Hunt Transport Services,8,28,4,40,
2025-09-15,Ren√© Jones,M&T Bank,11,24,5,40,
2025-09-15,Gerardo Norcia,DTE Energy,6,2,1,9,
2025-09-15,Andr√©s Gluski,AES,14,22,0,36,
2025-09-15,Timothy Spence,Fifth Third Bancorp,5,4,1,10,
2025-09-15,Eduardo Menezes,Air Products & Chemicals,3,6,1,10,
2025-09-15,Wendell Weeks,Corning,14,24,2,40,
2025-09-15,Anthony Guzzi,EMCOR Group,3,5,2,10,
2025-09-15,Adam Norwitt,Amphenol,3,16,0,19,
2025-09-15,Jean-Marc Gilson,Westlake Corporation,2,3,1,6,
2025-09-15,Lori Koch,DuPont,7,19,0,26,
2025-09-15,Derek Chang,Liberty Media,37,2,1,40,
2025-09-15,Martina Cheung,S&P Global,10,25,0,35,
2025-09-15,Tim Hingtgen,Community Health Systems,10,27,3,40,
2025-09-15,Brian Tierney,FirstEnergy,6,20,3,29,
2025-09-15,Rick McKenney,Unum Group,6,5,0,11,
2025-09-15,Stanley Bergman,Henry Schein,13,26,1,40,
2025-09-15,Tiang Yew Tan,Western Digital,1,3,0,4,
2025-09-15,Vincent Roche,Analog Devices,14,22,4,40,
2025-09-15,Sean Connolly,Conagra Brands,8,30,2,40,
2025-09-15,Bruce Van Saun,Citizens Financial Group,14,24,2,40,
2025-09-15,Mark George,Norfolk Southern,15,23,2,40,
2025-09-15,Andrew Marsh,Entergy,4,4,0,8,
2025-09-15,Robert Berkley,WR Berkley,8,28,4,40,
2025-09-15,Javier Rodriguez,DaVita,14,14,1,29,
2025-09-15,Michael OGrady,Northern Trust,3,1,0,4,
2025-09-15,James Snee,Hormel Foods,4,28,1,33,
2025-09-15,Timothy J Donahue,Crown Holdings,2,9,0,11,
2025-09-15,Joseph Ferraro,Avis Budget,2,7,1,10,
2025-09-15,Niraj Shah,Wayfair,8,25,7,40,
2025-09-15,Jos√© Mas,MasTec,6,14,0,20,
2025-09-15,Joseph Nolan,Eversource Energy,5,4,1,10,
2025-09-15,Thomas Palmer,Newmont,5,5,0,10,
2025-09-15,Robert Sanchez,Ryder System,10,5,1,16,
2025-09-15,Michael Nolan,Fidelity National Financial,4,1,0,5,
2025-09-15,Gavin Hattersley,Molson Coors Beverage,4,30,6,40,
2025-09-15,Thomas Reeg,Caesars Entertainment,5,5,0,10,
2025-09-15,Ellen Cooper,Lincoln National,3,8,0,11,
2025-09-15,Bracken Darrell,VF Corporation,8,29,3,40,
2025-09-15,Erik Fyrwald,International Flavors & Fragrances,7,8,4,19,
2025-09-15,Christopher Kastner,Huntington Ingalls Industries,3,4,1,8,
2025-09-15,Shane OKelly,Advance Auto Parts,0,6,0,6,
2025-09-15,Ralph LaRossa,Public Service Enterprise Group,11,15,0,26,
2025-09-15,Kecia Steelman,Ulta Beauty,36,3,1,40,
2025-09-15,Michele Buck,Hershey,5,33,2,40,
2025-09-15,Sumit Singh,Chewy,13,23,4,40,
2025-09-15,Steven Vondran,American Tower,4,6,0,10,
2025-09-15,Jeffrey Lorberbaum,Mohawk Industries,11,5,1,17,
2025-09-15,Keith Demmings,Assurant,4,9,0,13,
2025-09-15,Robert Martin,Thor Industries,4,5,1,10,
2025-09-15,Kathleen Mazzarella,Graybar Electric,1,6,2,9,
2025-09-15,Joey Wat,Yum China,15,22,3,40,
2025-09-15,Scott Richardson,Celanese,6,15,2,23,
2025-09-15,David Rawlinson II,QVC,8,17,2,27,
2025-09-15,Alan Armstrong,Williams,24,12,4,40,
2025-09-15,Philippe Krakowsky,Interpublic Group,12,25,3,40,
2025-09-15,Brendan McCracken,Ovintiv,6,5,0,11,
2025-09-15,Andrew Teno,Icahn Enterprises,4,6,0,10,
2025-09-15,Stephen Steinour,Huntington Bancshares,2,9,0,11,
2025-09-15,Timothy NeCastro,Erie Insurance,3,7,0,10,
2025-09-15,Ernest Garcia III,Carvana,25,11,4,40,
2025-09-15,R Bruce McDonald,Dana Incorporated,3,8,1,12,
2025-09-15,William Oplinger,Alcoa Corporation,1,7,1,9,
2025-09-15,Mark Pearson,Equitable,7,7,0,14,
2025-09-15,Richard Wallace,KLA,2,3,0,5,
2025-09-15,Ricardo Cardenas,Darden Restaurants,4,3,1,8,
2025-09-15,Mikael Bratt,Autoliv,6,6,2,14,
2025-09-15,Benito Minicucci,Alaska Air,2,4,2,8,
2025-09-15,Christopher Gorman,KeyCorp,5,5,0,10,
2025-09-15,Robert Goldstein,Las Vegas Sands,4,30,6,40,
2025-09-15,Edward Pesicka,Owens & Minor,3,32,1,36,
2025-09-15,Christopher Nassetta,Hilton Worldwide,8,15,3,26,
2025-09-15,Jamie Iannone,Ebay,20,16,4,40,
2025-09-15,Patrick Gallagher,Arthur J Gallagher,9,29,2,40,
2025-09-15,Rich Steinmeier,LPL Financial,23,15,2,40,
2025-09-15,Stephen Spray,Cincinnati Financial,1,6,2,9,
2025-09-15,Douglas Yearley,Toll Brothers,10,25,5,40,
2025-09-15,Gregory Brown,Motorola Solutions,2,5,1,8,
2025-09-15,Brian Chesky,Airbnb,2,31,6,39,
2025-09-15,Jeffrey Sprecher,Intercontinental Exchange,15,21,4,40,
2025-09-15,Robert Thomson,News Corp,6,31,3,40,
2025-09-15,Scott Boatwright,Chipotle Mexican Grill,10,27,3,40,
2025-09-15,Reshma Kewalramani,Vertex Pharmaceuticals,21,14,5,40,
2025-09-15,Christopher Viehbacher,Biogen,0,25,2,27,
2025-09-15,Malcolm Wilson,GXO Logistics,5,23,0,28,
2025-09-15,Tony Sarsam,SpartanNash,18,20,2,40,
2025-09-15,Michael O‚ÄôSullivan,Burlington Stores,9,27,4,40,
2025-09-15,Teresa Rasmussen,Thrivent Financial for Lutherans,4,1,0,5,
2025-09-15,Eugene Bredow,NVR,0,4,1,5,
2025-09-15,Brian Chambers,Owens Corning,3,13,0,16,
2025-09-15,Rafael Santana,Westinghouse Air Brake Technologies,3,10,1,14,
2025-09-15,John Pfeifer,Oshkosh Corporation,3,18,0,21,
2025-09-15,Cameron Bready,Global Payments,8,29,3,40,
2025-09-15,Calvin McDonald,Lululemon athletica,9,30,1,40,
2025-09-15,J Kent Masters,Albemarle Corporation,4,6,0,10,
2025-09-15,Joanna Geraghty,JetBlue Airways,15,18,7,40,
2025-09-15,Robert Steer,Seaboard,1,5,0,6,
2025-09-15,William Newlands,Constellation Brands,0,5,2,7,
2025-09-15,Michael Doss,Graphic Packaging,3,9,1,13,
2025-09-15,Gil West,Hertz,7,24,9,40,
2025-09-15,Malcolm C Roberts,FM Global,2,9,2,13,
2025-09-15,Mick Beekhuizen,Campbell Soup,8,24,0,32,
2025-09-15,Daniel Wall,Expeditors International of Washington,2,4,0,6,
2025-09-15,Gregory Roberts,A-Mark Precious Metals,2,4,1,7,
2025-09-15,Horacio Rozanski,Booz Allen Hamilton,16,19,5,40,
2025-09-15,James Davis,Quest Diagnostics,5,5,0,10,
2025-09-15,Dennis Mathew,Altice,6,26,7,39,
2025-09-15,Stefan Larsson,PVH,11,24,5,40,
2025-09-15,Mark Costa,Eastman Chemical,4,14,5,23,
2025-09-15,Joyce Mullen,Insight Enterprises,6,11,0,17,
2025-09-15,John Turner,Regions Financial,21,17,2,40,
2025-09-15,Julian G Francis,Beacon Roofing Supply,0,1,0,1,
2025-09-15,Blake Moret,Rockwell Automation,12,26,2,40,
2025-09-15,Mike Speetzen,Polaris Inc,3,17,2,22,
2025-09-15,William McDermott,ServiceNow,4,4,0,8,
2025-09-15,Jure Sola,Sanmina,2,11,1,14,
2025-09-15,Bob Flexon,UGI Utilities Inc,0,1,0,1,
2025-09-15,Scott Lauber,WEC Energy,13,7,0,20,
2025-09-15,Jon Rousseau,BrightSpring Health Services,19,20,1,40,
2025-09-15,Todd Schneider,Cintas,11,18,1,30,
2025-09-15,Peter Matt,Commercial Metals,5,3,0,8,
2025-09-15,Robert D Lawler,Continental Resources,0,0,0,0,
2025-09-15,Domenic Dell‚ÄôOsso Jr,Expand Energy,4,0,0,4,
2025-09-15,Jason P Wells,CenterPoint Energy,7,4,1,12,
2025-09-15,H Michael Krimbill,NGL Energy Partners,6,1,0,7,
2025-09-15,Tony Xu,DoorDash,15,18,7,40,
2025-09-15,Clay Williams,NOV,7,19,4,30,
2025-09-15,Kristin Peck,Zoetis,11,19,1,31,
2025-09-15,Mark Smucker,JM Smucker,12,22,6,40,
2025-09-15,Steve Sanghi,Microchip Technology,8,28,4,40,
2025-09-15,Richard Tobin,Dover Corporation,4,4,0,8,
2025-09-15,Kaes Van‚Äôt Hof,Diamondback Energy,21,15,3,39,
2025-09-15,Deon Stander,Avery Dennison,0,13,0,13,
2025-09-15,Vincent Sorgi,PPL,8,9,1,18,
2025-09-15,Hassane El-Khoury,ON Semiconductor,2,17,4,23,
2025-09-15,Arie Kotler,ARKO,4,22,0,26,
2025-09-15,William Monteleone,Par Pacific,2,6,2,10,
2025-09-15,John Christmann IV,APA,6,4,0,10,
2025-09-15,Adaire Fox-Martin,Equinix,17,21,2,40,
2025-09-15,Joseph M Otting,Flagstar Financial,3,3,2,8,
2025-09-15,Mary Dillon,Foot Locker,10,25,5,40,
2025-09-15,James Zallie,Ingredion,4,6,0,10,
2025-09-15,Christopher Peterson,Newell Brands,0,9,1,10,
2025-09-15,Scott Salmirs,ABM Industries,5,5,1,11,
2025-09-15,Christopher Hilger,Securian Financial,0,7,0,7,
2025-09-15,Hamid Moghadam,Prologis,8,27,5,40,
2025-09-15,Stephen Schwarzman,Blackstone,11,22,7,40,
2025-09-15,Robert Greenberg,Skechers USA,5,24,3,32,
2025-09-15,Keith Allman,Masco,4,9,1,14,
2025-09-15,Rusty Rush,Rush Enterprises,14,23,3,40,
2025-09-15,Jennifer Johnson,Franklin Resources,1,8,1,10,
2025-09-15,Gerry P Smith,ODP Business Solutions,0,0,0,0,
2025-09-15,Carl Lindner lll,American Financial,0,0,0,0,
2025-09-15,Mark Kowlzan,Packaging Corp of America,0,8,1,9,
2025-09-15,Thomas Hill,Vulcan Materials,4,7,2,13,
2025-09-15,Milan Galik,Interactive Brokers,8,17,2,27,
2025-09-15,Laura Alber,Williams-Sonoma,14,22,4,40,
2025-09-15,Mario Harik,XPO,7,32,1,40,
2025-09-15,Devin Stockfish,Weyerhaeuser,5,5,0,10,
2025-09-15,Thomas J McInerney,Genworth Financial,1,5,0,6,
2025-09-15,Garrick Rochow,CMS Energy,9,2,1,12,
2025-09-15,Toni Townes-Whitley,Science Applications International,11,20,1,32,
2025-09-15,Rich Handler,Jefferies Financial,12,12,2,26,
2025-09-15,Daniel Heaf,Bath & Body Works,14,24,2,40,
2025-09-15,Andrew Wilson,Electronic Arts,13,17,10,40,
2025-09-15,Sheryl Palmer,Taylor Morrison Home,9,10,1,20,
2025-09-15,Ivan Tornos,Zimmer Biomet,9,28,3,40,
2025-09-15,Linda Rendle,Clorox,1,34,3,38,
2025-09-15,Matthew Pine,Xylem Inc,1,9,1,11,
2025-09-15,Heather Lavallee,Voya Financial,6,11,2,19,
2025-09-15,Daniel Florness,Fastenal,2,6,1,9,
2025-09-15,Albert Nahmad,Watsco,2,7,0,9,
2025-09-15,Carl Eschenbach,Workday,13,18,9,40,
2025-09-15,Craig Smiddy,Old Republic International,2,5,2,9,
2025-09-15,Frank C Sullivan,RPM International,3,7,1,11,
2025-09-15,Matthew Missad,UFP Industries,8,2,0,10,
2025-09-15,Martin J Lyons,Ameren,2,4,1,7,
2025-09-15,Adam W Miller,Knight Swift Transportation,1,2,1,4,
2025-09-15,Rodney Sacks,Monster Beverage,13,26,0,39,
2025-09-15,Gary Guthart,Intuitive Surgical,11,23,6,40,
2025-09-15,Charles Liang,Super Micro Computer,34,6,0,40,
2025-09-15,Christopher Caldwell,Concentrix,3,4,0,7,
2025-09-15,Gordon J Hardie,O-I Glass,0,5,0,5,
2025-09-15,David Gibbs,Yum Brands,3,37,0,40,
2025-09-15,Steve Henry,Domtar,4,5,0,9,
2025-09-15,Chuck Treadway,CommScope,8,18,3,29,
2025-09-15,Rob Vitale,Post Holdings,1,13,5,19,
2025-09-15,Steven J Moskowitz,Crown Castle,2,5,3,10,
2025-09-15,Emmanuel Ligner,Avantor,2,10,1,13,
2025-09-15,Stuart Bradie,KBR,14,14,4,32,
2025-09-15,Carrie Wheeler,Opendoor Technologies,11,25,4,40,
2025-09-15,Russell Becker,APi Group,3,5,0,8,
2025-09-15,Toby Rice,EQT,25,12,3,40,
2025-09-15,Jesse Arenivas,EnLink Midstream,8,8,0,16,
2025-09-15,Nikesh Arora,Palo Alto Networks,8,23,9,40,
2025-09-15,Steven Bandrowczak,Xerox,2,6,1,9,
2025-09-15,Vicente Reynal,Ingersoll Rand,8,28,0,36,
2025-09-15,William T Dillard II,Dillards,4,4,1,9,
2025-09-15,C Howard Nye,Martin Marietta Materials,4,3,3,10,
2025-09-15,Giordano Albertazzi,Vertiv,14,17,4,35,
2025-09-15,Stephane Bancel,Moderna,9,21,10,40,
2025-09-15,Nate R Jorgensen,Boise Cascade,0,1,0,1,
2025-09-15,Jack Sinclair,Sprouts Farmers Market,16,24,0,40,
2025-09-15,Padraig McDonnell,Agilent Technologies,8,12,0,20,
2025-09-15,Kenneth T Lane,Olin,0,1,0,1,
2025-09-15,Randall C Stuewe,Darling Ingredients,26,1,0,27,
2025-09-15,R Howard Coker,Sonoco Products,2,7,1,10,
2025-09-15,John Mengucci,CACI International,22,17,1,40,
2025-09-15,Mark Witkowski,Core & Main,1,12,2,15,
2025-09-15,Lee M Tillman,Marathon Oil,4,5,0,9,
2025-09-15,Mark Hoplamazian,Hyatt Hotels,15,20,5,40,
2025-09-15,David S Chernow,Select Medical,0,8,1,9,
2025-09-15,Brendan M Foley,McCormick & Company,0,8,0,8,
2025-09-15,Joanne Crevoiserat,Tapestry,13,23,4,40,
2025-09-15,John Plant,Howmet Aerospace,4,14,3,21,
2025-09-15,Shankh Mitra,Welltower,17,22,1,40,
2025-09-15,W Anthony Will,CF Industries,4,5,0,9,
2025-09-15,David A Zapico,Ametek,2,16,1,19,
2025-09-15,Kevin Stein,TransDigm,11,9,2,22,
2025-09-15,Craig Billings,Wynn Resorts,13,25,2,40,
2025-09-15,William J Way,Southwestern Energy,2,0,0,2,
2025-09-15,Giel Rutten,Amkor Technology,3,6,1,10,
2025-09-15,Paul Sarvadi,Insperity,4,6,0,10,
2025-09-15,Donald Zurbay,Patterson Companies Inc,1,5,0,6,
2025-09-15,Rob Sharps,T Rowe Price,13,22,5,40,
2025-09-15,Patrice Louvet,Ralph Lauren,13,18,9,40,
2025-09-15,Jeffrey Mezger,KB Home,4,28,7,39,
2025-09-15,David M Foulkes,Brunswick,0,9,0,9,
2025-09-15,M Keith Waddell,Robert Half,4,6,0,10,
2025-09-15,Jay Snowden,PENN Entertainment,19,18,3,40,
2025-09-15,George Kurian,NetApp,16,21,3,40,
2025-09-15,Kevin Ali,Organon,9,16,2,27,
2025-09-15,Joel D Anderson,Petco Health and Wellness,1,8,0,9,
2025-09-15,Louis V Pinkham,Regal Rexnord,0,1,0,1,
2025-09-15,Jay Geldmacher,Resideo Technologies,10,6,0,16,
2025-09-15,Marcus Lemonis,Camping World,9,22,9,40,
2025-09-15,Peter R Huntsman,Huntsman,5,12,3,20,
2025-09-15,Hillary Super,Victorias Secret,11,4,8,23,
2025-09-15,Michelle Gass,Levi Strauss,12,24,3,39,
2025-09-15,Neil Hunn,Roper Technologies,2,22,0,24,
2025-09-15,Steven P Lawrence,Academy Sports and Outdoors,1,1,0,2,
2025-09-15,Phillippe Lord,Meritage Homes,8,18,0,26,
2025-09-15,David C Dauch,American Axle & Manufacturing,6,8,2,16,
2025-09-15,Olumide Soroye,Fortive,1,7,1,9,
2025-09-15,Adena Friedman,Nasdaq,15,21,4,40,
2025-09-15,Tim Gokey,Broadridge Financial Solutions,4,13,1,18,
2025-09-15,Patrick M Shanahan,Spirit AeroSystems,1,9,0,10,
2025-09-15,Robert Kyncl,Warner Music Group,10,28,2,40,
2025-09-15,Denise Dignam,Chemours,3,18,3,24,
2025-09-15,Jim DeVries,ADT,9,7,1,17,
2025-09-15,Bernard Zovighian,Edwards Lifesciences,6,7,2,15,
2025-09-15,Mark E Seaton,First American Financial,1,9,0,10,
2025-09-15,John C Roche,Hanover Insurance Group,7,16,0,23,
2025-09-15,Adam J Greenlee,Silgan,0,6,0,6,
2025-09-15,Jayne Hrdlicka,Endeavor Group,0,1,0,1,
2025-09-15,Robert Fauber,Moodys Corporation,0,6,0,6,
2025-09-15,Thomas E Jorden,Coterra Energy,8,0,0,8,
2025-09-15,Eugene A Hall,Gartner,1,9,0,10,
2025-09-15,Kevin Plank,Under Armour,8,27,3,38,
2025-09-15,James W Lanning,Ingles Markets,3,3,0,6,
2025-09-15,Matthew T Farrell,Church & Dwight,7,7,0,14,
2025-09-15,Kevin M Freeman,Old Dominion Freight Line,0,0,0,0,
2025-09-15,Joe Shoen,U-Haul,14,21,4,39,
2025-09-15,Mark Bertolini,Oscar Health,14,17,8,39,
2025-09-15,Jayshree Ullal,Arista Networks,19,20,1,40,
2025-09-15,Sassine Ghazi,Synopsys,10,26,4,40,
2025-09-15,Jochen Zeitz,Harley-Davidson,6,24,10,40,
2025-09-15,Nick Jeffery,Frontier Communications,9,25,0,34,
2025-09-15,Thomas Edward McCormick,Primoris Services,0,6,0,6,
2025-09-15,D Christian Koch,Carlisle Companies,1,5,0,6,
2025-09-15,David E Simon,Simon Property Group,3,6,1,10,
2025-09-15,Stephen Bratspies,Hanesbrands,3,11,2,16,
2025-09-15,Ryan M. Schneider,Anywhere Real Estate Inc,0,1,0,1,
2025-09-15,George Bobb III,Teledyne Technologies,1,4,0,5,
2025-09-15,Terrence A Duffy,CME Group,6,9,1,16,
2025-09-15,Rami Rahim,Juniper Networks,11,26,3,40,
2025-09-15,Sue Nabi,Coty,14,17,9,40,
2025-09-15,Peter D Arvan,Pool Corporation,3,6,0,9,
2025-09-15,David Campbell,Evergy,15,8,0,23,
2025-09-15,Matthew J Murphy,Marvell Technology,2,7,1,10,
2025-09-15,Lloyd Yates,NiSource,5,5,0,10,
2025-09-15,William C Stone,SS&C Technologies,2,5,1,8,
2025-09-15,Mark Rourke,Schneider National,11,15,1,27,
2025-09-15,Andrew Anagnost,Autodesk,9,24,7,40,
2025-09-15,Dustin Semach,Sealed Air Corporation,0,8,0,8,
2025-09-15,William L Meaney,Iron Mountain,3,14,0,17,
2025-09-15,Andy P Power,Digital Realty Trust,0,0,0,0,
2025-09-15,Satish Dhanasekaran,Keysight Technologies,3,10,0,13,
2025-09-15,Frank M Svoboda,Globe Life,3,4,3,10,
2025-09-15,Carey A Smith,Parsons Corporation,0,2,0,2,
2025-09-15,Ynon Kreiz,Mattel,8,26,6,40,
2025-09-15,Karen S Haller,Southwest Gas,3,6,0,9,
2025-09-15,Terrance Williams,TruStage,5,5,1,11,
2025-09-15,Eric W Gerstenberg,Clean Harbors,6,1,1,8,
2025-09-15,Gunner Smith,Cornerstone Building Brands,1,8,1,10,
2025-09-15,Gerben W Bakker,Hubbell,1,5,0,6,
2025-09-15,Dave Davis,Spirit Airlines,4,35,1,40,
2025-09-15,Michael J Smith,Lamb Weston,0,7,3,10,
2025-09-15,Strauss Zelnick,Take-Two Interactive Software,15,15,10,40,
2025-09-15,John C Turner Jr,GMS,2,8,0,10,
2025-09-15,David M OMalley,Penn Mutual Life Insurance,0,1,0,1,
2025-09-15,Frank A Lonegro,Landstar System,2,4,0,6,
2025-09-15,James F Risoleo,Host Hotels & Resorts,4,15,0,19,
2025-09-15,Ken Xie,Fortinet,12,21,7,40,
2025-09-15,Doug Shulman,OneMain,4,6,0,10,
2025-09-15,Ryan Cohen,GameStop,10,22,7,39,
2025-09-15,Mark W Begor,Equifax,2,12,0,14,
2025-09-15,Jay L Schottenstein,American Eagle Outfitters,8,19,1,28,
2025-09-15,Curtis C Farmer,Comerica,4,8,0,12,
2025-09-15,Ole Rosgaard,Greif,2,15,1,18,
2025-09-15,Brian E Lane,Comfort Systems USA,9,1,0,10,
2025-09-15,Robert M Buck,TopBuild,6,4,0,10,
2025-09-15,Ralph Andretta,Bread Financial,3,8,0,11,
2025-09-15,Jim Anderson,Coherent,5,32,1,38,
2025-09-15,Walter C. D. Carlson,Telephone & Data Systems,0,2,0,2,
2025-09-15,Ronald Kruszewski,Stifel Financial,6,3,0,9,
2025-09-15,Richard Hayne,Urban Outfitters,11,20,8,39,
2025-09-15,Simon Meester,Terex,4,7,0,11,
2025-09-15,Edward J Lehner,Ryerson Holding,0,3,0,3,
2025-09-15,Nicholas T Pinchuk,Snap-on,3,7,0,10,
2025-09-15,Ryals McMullian,Flowers Foods,5,29,2,36,
2025-09-15,D Bryan Jordan,First Horizon,3,8,1,12,
2025-09-15,John B Gibson,Paychex,4,4,1,9,
2025-09-15,Chris Cocks,Hasbro,12,19,9,40,
2025-09-15,Pete McPartland,Sentry Insurance Group,0,2,0,2,
2025-09-15,Michael Arougheti,Ares Management,16,22,2,40,
2025-09-15,Alok Maskara,Lennox International,5,3,1,9,
2025-09-15,James C Grech,Peabody Energy,4,0,0,4,
2025-09-15,Joseph P Lacher Jr,Kemper,4,18,3,25,
2025-09-15,Perry A Sook,Nexstar Media Group,8,26,1,35,
2025-09-15,Wade Davis,TelevisaUnivision,12,27,1,40,
2025-09-15,Scott L Thompson,Tempur Sealy International,0,8,0,8,
2025-09-15,Mike Simonds,TriNet Group,0,9,0,9,
2025-09-15,B Andrew Rose,Worthington Enterprises,0,1,0,1,
2025-09-15,Bruce L Caswell,Maximus,2,4,0,6,
2025-09-15,Robert L Reffkin,Compass,1,6,0,7,
2025-09-15,Mark Eubanks,Brinks Company,1,2,1,4,
2025-09-15,Peter Quigley,Kelly Services inc,1,8,0,9,
2025-09-15,David L Yowan,Navient,1,0,0,1,
2025-09-15,Mary E Kipp,Puget Sound Energy,3,0,2,5,
2025-09-15,Adam Aron,AMC Entertainment,16,18,6,40,
2025-09-15,Mark J Tarr,Encompass Health,2,4,1,7,
2025-09-15,Liam K Griffin,Skyworks Solutions,1,6,1,8,
2025-09-15,Richard G Kyle,Timken,2,13,1,16,
2025-09-15,Ron Gusek,Liberty Energy,24,1,0,25,
2025-09-15,John E Geller Jr,Marriott Vacations Worldwide,6,6,0,12,
2025-09-15,Karl G. Glassman,Leggett & Platt,0,3,0,3,
2025-09-15,Bruce K Thorn,Big Lots,2,6,2,10,
2025-09-15,Jonathan H Weis,Weis Markets,12,27,0,39,
2025-09-15,Jeffrey B Guldner,Pinnacle West Capital,1,1,0,2,
2025-09-15,Arkadiy Dobkin,EPAM Systems,9,14,1,24,
2025-09-15,Paul M Rady,Antero Resources,3,8,0,11,
2025-09-15,Michael Spanos,Bloomin Brands,1,8,1,10,
2025-09-15,Nicole A Kivisto,MDU Resources Group,5,4,0,9,
2025-09-15,Gerald L Morgan,Texas Roadhouse,3,2,3,8,
2025-09-15,Gabriel Tirador,Mercury General,5,3,2,10,
2025-09-15,Nicholas I Fink,Fortune Brands Innovations,3,7,0,10,
2025-09-15,Paul E Burdiss,Zions Bancorp,1,1,0,2,
2025-09-15,William J Christensen,JELD-WEN Holding,3,5,0,8,
2025-09-15,Evan Spiegel,Snap Inc,20,16,4,40,
2025-09-15,Bill Burns,Zebra Technologies,7,21,1,29,
2025-09-15,Steven Sell,Agilon Health,0,8,0,8,
2025-09-15,Richard M Olson,Toro Company,1,10,0,11,
2025-09-15,Eric S Yuan,Zoom Video Communications,5,6,0,11,
2025-09-15,Dan L Batrack,Tetra Tech,2,5,1,8,
2025-09-15,Joseph D Russell Jr,Public Storage,0,7,0,7,
2025-09-15,Jacob Thaysen,Illumina inc,3,8,0,11,
2025-09-15,Debra A Cafaro,Ventas inc,7,6,0,13,
2025-09-15,Pierre R Brondeau,FMC Corporation,0,5,0,5,
2025-09-15,Judy R McReynolds,ArcBest,5,13,1,19,
2025-09-15,Russell J Weiner,Dominos Pizza inc,0,0,0,0,
2025-09-15,Theodore S Hanson,ASGN,0,0,0,0,
2025-09-15,RJ Scaringe,Rivian Automotive,11,25,4,40,
2025-09-15,Jeffrey N Simmons,Elanco Animal Health,2,6,1,9,
2025-09-15,Tim O Shaughnessy,Graham Holdings Company,2,8,0,10,
2025-09-15,Thomas V Taylor,Floor & Decor,1,2,2,5,
2025-09-15,Neil A Schrimsher,Applied Industrial Technologies,7,22,1,30,
2025-09-15,Robert E Price,PriceSmart,4,6,0,10,
2025-09-15,John David Risher,Lyft,4,3,1,8,
2025-09-15,Gary B Smith,Ciena,4,7,0,11,
2025-09-15,Joey Levin,IAC,7,32,1,40,
2025-09-15,Jim Jacobs,Country Financial,6,6,2,14,
2025-09-15,Devin B McGranahan,Western Union,1,7,0,8,
2025-09-15,R Scott Rowe,Flowserve,5,4,1,10,
2025-09-15,Kenneth A Vecchione,Western Alliance Bancorp,0,0,1,1,
2025-09-15,John C Rademacher,Option Care Health,7,1,0,8,
2025-09-15,Doug Black,SiteOne Landscape Supply,3,12,2,17,
2025-09-15,Oliver G Brewer III,Topgolf Callaway Brands,1,0,0,1,
2025-09-15,Glenn Sanford,eXp World,15,21,4,40,
2025-09-15,Fran Horowitz,Abercrombie & Fitch,13,19,8,40,
2025-09-15,Kevin Akers,Atmos Energy,6,4,0,10,
2025-09-15,Alessandro Maselli,Catalent,3,11,2,16,
2025-09-15,J Powell Brown,Brown & Brown,13,22,5,40,
2025-09-15,Aman Bhutani,GoDaddy,16,22,2,40,
2025-09-15,John C. Griffith,American Water Works,1,4,0,5,
2025-09-15,John J Marchioni,Selective Insurance Group,5,13,3,21,
2025-09-15,Lawson E Whiting,Brown-Forman,2,7,0,9,
2025-09-15,Dave Peacock,Advantage Solutions,23,7,0,30,
2025-09-15,Mick Farrell,ResMed,16,23,1,40,
2025-09-15,Kamal Hathi,Splunk,3,5,0,8,
2025-09-15,Todd Kelsey,Plexus,2,6,0,8,
2025-09-15,Phillip D Yeager,Hub Group,4,5,0,9,
2025-09-15,Steven B Hedlund,Lincoln Electric,4,9,0,13,
2025-09-15,Timothy C Oliver,NCR Atleos,0,1,0,1,
2025-09-15,Bruce Fleming,Calumet,3,6,0,9,
2025-09-15,Daniel S. Peyovich,Dycom Industries,0,4,0,4,
2025-09-15,Avner M Applbaum,Valmont Industries,0,8,0,8,
2025-09-15,Kimberly A Fields,ATI inc,3,10,0,13,
2025-09-15,Khozema Z Shipchandler,Twilio,0,2,1,3,
2025-09-15,Gary C Bhojwani,CNO Financial Group,1,6,1,8,
2025-09-15,William Andrew Hendricks Jr,Patterson-UTI Energy,0,0,0,0,
2025-09-15,Kevin D Hochman,Brinker International,1,2,0,3,
2025-09-15,James C Foster,Charles River Laboratories International,2,8,0,10,
2025-09-15,Rajiv K Prasad,Hyster-Yale,2,5,0,7,
2025-09-15,Eric T Steigerwalt,Brighthouse Financial,0,1,0,1,
2025-09-15,Thomas L Ryan,Service Corp International,3,7,0,10,
2025-09-15,Charles M Nifong Jr,CrossAmerica Partners,0,0,0,0,
2025-09-15,Anirudh Devgan,Cadence,9,27,3,39,
2025-09-15,Andi Owen,MillerKnoll,17,15,8,40,
2025-09-15,Sumit Roy,Realty Income,16,18,2,36,
2025-09-15,Timothy John Fitzgerald,Middleby,0,0,0,0,
2025-09-15,Robert H Schottenstein,M/I Homes,1,9,0,10,
2025-09-15,Stephen P MacMillan,Hologic,1,7,1,9,
2025-09-15,Lisa M Barton,Alliant Energy,2,0,0,2,
2025-09-15,Aaron P Jagdfeld,Generac,2,6,1,9,
2025-09-15,Erik Gershwind,MSC Industrial Direct,2,5,3,10,
2025-09-15,Varun Krishna,Rocket Companies,8,31,1,40,
2025-09-15,Fahmi Karam,Upbound Group,5,2,0,7,
2025-09-15,NADominic Ng,East West Bancorp,0,0,0,0,
2025-09-15,Mark Wang,Hilton Grand Vacations,38,2,0,40,
2025-09-15,Robert J Sheedy Jr,Grocery Outlet Holding,0,0,0,0,
2025-09-15,Simon D Campion,Dentsply Sirona,1,2,0,3,
2025-09-15,Jeremy Wensinger,V2X,7,6,0,13,
2025-09-15,Andrew Rees,Crocs,16,12,12,40,
2025-09-15,David M Maura,Spectrum Brands,6,0,0,6,
2025-09-15,Sachin S Lawande,Visteon,0,0,0,0,
2025-09-15,Neil M Ashe,Acuity Inc,0,2,0,2,
2025-09-15,Lorie L Tekorius,Greenbrier,2,8,0,10,
2025-09-15,John R Ciulla,Webster Financial,4,6,0,10,
2025-09-15,Sean D Keohane,Cabot Corporation,4,4,1,9,
2025-09-15,Drew M Wilkerson,RXO inc,0,0,0,0,
2025-09-15,Daniel E Brown,Chord Energy,1,0,0,1,
2025-09-15,Javier D Ferrer Fernandez,Popular inc,0,0,0,0,
2025-09-15,Olivier Rabiller,Garrett Motion inc,2,8,0,10,
2025-09-15,Ronald N Tutor,Tutor Perini Corporation,2,7,0,9,
2025-09-15,Jeff Liaw,Copart,4,6,0,10,
2025-09-15,Aman Narang,Toast inc,4,5,1,10,
2025-09-15,Joseph M Hogan,Align Technology,2,6,0,8,
2025-09-15,Kevin J Wheeler,A O Smith,0,16,1,17,
2025-09-15,Christopher A Cartwright,TransUnion,2,0,1,3,
2025-09-15,James Kelly,NCR Voyix,2,12,0,14,
2025-09-15,Tom Leighton,Akamai Technologies,16,14,5,35,
2025-09-15,Robert G Painter,Trimble,3,2,0,5,
2025-09-15,Tony Helton,Medical Mutual of Ohio,2,3,1,6,
2025-09-15,Caroline S Grace,AMN Healthcare Services,0,0,0,0,
2025-09-15,Patrick Kaltenbach,Mettler-Toledo International,1,9,0,10,
2025-09-15,Michael L Baur,ScanSource,0,2,0,2,
2025-09-15,Jason Lippert,LCI Industries,5,13,0,18,
2025-09-15,Fredric J Tomczyk,Cboe Global Markets,1,7,1,9,
2025-09-15,Octavio Marquez,Diebold Nixdorf,5,11,1,17,
2025-09-15,Sivasankaran Somasundaram,ChampionX,8,1,0,9,
2025-09-15,Ronald F Clarke,Corpay,0,0,0,0,
2025-09-15,Robert W Pittman,iHeartMedia,5,3,0,8,
2025-09-15,Patrick Zalupski,Dream Finders Homes,21,17,2,40,
2025-09-15,Keith E Smith,Boyd Gaming,0,5,0,5,
2025-09-15,Mehran Assadi,NLV Financial,1,1,0,2,
2025-09-15,Barry R Port,Ensign Group,2,5,2,9,
2025-09-15,Denise A Paulonis,Sally Beauty,0,2,0,2,
2025-09-15,Clifford A Skelton,Conduent,0,2,1,3,
2025-09-15,Jean-Michel Ribieras,Sylvamo,2,6,0,8,
2025-09-15,Douglas F Bauer,Tri Pointe Homes,0,7,0,7,
2025-09-15,Shawn OConnell,EnerSys,0,1,0,1,
2025-09-15,Bill Meury,Incyte,7,14,0,21,
2025-09-15,Dale Francescon,Century Communities,1,10,3,14,
2025-09-15,Michael Nierenberg,Rithm Capital,11,27,2,40,
2025-09-15,Michael J Brown,Euronet Worldwide,2,7,0,9,
2025-09-15,Scott Seu,Hawaiian Electric Industries,5,16,1,22,
2025-09-15,Jason D Robins,DraftKings,5,2,0,7,
2025-09-15,Jonathan J Mazelsky,IDEXX Laboratories,1,1,1,3,
2025-09-15,Richard S Swartz,MYR Group,0,0,0,0,
2025-09-15,Stefano Caroti,Deckers Outdoor,2,6,1,9,
2025-09-15,Kevin R Sayer,DexCom,1,3,0,4,
2025-09-15,John T C Lee,MKS Instruments,3,7,0,10,
2025-09-15,Edward B Pitoniak,VICI Properties,1,7,0,8,
2025-09-15,Albert White III,Cooper Cos,0,0,0,0,
2025-09-15,Barry L Biffle,Frontier Airlines,1,5,6,12,
2025-09-15,Robert A Bruggeworth,Qorvo,5,4,0,9,
2025-09-15,Winnie Park,Five Below,9,27,4,40,
2025-09-15,Steven Oakland,TreeHouse Foods,2,13,0,15,
2025-09-15,James S Hagedorn,Scotts Miracle-Gro,1,0,0,1,
2025-09-15,Michael Cannon-Brookes,Atlassian,16,23,0,39,
2025-09-15,Bertrand Loy,Entegris,2,10,1,13,
2025-09-15,William E Waltz,Atkore,3,6,0,9,
2025-09-15,Celeste B Mastin,H B Fuller,0,2,0,2,
2025-09-15,Kyle T Larkin,Granite Construction,1,4,0,5,
2025-09-15,Michael J Happe,Winnebago Industries,1,3,1,5,
2025-09-15,Steven H Gunby,FTI Consulting,5,11,0,16,
2025-09-15,Stephan B Tanda,AptarGroup,1,4,2,7,
2025-09-15,Timothy P Boyle,Columbia Sportswear,5,2,2,9,
2025-09-15,Anthony J Wood,Roku,5,3,1,9,
2025-09-15,M Christopher Doyle,Civitas Resources,1,2,0,3,
2025-09-15,Andy Eidson,Alpha Metallurgical Resources,1,5,2,8,
2025-09-15,Andy L Nemeth,Patrick Industries,4,2,0,6,
2025-09-15,Roger W Jenkins,Murphy Oil,5,13,0,18,
2025-09-15,Kevin S Blair,Synovus Financial,7,3,0,10,
2025-09-15,Julie Felss Masino,Cracker Barrel Old Country Store,10,18,12,40,
2025-09-15,David M Overton,Cheesecake Factory,1,9,0,10,
2025-09-15,Nick DeIuliis,CNX Resources,7,2,1,10,
2025-09-15,Christopher Pappas,Chefs Warehouse,4,10,1,15,
2025-09-15,Tod Carpenter,Donaldson Company,2,8,0,10,
2025-09-15,Gregory L Christopher,Mueller Industries,2,6,0,8,
2025-09-15,Rob Saltiel,MRC Global,3,12,1,16,
2025-09-15,Jillian C Evanko,Chart Industries,4,6,0,10,
2025-09-15,Dave Guilmette,Alight Solutions,3,6,0,9,
2025-09-15,Joel Smejkal,Vishay Intertechnology,5,5,0,10,
2025-09-15,Dennis Degner,Range Resources,4,8,0,12,
2025-09-15,Ira D Robbins,Valley National Bancorp,0,2,0,2,
2025-09-15,Bernard Kim,Match Group,14,19,7,40,
2025-09-15,Vincent Pilette,Gen Digital,3,9,0,12,
2025-09-15,Timothy S Crane,Wintrust Financial,2,7,1,10,
2025-09-15,Pat Roche,Moog inc,3,10,2,15,
2025-09-15,Mark R Widmar,First Solar,3,3,3,9,
2025-09-15,Niko Lahanas,Central Garden & Pet,2,11,0,13,
2025-09-15,Chris Osowski,Green Plains inc,5,7,2,14,
2025-09-15,Derek J Leathers,Werner Enterprises,1,9,0,10,
2025-09-15,Adam Foroughi,AppLovin,10,26,4,40,
2025-09-15,Luca Savi,ITT,2,8,0,10,
2025-09-15,Lawrence H Silber,Herc Rentals,0,0,0,0,
2025-09-15,Hilton H Howell Jr,Gray Television,7,19,1,27,
2025-09-15,Eric D Ashleman,IDEX,0,9,1,10,
2025-09-15,Owen D Thomas,Boston Properties,2,8,0,10,
2025-09-15,Kurt Wolf,Pitney Bowes,5,18,1,24,
2025-09-15,Sara E Armbruster,Steelcase,1,0,0,1,
2025-09-15,Charles D. Young,Sun Communities,3,5,0,8,
2025-09-15,Suzanne Foster,AdaptHealth,4,9,1,14,
2025-09-15,Grant E Sims,Genesis Energy,3,2,0,5,
2025-09-15,Laura Prieskorn,Jackson Financial,2,5,2,9,
2025-09-15,Rick L Wessel,FirstCash,5,4,1,10,
2025-09-15,Sherman Miller,Cal-Maine Foods,11,29,0,40,
2025-09-15,Paul A Lang,Arch Resources,4,5,0,9,
2025-09-15,Ashish K Khandpur,Avient,2,6,0,8,
2025-09-15,Shyam K Reddy,BlueLinx,2,7,0,9,
2025-09-15,Christopher S Ripley,Sinclair,1,8,0,9,
2025-09-15,Stacy Kymes,BOK Financial,10,5,0,15,
2025-09-15,James H Walter,Permian Resources,0,0,0,0,
2025-09-15,Jason Murray,PACS Group,5,13,2,20,
2025-09-15,Brian Armstrong,Coinbase Global,13,22,5,40,
2025-09-15,Oscar K Brown,Western Midstream Partners,1,3,0,4,
2025-09-15,Nicholas R Lower,Federated Mutual Insurance,0,0,0,0,
2025-09-15,Morris Goldfarb,G-III Apparel Group,7,28,5,40,
2025-09-15,Mark D Morelli,Vontier,0,3,0,3,
2025-09-15,Matthew J Cox,Matson inc,2,4,0,6,
2025-09-15,David W Grzebinski,Kirby Corporation,1,3,0,4,
2025-09-15,Keith A Harvey,Kaiser Aluminum,5,4,1,10,
2025-09-15,Eric Nyman,Vista Outdoor,3,9,1,13,
2025-09-15,Doug Howe,Designer Brands,5,19,0,24,
2025-09-15,Jerry E Gahlhoff Jr,Rollins inc,0,2,0,2,
2025-09-15,D Scott Barbour,Advanced Drainage Systems,3,3,0,6,
2025-09-15,Sean Gamble,Cinemark,16,22,2,40,
2025-09-15,George Kurtz,CrowdStrike,13,24,3,40,
2025-09-15,Bill Ready,Pinterest,26,13,1,40,
2025-09-15,Fidji Simo,Instacart,9,30,1,40,
2025-09-15,Kimberly K Ryan,Hillenbrand,2,6,0,8,
2025-09-15,David S Graziosi,Allison Transmission,1,20,1,22,
2025-09-15,Gary G Friedman,Restoration Hardware,1,4,0,5,
2025-09-15,Lucinda M Baier,Brookdale Senior Living,4,3,1,8,
2025-09-15,Brian J Blaser,QuidelOrtho,1,9,0,10,
2025-09-15,E Jean Savage,Trinity Industries,1,8,1,10,
2025-09-15,Liam J Kelly,Teleflex,1,3,1,5,
2025-09-15,Laurans A Mendelson,HEICO,6,16,0,22,
2025-09-15,Frank H Laukien,Bruker,2,6,1,9,
2025-09-15,Harvey M Schwartz,Carlyle Group,6,13,0,19,
2025-09-15,Mark S LaVigne,Energizer,1,1,0,2,
2025-09-15,Joel Quadracci,Quad/Graphics,10,25,5,40,
2025-09-15,Amar Maletira,Rackspace Technology,5,10,2,17,
2025-09-15,Udit Batra,Waters Corporation,10,20,0,30,
2025-09-15,Eric M Green,West Pharmaceutical Services,2,8,0,10,
2025-09-15,Doug Palladini,Carters inc,2,2,2,6,
2025-09-15,G Mike Mikan,NeueHealth,4,1,0,5,
2025-09-15,Russell ChipChilds,SkyWest,0,0,0,0,
2025-09-15,Christopher H Hunter,Acadia Healthcare,0,1,0,1,
2025-09-15,Prahlad Singh,Revvity,3,7,0,10,
2025-09-15,Maria M Pope,Portland General Electric,2,6,0,8,
2025-09-15,Charles Chip Blankenship,Woodward inc,0,2,0,2,
2025-09-15,Mike Steib,TEGNA,15,13,1,29,
2025-09-15,Kurt J Ekert,Sabre Corporation,0,1,0,1,
2025-09-15,Matt Wilson,Light & Wonder,19,18,3,40,
2025-09-15,Rob Katz,Vail Resorts,3,11,26,40,
2025-09-15,Schnitzer Steel Industries,Radius Recycling,6,26,6,38,
2025-09-15,David A Spector,PennyMac Financial Services,6,1,0,7,
2025-09-15,Frederick J Holzgrefe III,Saia inc,0,1,0,1,
2025-09-15,Mark J Parrell,Equity Residential,4,6,1,11,
2025-09-15,John W Lindsay,Helmerich & Payne,0,6,0,6,
2025-09-15,Gary D Burnison,Korn Ferry,4,12,0,16,
2025-09-15,Timothy J McGrath,PC Connection Inc,1,2,0,3,
2025-09-15,Lynn M Bamford,Curtiss-Wright,9,10,0,19,
2025-09-15,Jonathan W Witter,Sallie Mae,0,1,0,1,
2025-09-15,Jeff Benck,Benchmark Electronics,4,8,0,12,
2025-09-15,Charles H Giancarlo,Pure Storage,0,4,0,4,
2025-09-15,Brian R Gray,Knife River Corporation,0,1,0,1,
2025-09-15,Jay Schmidt,Caleres inc,3,5,2,10,
2025-09-15,Dale Asplund,BrightView Holdings,1,7,0,8,
2025-09-15,Jeffrey S Edwards,Cooper-Standard,0,7,0,7,
2025-09-15,Glenn J Williams,Primerica,4,3,2,9,
2025-09-15,Francois Locoh-Donou,F5,6,24,2,32,
2025-09-15,Joseph Wm Foran,Matador Resources,7,9,0,16,
2025-09-15,Sridhar Ramaswamy,Snowflake inc,12,19,3,34,
2025-09-15,Mark D Dankberg,Viasat,1,6,3,10,
2025-09-15,Francisco J Leon,California Resources,1,2,1,4,
2025-09-15,Peter Stern,Peloton,18,18,4,40,
2025-09-15,David Baszucki,Roblox,7,23,10,40,
2025-09-15,Jeffrey W Edwards,Installed Building Products,0,0,0,0,
2025-09-15,Clark Lauritzen,First National of Nebraska,1,7,0,8,
2025-09-15,Carlos Alberini,Guess inc,13,26,1,40,
2025-09-15,Shyam P Kambeyanda,ESAB,3,5,0,8,
2025-09-15,Edmund Shallcross III,Amica Mutual Insurance,0,4,0,4,
2025-09-15,Benjamin W Schall,AvalonBay Communities,1,6,1,8,
2025-09-15,Allan C Thygesen,DocuSign,4,4,0,8,
2025-09-15,Bryan J Knutson,Titan Machinery,1,1,0,2,
2025-09-15,Heath Sampson,ModivCare,6,3,1,10,
2025-09-15,Ara K Hovnanian,Hovnanian Enterprises,1,16,2,19,
2025-09-15,Joshua G Silverman,Etsy,1,2,0,3,
2025-09-15,Kevin Roycraft,Adams Resources & Energy,5,4,1,10,
2025-09-15,J Eric Evans,Surgery Partners,0,5,0,5,
2025-09-15,Clint E Stein,Columbia Banking System,1,4,0,5,
2025-09-15,Lee M Shavel,Verisk Analytics,2,7,0,9,
2025-09-15,Dave Banyard Jr,MasterBrand,0,0,0,0,
2025-09-15,Peter R Ingram,Hawaiian Airlines inc,1,0,0,1,
2025-09-15,Kristin A Dolan,AMC Networks,3,2,0,5,
2025-09-15,Brendan T Cavanagh,SBA Communications,1,3,0,4,
2025-09-15,George F Chappelle Jr,Americold Realty Trust,2,3,0,5,
2025-09-15,Thomas E Gottwald,NewMarket Corporation,1,8,0,9,
2025-09-15,Thomas J Baltimore Jr,Park Hotels & Resorts,4,29,1,34,
2025-09-15,Peter M Moglia,Alexandria Real Estate Equities,3,4,0,7,
2025-09-15,Ronald J Kramer,Griffon Corporation,1,7,1,9,
2025-09-15,John L Plueger,Air Lease,2,13,0,15,
2025-09-15,Jennifer F Scanlon,UL Solutions,1,3,0,4,
2025-09-15,Greg Smith,Teradyne,1,7,2,10,
2025-09-15,Sean Trauschke,OGE Energy,18,4,0,22,
2025-09-15,Norman D Schwartz,Bio-Rad Laboratories,0,0,1,1,
2025-09-15,Scott Doyle,Spire inc,3,6,1,10,
2025-09-15,Michael E Reed,Gannett,0,4,1,5,
2025-09-15,Cindy J Miller,Stericycle,2,4,2,8,
2025-09-15,Phillip D Green,Cullen Frost Bankers,1,3,2,6,
2025-09-15,Joseph D Margolis,Extra Space Storage,2,7,1,10,
2025-09-15,Mark A Skonieczny,REV Group,1,2,0,3,
2025-09-15,Ladd Wilks,ProFrac Holding,4,1,0,5,
2025-09-15,Sundaram Nagarajan,Nordson,0,9,1,10,
2025-09-15,Anne P Noonan,Summit Materials,0,1,0,1,
2025-09-15,Lori Flees,Valvoline inc,4,4,1,9,
2025-09-15,Scott H Baxter,Kontoor Brands,2,2,0,4,
2025-09-15,Tim Larson,Skyline Champion,6,0,0,6,
2025-09-15,Chuck Divita,Teladoc Health,11,16,5,32,
2025-09-15,W Bradley Southern,Louisiana-Pacific Corporation,0,0,0,0,
2025-09-15,George C Freeman III,Universal Corporation,2,7,0,9,
2025-09-15,James A Brock,Consol Energy,1,0,0,1,
2025-09-15,Robert Antokol,Playtika Holding,0,6,1,7,
2025-09-15,Joe Craft,Alliance Resource Partners,6,10,2,18,
2025-09-15,Paul Keel,Envista,2,6,1,9,
2025-09-15,Jared Isaacman,Shift4 Payments,6,28,6,40,
2025-09-15,Mark Mac McFarland,Talen Energy,4,1,1,6,
2025-09-15,Tony R Thene,Carpenter Technology,1,9,0,10,
2025-09-15,Melissa D Smith,WEX,1,7,1,9,
2025-09-15,James Jim C Ryan III,Old National Bancorp,1,0,0,1,
2025-09-15,Peter J Federico,AGNC Investment,1,0,0,1,
2025-09-15,Brent L Yeagy,Wabash National,0,1,0,1,
2025-09-15,Henry A Fernandez,MSCI,2,15,0,17,
2025-09-15,Mark Penn,Stagwell,10,23,6,39,
2025-09-15,Julie Schertell,Mativ,2,8,0,10,
2025-09-15,Ashish Chand,Belden,2,6,1,9,
2025-09-15,Greg Anderson,Allegiant Travel Company,5,7,0,12,
2025-09-15,Drew Houston,Dropbox,14,18,8,40,
2025-09-15,Kevin T Conroy,Exact Sciences,2,5,2,9,
2025-09-15,Rex D Geveden,BWX Technologies,4,5,0,9,
2025-09-15,Scott R Wells,Clear Channel Outdoor Hldgs,0,0,0,0,
2025-09-15,Paul Bay,Ingram Micro,11,24,5,40,
2025-09-16,Doug McMillon,Walmart,17,17,6,40,
2025-09-16,Andrew Jassy,Amazon,4,30,6,40,
2025-09-16,Tim Cook,Apple,19,20,1,40,
2025-09-16,Stephen Hemsley,UnitedHealth,7,29,4,40,
2025-09-16,Warren Buffett,Berkshire Hathaway,12,14,13,39,
2025-09-16,David Joyner,CVS Health,5,30,5,40,
2025-09-16,Darren Woods,Exxon Mobil,11,21,7,39,
2025-09-16,Sundar Pichai,Alphabet,17,19,4,40,
2025-09-16,Brian Tyler,McKesson,6,14,6,26,
2025-09-16,Robert Mauch,Cencora,3,7,0,10,
2025-09-16,Ron Vachris,Costco,6,31,3,40,
2025-09-16,Jamie Dimon,JPMorgan Chase,10,18,12,40,
2025-09-16,Satya Nadella,Microsoft,14,19,7,40,
2025-09-16,Jason Hollar,Cardinal Health,14,22,4,40,
2025-09-16,Mike Wirth,Chevron,16,15,9,40,
2025-09-16,David Cordani,Cigna,21,16,3,40,
2025-09-16,Jim Farley,Ford Motor,10,22,8,40,
2025-09-16,Brian Moynihan,Bank of America,9,29,2,40,
2025-09-16,Mary Barra,General Motors,12,24,4,40,
2025-09-16,Gail Boudreaux,Elevance Health,16,15,9,40,
2025-09-16,Jane Fraser,Citigroup,10,25,5,40,
2025-09-16,Sarah London,Centene,13,17,9,39,
2025-09-16,Ted Decker,Home Depot,11,24,5,40,
2025-09-16,Maryann Mannen,Marathon Petroleum,6,15,1,22,
2025-09-16,Ron Sargent,Kroger,5,22,13,40,
2025-09-16,Mark Lashier,Phillips 66,10,20,8,38,
2025-09-16,Priscilla Almodovar,Fannie Mae,10,17,13,40,
2025-09-16,Tim Wentworth,Walgreens,6,25,9,40,
2025-09-16,Lane Riggs,Valero Energy,13,7,0,20,
2025-09-16,Mark Zuckerberg,Meta,10,19,10,39,
2025-09-16,Hans Vestberg,Verizon,16,20,4,40,
2025-09-16,John Stankey,AT&T,8,26,6,40,
2025-09-16,Brian Roberts,Comcast,12,23,5,40,
2025-09-16,Charles Scharf,Wells Fargo,28,6,6,40,
2025-09-16,David Solomon,Goldman Sachs,10,19,11,40,
2025-09-16,Michael Hutchins,Freddie Mac,2,11,3,16,
2025-09-16,Michael Fiddelke,Target,8,22,10,40,
2025-09-16,Jim Rechtin,Humana,21,15,4,40,
2025-09-16,Jon Farney,State Farm Insurance,1,14,3,18,
2025-09-16,Elon Musk,Tesla,20,14,5,39,
2025-09-16,Ted Pick,Morgan Stanley,16,21,3,40,
2025-09-16,Joaquin Duato,Johnson & Johnson,11,24,5,40,
2025-09-16,Juan Luciano,Archer Daniels Midland,4,20,11,35,
2025-09-16,Ramon Laguarta,PepsiCo,7,28,5,40,
2025-09-16,Carol Tom√©,UPS,7,23,10,40,
2025-09-16,Rajesh Subramaniam,FedEx,10,29,0,39,
2025-09-16,Bob Iger,Walt Disney,10,28,2,40,
2025-09-16,Michael Dell,Dell Technologies,10,26,4,40,
2025-09-16,Marvin Ellison,Lowes,13,24,2,39,
2025-09-16,Jon Moeller,Procter & Gamble,4,31,5,40,
2025-09-16,Thomas Long,Energy Transfer,9,0,1,10,
2025-09-16,Kelly Ortberg,Boeing,8,26,5,39,
2025-09-16,Susan Morris,Albertsons,15,21,4,40,
2025-09-16,Kevin Hourican,Sysco,9,27,4,40,
2025-09-16,Christopher Calio,RTX,5,11,0,16,
2025-09-16,Larry Culp,General Electric,10,27,3,40,
2025-09-16,James Taiclet,Lockheed Martin,14,20,6,40,
2025-09-16,Stephen Squeri,American Express,15,24,1,40,
2025-09-16,Joe Creed,Caterpillar,9,28,3,40,
2025-09-16,Michel Khalaf,MetLife,9,17,0,26,
2025-09-16,Samuel Hazen,HCA Healthcare,9,5,0,14,
2025-09-16,Tricia Griffith,Progressive Insurance,9,25,5,39,
2025-09-16,Arvind Krishna,IBM,14,20,6,40,
2025-09-16,John May,Deere,8,26,6,40,
2025-09-16,Jensen Huang,Nvidia,13,17,9,39,
2025-09-16,Philip Smith,StoneX,0,9,0,9,
2025-09-16,Robert M Davis,Merck,4,18,0,22,
2025-09-16,Ryan Lance,ConocoPhillips,14,21,5,40,
2025-09-16,Albert Bourla,Pfizer,19,13,8,40,
2025-09-16,Ed Bastian,Delta Air Lines,11,16,13,40,
2025-09-16,Patrick Zammit,TD Synnex,8,13,0,21,
2025-09-16,Kevin Murphy,Publix Super Markets,10,20,1,31,
2025-09-16,Thomas J Wilson,Allstate,1,7,1,9,
2025-09-16,Chuck Robbins,Cisco Systems,12,24,4,40,
2025-09-16,Kirt Walker,Nationwide Insurance,5,5,0,10,
2025-09-16,Christopher Winfrey,Charter Communications,5,13,5,23,
2025-09-16,Bob Michael,AbbVie,0,0,0,0,
2025-09-16,Craig DeSanto,New York Life Insurance,2,21,0,23,
2025-09-16,Lip-Bu Tan,Intel,7,17,16,40,
2025-09-16,Ernie Herrman,TJX,16,23,1,40,
2025-09-16,Andrew Sullivan,Prudential Financial,13,19,0,32,
2025-09-16,Enrique Lores,Hewlett Packard,10,15,6,31,
2025-09-16,Scott Kirby,United Airlines,27,7,6,40,
2025-09-16,George Holm,Performance Food,7,21,2,30,
2025-09-16,Donnie King,Tyson Foods,8,25,7,40,
2025-09-16,Robert Isom,American Airlines,7,24,9,40,
2025-09-16,Timothy M Sweeney,Liberty Mutual Insurance,11,0,0,11,
2025-09-16,Elliott Hill,Nike,12,24,4,40,
2025-09-16,Safra Catz,Oracle,20,14,6,40,
2025-09-16,AJ Jim Teague,Enterprise Products Partners,4,11,0,15,
2025-09-16,Richard Fairbank,Capital One,17,21,2,40,
2025-09-16,Willie Chiang,Plains GP,3,5,1,9,
2025-09-16,Michael Kasbar,World Kinect,2,8,0,10,
2025-09-16,Peter Zaffino,American International Group,8,27,5,40,
2025-09-16,James Quincey,The Coca-Cola Company,10,28,2,40,
2025-09-16,Thasunda Brown Duckett,TIAA,20,20,0,40,
2025-09-16,Jay Debertin,CHS,4,11,3,18,
2025-09-16,Chris Boerner,Bristol-Myers Squibb,10,25,5,40,
2025-09-16,Corie Barry,Best Buy,39,1,0,40,
2025-09-16,Marc Casper,Thermo Fisher Scientific,15,22,3,40,
2025-09-16,Roger Crandall,Mass Mutual,2,8,0,10,
2025-09-16,Juan Andrade,USAA,5,18,0,23,
2025-09-16,Phebe Novakovic,General Dynamics,28,8,4,40,
2025-09-16,Alan Schnitzer,Travelers Insurance,3,4,2,9,
2025-09-16,David Zaslav,Warner Bros Discovery,3,31,6,40,
2025-09-16,Gunjan Kedia,US Bancorp,16,22,2,40,
2025-09-16,Robert Ford,Abbott Laboratories,12,21,7,40,
2025-09-16,Kathy Warden,Northrop Grumman,14,21,5,40,
2025-09-16,Tim Gerend,Northwestern Mutual,11,28,1,40,
2025-09-16,Todd Vasos,Dollar General,7,24,9,40,
2025-09-16,Matthew Lucey,PBF Energy,6,2,0,8,
2025-09-16,Dara Khosrowshahi,Uber,13,21,6,40,
2025-09-16,Vimal Kapur,Honeywell,11,29,0,40,
2025-09-16,Dirk Van de Put,Mondelez,10,27,3,40,
2025-09-16,Brian Niccol,Starbucks,9,27,4,40,
2025-09-16,Cristiano Amon,Qualcomm,10,28,2,40,
2025-09-16,Hock Tan,Broadcom,11,28,1,40,
2025-09-16,David Flitman,US Foods,3,7,0,10,
2025-09-16,Paul Romanowski,DR Horton,5,13,5,23,
2025-09-16,Jacek Olczak,Philip Morris,14,22,4,40,
2025-09-16,Preston Feight,Paccar,9,26,1,36,
2025-09-16,Marc Benioff,Salesforce,8,19,12,39,
2025-09-16,Leon Topalian,Nucor,13,24,3,40,
2025-09-16,Michael Dastoor,Jabil,2,5,0,7,
2025-09-16,Jonathan Jaffe,Lennar,2,7,1,10,
2025-09-16,David Ricks,Eli Lilly,10,20,10,40,
2025-09-16,Joe Zubretsky,Molina Healthcare,11,3,4,18,
2025-09-16,Jennifer Rumsey,Cummins,7,28,5,40,
2025-09-16,Robin Vince,Bank of New York Mellon,20,19,1,40,
2025-09-16,Ted Sarandos,Netflix,12,26,2,40,
2025-09-16,William H Rogers Jr,Truist Financial,3,7,0,10,
2025-09-16,Sean Kerins,Arrow Electronics,1,10,0,11,
2025-09-16,William M Brown,3M,2,8,0,10,
2025-09-16,Ryan McInerney,Visa,13,23,4,40,
2025-09-16,Marc Rowan,Apollo Global Management,13,22,5,40,
2025-09-16,Tim Go,HF Sinclair,6,2,0,8,
2025-09-16,Robert Sulentic,CBRE Group,1,8,1,10,
2025-09-16,William Demchak,PNC Financial Services,14,21,5,40,
2025-09-16,Bryan DeBoer,Lithia Motors,11,28,1,40,
2025-09-16,William Nash,CarMax,3,5,2,10,
2025-09-16,Brian Robbins,Paramount Global,9,31,0,40,
2025-09-16,Michael Creedon,Dollar Tree,6,32,2,40,
2025-09-16,Sandy Douglas,United Natural Foods,33,5,2,40,
2025-09-16,Alex Chriss,PayPal,14,22,4,40,
2025-09-16,Roger Penske,Penske Automotive,17,22,1,40,
2025-09-16,Antonio Neri,Hewlett Packard Enterprise,9,24,7,40,
2025-09-16,Harry Sideris,Duke Energy,36,4,0,40,
2025-09-16,Vicki Hollub,Occidental Petroleum,21,16,3,40,
2025-09-16,Lawrence Coben,NRG Energy,6,3,0,9,
2025-09-16,Robert Bradway,Amgen,10,28,2,40,
2025-09-16,John Ketchum,NextEra Energy,24,15,1,40,
2025-09-16,Rainer Blair,Danaher,7,15,2,24,
2025-09-16,Daniel ODay,Gilead Sciences,2,8,0,10,
2025-09-16,Michael Manley,AutoNation,3,6,1,10,
2025-09-16,Carlos Abrams-Rivera,Kraft Heinz,9,24,7,40,
2025-09-16,Philip Gallagher,Avnet,1,5,0,6,
2025-09-16,Gary Dickerson,Applied Materials,6,19,15,40,
2025-09-16,Bob Jordan,Southwest Airlines,8,25,7,40,
2025-09-16,Rick Wurster,Charles Schwab,13,21,5,39,
2025-09-16,Lorenzo Simonelli,Baker Hughes,17,21,2,40,
2025-09-16,Chris Kempczinski,McDonalds,10,22,8,40,
2025-09-16,Christopher Womack,Southern Company,3,6,0,9,
2025-09-16,Michael Miebach,Mastercard,11,26,3,40,
2025-09-16,Joseph Dominguez,Constellation Energy,14,9,1,24,
2025-09-16,Christopher Swift,The Hartford,15,21,4,40,
2025-09-16,Patricia Poppe,PG&E,7,14,2,23,
2025-09-16,Bom Kim,Coupang,8,30,2,40,
2025-09-16,Ezra Yacob,EOG Resources,24,14,2,40,
2025-09-16,Jim Vena,Union Pacific,19,20,1,40,
2025-09-16,Matt Schroeder,Rite Aid,3,34,3,40,
2025-09-16,Tony Spring,Macys,8,24,5,37,
2025-09-16,Anthony Capuano,Marriott International,11,27,2,40,
2025-09-16,Raymond E Scott,Lear Corporation,2,8,0,10,
2025-09-16,William Stengel II,Genuine Parts,0,4,0,4,
2025-09-16,Heidi Petz,Sherwin-Williams,8,28,2,38,
2025-09-16,Jeff Miller,Halliburton,9,25,6,40,
2025-09-16,Kathleen Quirk,Freeport-McMoRan,13,16,2,31,
2025-09-16,Michael Rapino,Live Nation Entertainment,14,23,3,40,
2025-09-16,John Doyle,Marsh & McLennan,9,6,1,16,
2025-09-16,Lisa Su,Advanced Micro Devices,15,19,6,40,
2025-09-16,Frank Holding,First Citizens BancShares,9,16,2,27,
2025-09-16,John Engel,WESCO International,4,15,1,20,
2025-09-16,David Gitlin,Carrier Global,14,24,2,40,
2025-09-16,Lourenco Goncalves,Cleveland-Cliffs,6,23,11,40,
2025-09-16,Calvin G Butler Jr,Exelon,6,4,0,10,
2025-09-16,Joseph Bae,KKR & Co,8,7,1,16,
2025-09-16,Christine Leahy,CDW,1,9,2,12,
2025-09-16,Glenn Fogel,Booking Holdings,11,23,6,40,
2025-09-16,Brian Doubles,Synchrony Financial,4,7,2,13,
2025-09-16,Earl Austin,Quanta Services,2,5,1,8,
2025-09-16,Christian Ulbrich,Jones Lang LaSalle,7,16,0,23,
2025-09-16,Saumya Sutaria,Tenet Healthcare,7,2,1,10,
2025-09-16,William Gifford,Altria Group,2,7,1,10,
2025-09-16,Kevin Lobo,Stryker,13,24,3,40,
2025-09-16,Michael Hsu,Kimberly-Clark,5,6,1,12,
2025-09-16,Jack Fusco,Cheniere Energy,19,18,3,40,
2025-09-16,James Conroy,Ross Stores,4,15,0,19,
2025-09-16,Anthony Smurfit,Smurfit Westrock,3,5,0,8,
2025-09-16,Jeffrey Harmening,General Mills,3,17,5,25,
2025-09-16,Mark Stewart,Goodyear Tire & Rubber,4,35,1,40,
2025-09-16,Bob Eddy,BJs Wholesale Club,6,20,3,29,
2025-09-16,Peter Arduini,GE HealthCare Technologies,3,8,0,11,
2025-09-16,Noel Wallace,Colgate-Palmolive,10,20,2,32,
2025-09-16,Marc Bitzer,Whirlpool,12,14,14,40,
2025-09-16,Chris Kubasik,L3Harris Technologies,7,13,1,21,
2025-09-16,Shantanu Narayen,Adobe,18,20,1,39,
2025-09-16,Thomas Polen,Becton Dickinson,6,4,0,10,
2025-09-16,Richard P Dealy,Pioneer Natural Resources,6,3,0,9,
2025-09-16,Ravi Kumar S,Cognizant Technology Solutions,11,18,3,32,
2025-09-16,Andrew Clyde,Murphy USA,14,25,1,40,
2025-09-16,Mike Lyons,Fiserv,4,11,0,15,
2025-09-16,Jennifer Parmentier,Parker-Hannifin,3,14,0,17,
2025-09-16,William Fehrman,American Electric Power,3,7,0,10,
2025-09-16,Andrew Silvernail,International Paper,6,23,0,29,
2025-09-16,Jonas Prising,ManpowerGroup,7,23,2,32,
2025-09-16,John Zillmer,Aramark,7,13,2,22,
2025-09-16,Mark Millett,Steel Dynamics,16,2,0,18,
2025-09-16,Dan Amos,Aflac,14,16,10,40,
2025-09-16,Tony Cheng,Reinsurance Group of America,2,10,2,14,
2025-09-16,Karsanbhai,Emerson Electric,8,14,3,25,
2025-09-16,Ronald P OHanley,State Street,0,4,0,4,
2025-09-16,Timothy Knavish,PPG Industries,0,1,0,1,
2025-09-16,David Burritt,United States Steel,9,20,10,39,
2025-09-16,Maria Black,Automatic Data Processing,4,5,0,9,
2025-09-16,Daryl Kenningham,Group 1 Automotive,13,24,3,40,
2025-09-16,Robert Blue,Dominion Energy,26,13,1,40,
2025-09-16,Larry Fink,BlackRock,10,23,7,40,
2025-09-16,Pierce Norton II,Oneok,5,3,1,9,
2025-09-16,David Bozeman,CH Robinson Worldwide,2,8,0,10,
2025-09-16,Haviv Ilan,Texas Instruments,11,27,2,40,
2025-09-16,Michael Bender,Kohls,2,24,14,40,
2025-09-16,Philip Daniele III,AutoZone,0,2,0,2,
2025-09-16,Timothy Archer,Lam Research,2,7,0,9,
2025-09-16,Charles Magro,Corteva,5,3,1,9,
2025-09-16,Rick Lanoha,Peter Kiewit Sons,0,2,0,2,
2025-09-16,Peter Jackson,Builders FirstSource,5,11,1,17,
2025-09-16,Martin Schroeter,Kyndryl,9,31,0,40,
2025-09-16,Hamid Akhavan,EchoStar,6,25,9,40,
2025-09-16,Bill Westrate,American Family Insurance,10,16,2,28,
2025-09-16,Avigal Soreq,Delek US,5,8,5,18,
2025-09-16,Beth Ford,Land OLakes,4,6,1,11,
2025-09-16,Walker Martin,Sempra,0,1,0,1,
2025-09-16,Eric Slifka,Global Partners,12,21,7,40,
2025-09-16,DG Macpherson,WW Grainger,2,7,0,9,
2025-09-16,Bob Pragada,Jacobs Solutions,5,9,0,14,
2025-09-16,Pedro Pizarro,Edison International,15,7,18,40,
2025-09-16,William Hornbuckle,MGM Resorts International,8,26,1,35,
2025-09-16,Andrew McMahon,Guardian Life insurance,6,12,0,18,
2025-09-16,Christopher OHerlihy,Illinois Tool Works,0,1,0,1,
2025-09-16,James Cracchiolo,Ameriprise Financial,2,22,2,26,
2025-09-16,Ryan Marshall,PulteGroup,9,15,10,34,
2025-09-16,Matthew Meloy,Targa Resources,5,5,0,10,
2025-09-16,Michael Rhodes,Ally Financial,8,28,4,40,
2025-09-16,Joseph Fadool,BorgWarner,4,11,0,15,
2025-09-16,St√©phane de La Faverie,Est√©e Lauder,17,20,3,40,
2025-09-16,Benjamin Tisch,Loews,2,6,0,8,
2025-09-16,Brad Beckham,OReilly Automotive,2,7,0,9,
2025-09-16,Thomas Gayner,Markel Group,2,8,0,10,
2025-09-16,Donald Allan,Stanley Black & Decker,9,29,2,40,
2025-09-16,Sanjay Mehrotra,Micron Technology,19,19,2,40,
2025-09-16,James Breuer,Fluor,1,1,1,3,
2025-09-16,Thomas Bell,Leidos,9,18,2,29,
2025-09-16,Scott Smith,Viatris,6,4,0,10,
2025-09-16,Kimberly Dang,Kinder Morgan,9,1,0,10,
2025-09-16,Christophe Beck,Ecolab,20,20,0,40,
2025-09-16,Brent Shafer,Baxter International,1,10,0,11,
2025-09-16,Clay Gaspar,Devon Energy,22,2,0,24,
2025-09-16,Steven Cahillane,Kellanova,1,7,0,8,
2025-09-16,Raul Nicholas Vargas Ochoa,Farmers Insurance Exchange,0,0,0,0,
2025-09-16,Darren Rebelez,Caseys General Stores,4,6,0,10,
2025-09-16,Ari Bousbib,IQVIA,6,14,0,20,
2025-09-16,Jon Vander Ark,Republic Services,12,18,10,40,
2025-09-16,Timothy Cofer,Keurig Dr Pepper,2,5,1,8,
2025-09-16,Karla Lewis,Reliance Inc,5,5,0,10,
2025-09-16,David Hult,Asbury Automotive Group,8,31,1,40,
2025-09-16,Darryl Button,Pacific Life,0,8,0,8,
2025-09-16,James Burke,Vistra,7,3,0,10,
2025-09-16,John Barrett,Western & Southern Financial,12,26,2,40,
2025-09-16,William Krueger,The Andersons Inc,0,2,0,2,
2025-09-16,Erik Nordstrom,Nordstrom,8,27,5,40,
2025-09-16,John Wren,Omnicom Group,13,21,6,40,
2025-09-16,Stephanie Ferris,Fidelity National Information Services,14,23,3,40,
2025-09-16,Timothy Cawley,Consolidated Edison,4,5,0,9,
2025-09-16,Joseph Hinrichs,CSX,6,9,1,16,
2025-09-16,Troy Rudd,AECOM,7,23,4,34,
2025-09-16,Kathleen Johnson,Lumen Technologies,4,5,1,10,
2025-09-16,Harry Lawton III,Tractor Supply,1,0,0,1,
2025-09-16,Raul Fernandez,DXC Technology,3,26,1,30,
2025-09-16,Eric Hansotia,AGCO,14,24,2,40,
2025-09-16,David Bruton Smith,Sonic Automotive,3,6,9,18,
2025-09-16,Sasan Goodarzi,Intuit,11,25,4,40,
2025-09-16,Matthew Flannery,United Rentals,33,1,0,34,
2025-09-16,Marc Miller,Universal Health Services,3,25,3,31,
2025-09-16,Michael Mahoney,Boston Scientific,11,28,0,39,
2025-09-16,Judith Marks,Otis Worldwide,3,3,0,6,
2025-09-16,Robert Frenzel,Xcel Energy,4,3,1,8,
2025-09-16,Penny Pennington,Edward Jones,6,29,5,40,
2025-09-16,Daniel Fisher,Ball,1,18,6,25,
2025-09-16,Justin Jude,LKQ,4,5,1,10,
2025-09-16,James Blackledge,Mutual of Omaha,1,30,2,33,
2025-09-16,Bruce Bodine,Mosaic,3,7,0,10,
2025-09-16,Scott Donnelly,Textron,10,27,3,40,
2025-09-16,Adam Schechter,Labcorp Holdings,1,6,1,8,
2025-09-16,Deanna Strable-Soethout,Principal Financial,1,8,0,9,
2025-09-16,Leonard Schleifer,Regeneron Pharmaceuticals,6,27,7,40,
2025-09-16,Paul Shoukry,Raymond James Financial,14,25,1,40,
2025-09-16,Lauren Hobart,Dicks Sporting Goods,12,24,4,40,
2025-09-16,Jamie Whisnant,Auto-Owners Insurance,0,2,0,2,
2025-09-16,Ariane Gorin,Expedia,10,29,1,40,
2025-09-16,Shelley Simpson,JB Hunt Transport Services,8,28,4,40,
2025-09-16,Ren√© Jones,M&T Bank,10,25,5,40,
2025-09-16,Gerardo Norcia,DTE Energy,6,2,1,9,
2025-09-16,Andr√©s Gluski,AES,15,20,0,35,
2025-09-16,Timothy Spence,Fifth Third Bancorp,5,5,0,10,
2025-09-16,Eduardo Menezes,Air Products & Chemicals,3,6,1,10,
2025-09-16,Wendell Weeks,Corning,14,24,2,40,
2025-09-16,Anthony Guzzi,EMCOR Group,2,5,2,9,
2025-09-16,Adam Norwitt,Amphenol,3,17,0,20,
2025-09-16,Jean-Marc Gilson,Westlake Corporation,2,4,1,7,
2025-09-16,Lori Koch,DuPont,6,18,0,24,
2025-09-16,Derek Chang,Liberty Media,37,2,1,40,
2025-09-16,Martina Cheung,S&P Global,10,25,0,35,
2025-09-16,Tim Hingtgen,Community Health Systems,10,27,3,40,
2025-09-16,Brian Tierney,FirstEnergy,6,19,3,28,
2025-09-16,Rick McKenney,Unum Group,6,5,0,11,
2025-09-16,Stanley Bergman,Henry Schein,13,26,1,40,
2025-09-16,Tiang Yew Tan,Western Digital,1,3,0,4,
2025-09-16,Vincent Roche,Analog Devices,14,22,4,40,
2025-09-16,Sean Connolly,Conagra Brands,8,30,2,40,
2025-09-16,Bruce Van Saun,Citizens Financial Group,12,24,4,40,
2025-09-16,Mark George,Norfolk Southern,17,20,3,40,
2025-09-16,Andrew Marsh,Entergy,4,4,0,8,
2025-09-16,Robert Berkley,WR Berkley,8,28,4,40,
2025-09-16,Javier Rodriguez,DaVita,12,14,1,27,
2025-09-16,Michael OGrady,Northern Trust,3,1,0,4,
2025-09-16,James Snee,Hormel Foods,4,29,1,34,
2025-09-16,Timothy J Donahue,Crown Holdings,2,9,0,11,
2025-09-16,Joseph Ferraro,Avis Budget,3,6,1,10,
2025-09-16,Niraj Shah,Wayfair,7,25,8,40,
2025-09-16,Jos√© Mas,MasTec,6,14,0,20,
2025-09-16,Joseph Nolan,Eversource Energy,5,4,1,10,
2025-09-16,Thomas Palmer,Newmont,5,5,0,10,
2025-09-16,Robert Sanchez,Ryder System,9,6,1,16,
2025-09-16,Michael Nolan,Fidelity National Financial,4,1,0,5,
2025-09-16,Gavin Hattersley,Molson Coors Beverage,5,29,6,40,
2025-09-16,Thomas Reeg,Caesars Entertainment,5,5,0,10,
2025-09-16,Ellen Cooper,Lincoln National,4,6,0,10,
2025-09-16,Bracken Darrell,VF Corporation,7,30,3,40,
2025-09-16,Erik Fyrwald,International Flavors & Fragrances,6,9,3,18,
2025-09-16,Christopher Kastner,Huntington Ingalls Industries,3,4,1,8,
2025-09-16,Shane OKelly,Advance Auto Parts,0,6,0,6,
2025-09-16,Ralph LaRossa,Public Service Enterprise Group,11,16,0,27,
2025-09-16,Kecia Steelman,Ulta Beauty,34,5,1,40,
2025-09-16,Michele Buck,Hershey,6,32,2,40,
2025-09-16,Sumit Singh,Chewy,13,23,4,40,
2025-09-16,Steven Vondran,American Tower,4,6,0,10,
2025-09-16,Jeffrey Lorberbaum,Mohawk Industries,11,5,1,17,
2025-09-16,Keith Demmings,Assurant,4,9,0,13,
2025-09-16,Robert Martin,Thor Industries,4,5,1,10,
2025-09-16,Kathleen Mazzarella,Graybar Electric,1,6,2,9,
2025-09-16,Joey Wat,Yum China,15,22,3,40,
2025-09-16,Scott Richardson,Celanese,6,14,2,22,
2025-09-16,David Rawlinson II,QVC,8,15,2,25,
2025-09-16,Alan Armstrong,Williams,24,12,4,40,
2025-09-16,Philippe Krakowsky,Interpublic Group,13,24,3,40,
2025-09-16,Brendan McCracken,Ovintiv,6,5,0,11,
2025-09-16,Andrew Teno,Icahn Enterprises,4,6,0,10,
2025-09-16,Stephen Steinour,Huntington Bancshares,2,8,0,10,
2025-09-16,Timothy NeCastro,Erie Insurance,2,8,0,10,
2025-09-16,Ernest Garcia III,Carvana,23,13,4,40,
2025-09-16,R Bruce McDonald,Dana Incorporated,3,8,1,12,
2025-09-16,William Oplinger,Alcoa Corporation,2,6,1,9,
2025-09-16,Mark Pearson,Equitable,7,8,0,15,
2025-09-16,Richard Wallace,KLA,4,4,0,8,
2025-09-16,Ricardo Cardenas,Darden Restaurants,4,3,1,8,
2025-09-16,Mikael Bratt,Autoliv,4,8,2,14,
2025-09-16,Benito Minicucci,Alaska Air,2,2,2,6,
2025-09-16,Christopher Gorman,KeyCorp,5,5,0,10,
2025-09-16,Robert Goldstein,Las Vegas Sands,4,30,6,40,
2025-09-16,Edward Pesicka,Owens & Minor,3,32,2,37,
2025-09-16,Christopher Nassetta,Hilton Worldwide,8,15,3,26,
2025-09-16,Jamie Iannone,Ebay,18,19,3,40,
2025-09-16,Patrick Gallagher,Arthur J Gallagher,8,30,2,40,
2025-09-16,Rich Steinmeier,LPL Financial,22,16,2,40,
2025-09-16,Stephen Spray,Cincinnati Financial,2,5,2,9,
2025-09-16,Douglas Yearley,Toll Brothers,10,25,5,40,
2025-09-16,Gregory Brown,Motorola Solutions,3,5,1,9,
2025-09-16,Brian Chesky,Airbnb,4,28,8,40,
2025-09-16,Jeffrey Sprecher,Intercontinental Exchange,15,22,3,40,
2025-09-16,Robert Thomson,News Corp,6,31,3,40,
2025-09-16,Scott Boatwright,Chipotle Mexican Grill,9,28,3,40,
2025-09-16,Reshma Kewalramani,Vertex Pharmaceuticals,21,14,5,40,
2025-09-16,Christopher Viehbacher,Biogen,0,26,2,28,
2025-09-16,Malcolm Wilson,GXO Logistics,6,22,0,28,
2025-09-16,Tony Sarsam,SpartanNash,18,20,2,40,
2025-09-16,Michael O‚ÄôSullivan,Burlington Stores,9,27,4,40,
2025-09-16,Teresa Rasmussen,Thrivent Financial for Lutherans,4,1,0,5,
2025-09-16,Eugene Bredow,NVR,0,4,1,5,
2025-09-16,Brian Chambers,Owens Corning,3,14,0,17,
2025-09-16,Rafael Santana,Westinghouse Air Brake Technologies,3,10,1,14,
2025-09-16,John Pfeifer,Oshkosh Corporation,3,18,0,21,
2025-09-16,Cameron Bready,Global Payments,8,29,3,40,
2025-09-16,Calvin McDonald,Lululemon athletica,9,30,1,40,
2025-09-16,J Kent Masters,Albemarle Corporation,4,6,0,10,
2025-09-16,Joanna Geraghty,JetBlue Airways,15,19,6,40,
2025-09-16,Robert Steer,Seaboard,1,5,0,6,
2025-09-16,William Newlands,Constellation Brands,0,4,2,6,
2025-09-16,Michael Doss,Graphic Packaging,3,9,1,13,
2025-09-16,Gil West,Hertz,7,24,9,40,
2025-09-16,Malcolm C Roberts,FM Global,2,10,2,14,
2025-09-16,Mick Beekhuizen,Campbell Soup,8,23,0,31,
2025-09-16,Daniel Wall,Expeditors International of Washington,2,4,0,6,
2025-09-16,Gregory Roberts,A-Mark Precious Metals,2,4,1,7,
2025-09-16,Horacio Rozanski,Booz Allen Hamilton,17,18,5,40,
2025-09-16,James Davis,Quest Diagnostics,5,5,0,10,
2025-09-16,Dennis Mathew,Altice,5,26,7,38,
2025-09-16,Stefan Larsson,PVH,11,24,5,40,
2025-09-16,Mark Costa,Eastman Chemical,5,14,5,24,
2025-09-16,Joyce Mullen,Insight Enterprises,6,12,0,18,
2025-09-16,John Turner,Regions Financial,21,17,2,40,
2025-09-16,Julian G Francis,Beacon Roofing Supply,0,1,0,1,
2025-09-16,Blake Moret,Rockwell Automation,11,27,2,40,
2025-09-16,Mike Speetzen,Polaris Inc,3,17,2,22,
2025-09-16,William McDermott,ServiceNow,4,4,0,8,
2025-09-16,Jure Sola,Sanmina,3,10,1,14,
2025-09-16,Bob Flexon,UGI Utilities Inc,0,1,0,1,
2025-09-16,Scott Lauber,WEC Energy,13,7,0,20,
2025-09-16,Jon Rousseau,BrightSpring Health Services,19,20,1,40,
2025-09-16,Todd Schneider,Cintas,11,18,1,30,
2025-09-16,Peter Matt,Commercial Metals,5,4,0,9,
2025-09-16,Robert D Lawler,Continental Resources,0,0,0,0,
2025-09-16,Domenic Dell‚ÄôOsso Jr,Expand Energy,4,0,0,4,
2025-09-16,Jason P Wells,CenterPoint Energy,6,4,1,11,
2025-09-16,H Michael Krimbill,NGL Energy Partners,5,1,0,6,
2025-09-16,Tony Xu,DoorDash,15,18,7,40,
2025-09-16,Clay Williams,NOV,6,19,4,29,
2025-09-16,Kristin Peck,Zoetis,11,19,1,31,
2025-09-16,Mark Smucker,JM Smucker,12,22,6,40,
2025-09-16,Steve Sanghi,Microchip Technology,7,28,5,40,
2025-09-16,Richard Tobin,Dover Corporation,4,3,0,7,
2025-09-16,Kaes Van‚Äôt Hof,Diamondback Energy,22,14,3,39,
2025-09-16,Deon Stander,Avery Dennison,0,13,0,13,
2025-09-16,Vincent Sorgi,PPL,8,9,1,18,
2025-09-16,Hassane El-Khoury,ON Semiconductor,3,16,4,23,
2025-09-16,Arie Kotler,ARKO,4,22,1,27,
2025-09-16,William Monteleone,Par Pacific,2,5,2,9,
2025-09-16,John Christmann IV,APA,6,4,0,10,
2025-09-16,Adaire Fox-Martin,Equinix,17,21,2,40,
2025-09-16,Joseph M Otting,Flagstar Financial,3,5,2,10,
2025-09-16,Mary Dillon,Foot Locker,9,26,5,40,
2025-09-16,James Zallie,Ingredion,5,5,0,10,
2025-09-16,Christopher Peterson,Newell Brands,0,9,1,10,
2025-09-16,Scott Salmirs,ABM Industries,5,4,1,10,
2025-09-16,Christopher Hilger,Securian Financial,0,6,0,6,
2025-09-16,Hamid Moghadam,Prologis,8,27,5,40,
2025-09-16,Stephen Schwarzman,Blackstone,10,21,9,40,
2025-09-16,Robert Greenberg,Skechers USA,5,24,3,32,
2025-09-16,Keith Allman,Masco,4,9,0,13,
2025-09-16,Rusty Rush,Rush Enterprises,15,22,3,40,
2025-09-16,Jennifer Johnson,Franklin Resources,1,8,1,10,
2025-09-16,Gerry P Smith,ODP Business Solutions,0,0,0,0,
2025-09-16,Carl Lindner lll,American Financial,0,0,0,0,
2025-09-16,Mark Kowlzan,Packaging Corp of America,0,8,1,9,
2025-09-16,Thomas Hill,Vulcan Materials,4,7,2,13,
2025-09-16,Milan Galik,Interactive Brokers,7,17,2,26,
2025-09-16,Laura Alber,Williams-Sonoma,15,21,4,40,
2025-09-16,Mario Harik,XPO,7,32,1,40,
2025-09-16,Devin Stockfish,Weyerhaeuser,5,5,0,10,
2025-09-16,Thomas J McInerney,Genworth Financial,1,5,1,7,
2025-09-16,Garrick Rochow,CMS Energy,9,3,1,13,
2025-09-16,Toni Townes-Whitley,Science Applications International,11,20,1,32,
2025-09-16,Rich Handler,Jefferies Financial,12,12,2,26,
2025-09-16,Daniel Heaf,Bath & Body Works,16,22,2,40,
2025-09-16,Andrew Wilson,Electronic Arts,11,18,11,40,
2025-09-16,Sheryl Palmer,Taylor Morrison Home,9,10,1,20,
2025-09-16,Ivan Tornos,Zimmer Biomet,9,28,3,40,
2025-09-16,Linda Rendle,Clorox,2,33,3,38,
2025-09-16,Matthew Pine,Xylem Inc,1,9,1,11,
2025-09-16,Heather Lavallee,Voya Financial,6,12,2,20,
2025-09-16,Daniel Florness,Fastenal,2,6,2,10,
2025-09-16,Albert Nahmad,Watsco,2,7,0,9,
2025-09-16,Carl Eschenbach,Workday,12,19,9,40,
2025-09-16,Craig Smiddy,Old Republic International,1,7,1,9,
2025-09-16,Frank C Sullivan,RPM International,3,7,1,11,
2025-09-16,Matthew Missad,UFP Industries,8,2,0,10,
2025-09-16,Martin J Lyons,Ameren,4,3,1,8,
2025-09-16,Adam W Miller,Knight Swift Transportation,1,2,1,4,
2025-09-16,Rodney Sacks,Monster Beverage,13,25,1,39,
2025-09-16,Gary Guthart,Intuitive Surgical,10,24,6,40,
2025-09-16,Charles Liang,Super Micro Computer,33,6,1,40,
2025-09-16,Christopher Caldwell,Concentrix,3,5,0,8,
2025-09-16,Gordon J Hardie,O-I Glass,0,5,0,5,
2025-09-16,David Gibbs,Yum Brands,3,37,0,40,
2025-09-16,Steve Henry,Domtar,4,6,0,10,
2025-09-16,Chuck Treadway,CommScope,7,19,3,29,
2025-09-16,Rob Vitale,Post Holdings,1,13,5,19,
2025-09-16,Steven J Moskowitz,Crown Castle,2,5,3,10,
2025-09-16,Emmanuel Ligner,Avantor,2,10,1,13,
2025-09-16,Stuart Bradie,KBR,14,14,4,32,
2025-09-16,Carrie Wheeler,Opendoor Technologies,11,24,5,40,
2025-09-16,Russell Becker,APi Group,4,4,0,8,
2025-09-16,Toby Rice,EQT,26,12,2,40,
2025-09-16,Jesse Arenivas,EnLink Midstream,8,8,0,16,
2025-09-16,Nikesh Arora,Palo Alto Networks,10,21,9,40,
2025-09-16,Steven Bandrowczak,Xerox,2,6,1,9,
2025-09-16,Vicente Reynal,Ingersoll Rand,8,29,0,37,
2025-09-16,William T Dillard II,Dillards,4,4,1,9,
2025-09-16,C Howard Nye,Martin Marietta Materials,4,3,3,10,
2025-09-16,Giordano Albertazzi,Vertiv,15,19,4,38,
2025-09-16,Stephane Bancel,Moderna,10,23,7,40,
2025-09-16,Nate R Jorgensen,Boise Cascade,0,0,0,0,
2025-09-16,Jack Sinclair,Sprouts Farmers Market,17,23,0,40,
2025-09-16,Padraig McDonnell,Agilent Technologies,8,11,0,19,
2025-09-16,Kenneth T Lane,Olin,0,0,0,0,
2025-09-16,Randall C Stuewe,Darling Ingredients,27,1,0,28,
2025-09-16,R Howard Coker,Sonoco Products,2,7,1,10,
2025-09-16,John Mengucci,CACI International,22,17,1,40,
2025-09-16,Mark Witkowski,Core & Main,1,12,2,15,
2025-09-16,Lee M Tillman,Marathon Oil,4,5,0,9,
2025-09-16,Mark Hoplamazian,Hyatt Hotels,15,20,5,40,
2025-09-16,David S Chernow,Select Medical,0,9,1,10,
2025-09-16,Brendan M Foley,McCormick & Company,0,8,0,8,
2025-09-16,Joanne Crevoiserat,Tapestry,15,21,4,40,
2025-09-16,John Plant,Howmet Aerospace,4,13,3,20,
2025-09-16,Shankh Mitra,Welltower,17,22,1,40,
2025-09-16,W Anthony Will,CF Industries,4,5,0,9,
2025-09-16,David A Zapico,Ametek,2,16,1,19,
2025-09-16,Kevin Stein,TransDigm,11,10,2,23,
2025-09-16,Craig Billings,Wynn Resorts,13,25,2,40,
2025-09-16,William J Way,Southwestern Energy,2,0,0,2,
2025-09-16,Giel Rutten,Amkor Technology,3,7,1,11,
2025-09-16,Paul Sarvadi,Insperity,4,5,0,9,
2025-09-16,Donald Zurbay,Patterson Companies Inc,1,5,0,6,
2025-09-16,Rob Sharps,T Rowe Price,15,20,5,40,
2025-09-16,Patrice Louvet,Ralph Lauren,13,18,9,40,
2025-09-16,Jeffrey Mezger,KB Home,4,28,7,39,
2025-09-16,David M Foulkes,Brunswick,0,9,0,9,
2025-09-16,M Keith Waddell,Robert Half,4,6,0,10,
2025-09-16,Jay Snowden,PENN Entertainment,19,17,4,40,
2025-09-16,George Kurian,NetApp,17,20,3,40,
2025-09-16,Kevin Ali,Organon,9,14,2,25,
2025-09-16,Joel D Anderson,Petco Health and Wellness,1,9,0,10,
2025-09-16,Louis V Pinkham,Regal Rexnord,0,1,0,1,
2025-09-16,Jay Geldmacher,Resideo Technologies,10,6,0,16,
2025-09-16,Marcus Lemonis,Camping World,11,20,9,40,
2025-09-16,Peter R Huntsman,Huntsman,5,11,3,19,
2025-09-16,Hillary Super,Victorias Secret,11,4,8,23,
2025-09-16,Michelle Gass,Levi Strauss,11,25,3,39,
2025-09-16,Neil Hunn,Roper Technologies,2,20,0,22,
2025-09-16,Steven P Lawrence,Academy Sports and Outdoors,1,1,0,2,
2025-09-16,Phillippe Lord,Meritage Homes,8,17,0,25,
2025-09-16,David C Dauch,American Axle & Manufacturing,6,8,2,16,
2025-09-16,Olumide Soroye,Fortive,1,8,0,9,
2025-09-16,Adena Friedman,Nasdaq,15,21,4,40,
2025-09-16,Tim Gokey,Broadridge Financial Solutions,4,13,1,18,
2025-09-16,Patrick M Shanahan,Spirit AeroSystems,1,9,0,10,
2025-09-16,Robert Kyncl,Warner Music Group,10,28,2,40,
2025-09-16,Denise Dignam,Chemours,4,17,3,24,
2025-09-16,Jim DeVries,ADT,9,7,1,17,
2025-09-16,Bernard Zovighian,Edwards Lifesciences,6,7,2,15,
2025-09-16,Mark E Seaton,First American Financial,1,9,0,10,
2025-09-16,John C Roche,Hanover Insurance Group,7,15,0,22,
2025-09-16,Adam J Greenlee,Silgan,0,5,0,5,
2025-09-16,Jayne Hrdlicka,Endeavor Group,0,1,0,1,
2025-09-16,Robert Fauber,Moodys Corporation,0,6,0,6,
2025-09-16,Thomas E Jorden,Coterra Energy,8,0,0,8,
2025-09-16,Eugene A Hall,Gartner,1,9,0,10,
2025-09-16,Kevin Plank,Under Armour,9,27,2,38,
2025-09-16,James W Lanning,Ingles Markets,3,3,0,6,
2025-09-16,Matthew T Farrell,Church & Dwight,7,7,0,14,
2025-09-16,Kevin M Freeman,Old Dominion Freight Line,0,0,0,0,
2025-09-16,Joe Shoen,U-Haul,15,20,4,39,
2025-09-16,Mark Bertolini,Oscar Health,13,18,8,39,
2025-09-16,Jayshree Ullal,Arista Networks,20,19,1,40,
2025-09-16,Sassine Ghazi,Synopsys,12,24,4,40,
2025-09-16,Jochen Zeitz,Harley-Davidson,5,25,10,40,
2025-09-16,Nick Jeffery,Frontier Communications,10,24,0,34,
2025-09-16,Thomas Edward McCormick,Primoris Services,0,6,0,6,
2025-09-16,D Christian Koch,Carlisle Companies,0,5,0,5,
2025-09-16,David E Simon,Simon Property Group,3,6,1,10,
2025-09-16,Stephen Bratspies,Hanesbrands,3,11,2,16,
2025-09-16,Ryan M. Schneider,Anywhere Real Estate Inc,0,1,0,1,
2025-09-16,George Bobb III,Teledyne Technologies,1,4,0,5,
2025-09-16,Terrence A Duffy,CME Group,6,9,1,16,
2025-09-16,Rami Rahim,Juniper Networks,12,26,2,40,
2025-09-16,Sue Nabi,Coty,14,18,8,40,
2025-09-16,Peter D Arvan,Pool Corporation,3,6,0,9,
2025-09-16,David Campbell,Evergy,15,8,0,23,
2025-09-16,Matthew J Murphy,Marvell Technology,2,6,1,9,
2025-09-16,Lloyd Yates,NiSource,5,5,0,10,
2025-09-16,William C Stone,SS&C Technologies,3,5,1,9,
2025-09-16,Mark Rourke,Schneider National,10,15,1,26,
2025-09-16,Andrew Anagnost,Autodesk,10,23,7,40,
2025-09-16,Dustin Semach,Sealed Air Corporation,0,9,0,9,
2025-09-16,William L Meaney,Iron Mountain,3,13,0,16,
2025-09-16,Andy P Power,Digital Realty Trust,0,0,0,0,
2025-09-16,Satish Dhanasekaran,Keysight Technologies,3,10,0,13,
2025-09-16,Frank M Svoboda,Globe Life,3,4,3,10,
2025-09-16,Carey A Smith,Parsons Corporation,0,2,0,2,
2025-09-16,Ynon Kreiz,Mattel,8,26,6,40,
2025-09-16,Karen S Haller,Southwest Gas,3,6,0,9,
2025-09-16,Terrance Williams,TruStage,5,5,1,11,
2025-09-16,Eric W Gerstenberg,Clean Harbors,6,1,1,8,
2025-09-16,Gunner Smith,Cornerstone Building Brands,1,7,2,10,
2025-09-16,Gerben W Bakker,Hubbell,1,5,0,6,
2025-09-16,Dave Davis,Spirit Airlines,4,35,1,40,
2025-09-16,Michael J Smith,Lamb Weston,0,7,3,10,
2025-09-16,Strauss Zelnick,Take-Two Interactive Software,14,15,11,40,
2025-09-16,John C Turner Jr,GMS,2,8,0,10,
2025-09-16,David M OMalley,Penn Mutual Life Insurance,0,1,0,1,
2025-09-16,Frank A Lonegro,Landstar System,2,4,0,6,
2025-09-16,James F Risoleo,Host Hotels & Resorts,4,15,0,19,
2025-09-16,Ken Xie,Fortinet,15,17,8,40,
2025-09-16,Doug Shulman,OneMain,4,6,0,10,
2025-09-16,Ryan Cohen,GameStop,10,22,7,39,
2025-09-16,Mark W Begor,Equifax,2,12,0,14,
2025-09-16,Jay L Schottenstein,American Eagle Outfitters,8,19,1,28,
2025-09-16,Curtis C Farmer,Comerica,4,8,0,12,
2025-09-16,Ole Rosgaard,Greif,3,12,1,16,
2025-09-16,Brian E Lane,Comfort Systems USA,10,0,0,10,
2025-09-16,Robert M Buck,TopBuild,4,6,0,10,
2025-09-16,Ralph Andretta,Bread Financial,3,9,0,12,
2025-09-16,Jim Anderson,Coherent,5,33,1,39,
2025-09-16,Walter C. D. Carlson,Telephone & Data Systems,0,2,0,2,
2025-09-16,Ronald Kruszewski,Stifel Financial,6,3,0,9,
2025-09-16,Richard Hayne,Urban Outfitters,11,20,8,39,
2025-09-16,Simon Meester,Terex,4,7,0,11,
2025-09-16,Edward J Lehner,Ryerson Holding,0,3,0,3,
2025-09-16,Nicholas T Pinchuk,Snap-on,3,7,0,10,
2025-09-16,Ryals McMullian,Flowers Foods,5,28,2,35,
2025-09-16,D Bryan Jordan,First Horizon,3,7,1,11,
2025-09-16,John B Gibson,Paychex,5,4,1,10,
2025-09-16,Chris Cocks,Hasbro,12,19,9,40,
2025-09-16,Pete McPartland,Sentry Insurance Group,0,2,0,2,
2025-09-16,Michael Arougheti,Ares Management,16,22,2,40,
2025-09-16,Alok Maskara,Lennox International,5,2,1,8,
2025-09-16,James C Grech,Peabody Energy,3,0,0,3,
2025-09-16,Joseph P Lacher Jr,Kemper,3,18,3,24,
2025-09-16,Perry A Sook,Nexstar Media Group,8,26,1,35,
2025-09-16,Wade Davis,TelevisaUnivision,11,28,1,40,
2025-09-16,Scott L Thompson,Tempur Sealy International,0,8,0,8,
2025-09-16,Mike Simonds,TriNet Group,0,9,0,9,
2025-09-16,B Andrew Rose,Worthington Enterprises,0,1,0,1,
2025-09-16,Bruce L Caswell,Maximus,2,3,0,5,
2025-09-16,Robert L Reffkin,Compass,1,6,0,7,
2025-09-16,Mark Eubanks,Brinks Company,1,2,1,4,
2025-09-16,Peter Quigley,Kelly Services inc,1,7,0,8,
2025-09-16,David L Yowan,Navient,1,0,0,1,
2025-09-16,Mary E Kipp,Puget Sound Energy,3,0,1,4,
2025-09-16,Adam Aron,AMC Entertainment,16,18,6,40,
2025-09-16,Mark J Tarr,Encompass Health,2,3,1,6,
2025-09-16,Liam K Griffin,Skyworks Solutions,1,6,1,8,
2025-09-16,Richard G Kyle,Timken,2,12,1,15,
2025-09-16,Ron Gusek,Liberty Energy,24,1,0,25,
2025-09-16,John E Geller Jr,Marriott Vacations Worldwide,6,6,0,12,
2025-09-16,Karl G. Glassman,Leggett & Platt,0,3,0,3,
2025-09-16,Bruce K Thorn,Big Lots,2,7,1,10,
2025-09-16,Jonathan H Weis,Weis Markets,11,28,0,39,
2025-09-16,Jeffrey B Guldner,Pinnacle West Capital,1,1,0,2,
2025-09-16,Arkadiy Dobkin,EPAM Systems,9,15,1,25,
2025-09-16,Paul M Rady,Antero Resources,3,8,0,11,
2025-09-16,Michael Spanos,Bloomin Brands,1,8,1,10,
2025-09-16,Nicole A Kivisto,MDU Resources Group,4,6,0,10,
2025-09-16,Gerald L Morgan,Texas Roadhouse,2,2,5,9,
2025-09-16,Gabriel Tirador,Mercury General,5,3,2,10,
2025-09-16,Nicholas I Fink,Fortune Brands Innovations,4,6,0,10,
2025-09-16,Paul E Burdiss,Zions Bancorp,1,1,0,2,
2025-09-16,William J Christensen,JELD-WEN Holding,4,5,0,9,
2025-09-16,Evan Spiegel,Snap Inc,20,16,4,40,
2025-09-16,Bill Burns,Zebra Technologies,6,20,1,27,
2025-09-16,Steven Sell,Agilon Health,0,8,0,8,
2025-09-16,Richard M Olson,Toro Company,1,9,0,10,
2025-09-16,Eric S Yuan,Zoom Video Communications,5,7,0,12,
2025-09-16,Dan L Batrack,Tetra Tech,2,4,1,7,
2025-09-16,Joseph D Russell Jr,Public Storage,0,6,0,6,
2025-09-16,Jacob Thaysen,Illumina inc,4,6,1,11,
2025-09-16,Debra A Cafaro,Ventas inc,6,7,0,13,
2025-09-16,Pierre R Brondeau,FMC Corporation,0,4,0,4,
2025-09-16,Judy R McReynolds,ArcBest,5,13,1,19,
2025-09-16,Russell J Weiner,Dominos Pizza inc,0,0,0,0,
2025-09-16,Theodore S Hanson,ASGN,0,0,0,0,
2025-09-16,RJ Scaringe,Rivian Automotive,10,26,4,40,
2025-09-16,Jeffrey N Simmons,Elanco Animal Health,2,6,1,9,
2025-09-16,Tim O Shaughnessy,Graham Holdings Company,2,7,0,9,
2025-09-16,Thomas V Taylor,Floor & Decor,1,2,2,5,
2025-09-16,Neil A Schrimsher,Applied Industrial Technologies,6,22,1,29,
2025-09-16,Robert E Price,PriceSmart,4,6,0,10,
2025-09-16,John David Risher,Lyft,4,3,1,8,
2025-09-16,Gary B Smith,Ciena,4,7,0,11,
2025-09-16,Joey Levin,IAC,7,32,1,40,
2025-09-16,Jim Jacobs,Country Financial,6,6,2,14,
2025-09-16,Devin B McGranahan,Western Union,2,6,0,8,
2025-09-16,R Scott Rowe,Flowserve,5,4,1,10,
2025-09-16,Kenneth A Vecchione,Western Alliance Bancorp,0,0,1,1,
2025-09-16,John C Rademacher,Option Care Health,7,0,0,7,
2025-09-16,Doug Black,SiteOne Landscape Supply,3,12,1,16,
2025-09-16,Oliver G Brewer III,Topgolf Callaway Brands,1,0,0,1,
2025-09-16,Glenn Sanford,eXp World,15,21,4,40,
2025-09-16,Fran Horowitz,Abercrombie & Fitch,15,20,5,40,
2025-09-16,Kevin Akers,Atmos Energy,6,3,1,10,
2025-09-16,Alessandro Maselli,Catalent,3,11,2,16,
2025-09-16,J Powell Brown,Brown & Brown,13,21,6,40,
2025-09-16,Aman Bhutani,GoDaddy,16,22,2,40,
2025-09-16,John C. Griffith,American Water Works,1,4,0,5,
2025-09-16,John J Marchioni,Selective Insurance Group,5,13,3,21,
2025-09-16,Lawson E Whiting,Brown-Forman,2,7,0,9,
2025-09-16,Dave Peacock,Advantage Solutions,22,6,0,28,
2025-09-16,Mick Farrell,ResMed,16,22,2,40,
2025-09-16,Kamal Hathi,Splunk,4,5,0,9,
2025-09-16,Todd Kelsey,Plexus,3,7,0,10,
2025-09-16,Phillip D Yeager,Hub Group,4,5,0,9,
2025-09-16,Steven B Hedlund,Lincoln Electric,4,10,0,14,
2025-09-16,Timothy C Oliver,NCR Atleos,0,1,0,1,
2025-09-16,Bruce Fleming,Calumet,3,6,0,9,
2025-09-16,Daniel S. Peyovich,Dycom Industries,0,4,0,4,
2025-09-16,Avner M Applbaum,Valmont Industries,0,8,0,8,
2025-09-16,Kimberly A Fields,ATI inc,3,9,0,12,
2025-09-16,Khozema Z Shipchandler,Twilio,0,2,1,3,
2025-09-16,Gary C Bhojwani,CNO Financial Group,1,6,1,8,
2025-09-16,William Andrew Hendricks Jr,Patterson-UTI Energy,0,0,0,0,
2025-09-16,Kevin D Hochman,Brinker International,1,2,0,3,
2025-09-16,James C Foster,Charles River Laboratories International,2,8,0,10,
2025-09-16,Rajiv K Prasad,Hyster-Yale,2,5,0,7,
2025-09-16,Eric T Steigerwalt,Brighthouse Financial,0,2,0,2,
2025-09-16,Thomas L Ryan,Service Corp International,2,7,0,9,
2025-09-16,Charles M Nifong Jr,CrossAmerica Partners,0,0,0,0,
2025-09-16,Anirudh Devgan,Cadence,10,27,3,40,
2025-09-16,Andi Owen,MillerKnoll,17,15,8,40,
2025-09-16,Sumit Roy,Realty Income,16,18,2,36,
2025-09-16,Timothy John Fitzgerald,Middleby,0,0,0,0,
2025-09-16,Robert H Schottenstein,M/I Homes,2,8,0,10,
2025-09-16,Stephen P MacMillan,Hologic,1,7,1,9,
2025-09-16,Lisa M Barton,Alliant Energy,2,0,0,2,
2025-09-16,Aaron P Jagdfeld,Generac,2,6,1,9,
2025-09-16,Erik Gershwind,MSC Industrial Direct,2,5,3,10,
2025-09-16,Varun Krishna,Rocket Companies,8,31,1,40,
2025-09-16,Fahmi Karam,Upbound Group,5,2,0,7,
2025-09-16,NADominic Ng,East West Bancorp,0,0,0,0,
2025-09-16,Mark Wang,Hilton Grand Vacations,38,2,0,40,
2025-09-16,Robert J Sheedy Jr,Grocery Outlet Holding,0,0,0,0,
2025-09-16,Simon D Campion,Dentsply Sirona,1,2,0,3,
2025-09-16,Jeremy Wensinger,V2X,7,6,0,13,
2025-09-16,Andrew Rees,Crocs,15,13,12,40,
2025-09-16,David M Maura,Spectrum Brands,6,0,0,6,
2025-09-16,Sachin S Lawande,Visteon,0,0,0,0,
2025-09-16,Neil M Ashe,Acuity Inc,0,2,0,2,
2025-09-16,Lorie L Tekorius,Greenbrier,2,8,0,10,
2025-09-16,John R Ciulla,Webster Financial,4,6,0,10,
2025-09-16,Sean D Keohane,Cabot Corporation,4,5,1,10,
2025-09-16,Drew M Wilkerson,RXO inc,0,0,0,0,
2025-09-16,Daniel E Brown,Chord Energy,1,0,0,1,
2025-09-16,Javier D Ferrer Fernandez,Popular inc,0,0,0,0,
2025-09-16,Olivier Rabiller,Garrett Motion inc,2,8,0,10,
2025-09-16,Ronald N Tutor,Tutor Perini Corporation,1,8,0,9,
2025-09-16,Jeff Liaw,Copart,4,7,0,11,
2025-09-16,Aman Narang,Toast inc,6,5,2,13,
2025-09-16,Joseph M Hogan,Align Technology,3,5,0,8,
2025-09-16,Kevin J Wheeler,A O Smith,0,16,1,17,
2025-09-16,Christopher A Cartwright,TransUnion,2,0,0,2,
2025-09-16,James Kelly,NCR Voyix,2,12,0,14,
2025-09-16,Tom Leighton,Akamai Technologies,16,14,5,35,
2025-09-16,Robert G Painter,Trimble,4,2,0,6,
2025-09-16,Tony Helton,Medical Mutual of Ohio,2,3,1,6,
2025-09-16,Caroline S Grace,AMN Healthcare Services,0,0,0,0,
2025-09-16,Patrick Kaltenbach,Mettler-Toledo International,1,9,0,10,
2025-09-16,Michael L Baur,ScanSource,0,1,0,1,
2025-09-16,Jason Lippert,LCI Industries,5,12,0,17,
2025-09-16,Fredric J Tomczyk,Cboe Global Markets,0,8,1,9,
2025-09-16,Octavio Marquez,Diebold Nixdorf,6,11,1,18,
2025-09-16,Sivasankaran Somasundaram,ChampionX,8,2,0,10,
2025-09-16,Ronald F Clarke,Corpay,0,0,0,0,
2025-09-16,Robert W Pittman,iHeartMedia,5,3,0,8,
2025-09-16,Patrick Zalupski,Dream Finders Homes,23,15,2,40,
2025-09-16,Keith E Smith,Boyd Gaming,0,5,0,5,
2025-09-16,Mehran Assadi,NLV Financial,1,1,0,2,
2025-09-16,Barry R Port,Ensign Group,2,5,2,9,
2025-09-16,Denise A Paulonis,Sally Beauty,0,2,0,2,
2025-09-16,Clifford A Skelton,Conduent,0,2,1,3,
2025-09-16,Jean-Michel Ribieras,Sylvamo,2,6,0,8,
2025-09-16,Douglas F Bauer,Tri Pointe Homes,0,7,0,7,
2025-09-16,Shawn OConnell,EnerSys,0,1,0,1,
2025-09-16,Bill Meury,Incyte,7,14,0,21,
2025-09-16,Dale Francescon,Century Communities,1,11,3,15,
2025-09-16,Michael Nierenberg,Rithm Capital,10,23,2,35,
2025-09-16,Michael J Brown,Euronet Worldwide,2,6,0,8,
2025-09-16,Scott Seu,Hawaiian Electric Industries,5,16,1,22,
2025-09-16,Jason D Robins,DraftKings,5,2,1,8,
2025-09-16,Jonathan J Mazelsky,IDEXX Laboratories,1,1,1,3,
2025-09-16,Richard S Swartz,MYR Group,0,0,0,0,
2025-09-16,Stefano Caroti,Deckers Outdoor,2,6,1,9,
2025-09-16,Kevin R Sayer,DexCom,1,4,0,5,
2025-09-16,John T C Lee,MKS Instruments,3,7,0,10,
2025-09-16,Edward B Pitoniak,VICI Properties,1,7,0,8,
2025-09-16,Albert White III,Cooper Cos,0,0,0,0,
2025-09-16,Barry L Biffle,Frontier Airlines,1,5,6,12,
2025-09-16,Robert A Bruggeworth,Qorvo,5,4,0,9,
2025-09-16,Winnie Park,Five Below,8,28,4,40,
2025-09-16,Steven Oakland,TreeHouse Foods,1,13,0,14,
2025-09-16,James S Hagedorn,Scotts Miracle-Gro,1,0,0,1,
2025-09-16,Michael Cannon-Brookes,Atlassian,16,23,0,39,
2025-09-16,Bertrand Loy,Entegris,2,8,1,11,
2025-09-16,William E Waltz,Atkore,3,6,0,9,
2025-09-16,Celeste B Mastin,H B Fuller,0,2,0,2,
2025-09-16,Kyle T Larkin,Granite Construction,0,4,0,4,
2025-09-16,Michael J Happe,Winnebago Industries,1,3,1,5,
2025-09-16,Steven H Gunby,FTI Consulting,5,12,0,17,
2025-09-16,Stephan B Tanda,AptarGroup,1,3,3,7,
2025-09-16,Timothy P Boyle,Columbia Sportswear,5,3,2,10,
2025-09-16,Anthony J Wood,Roku,6,3,1,10,
2025-09-16,M Christopher Doyle,Civitas Resources,1,2,0,3,
2025-09-16,Andy Eidson,Alpha Metallurgical Resources,1,5,3,9,
2025-09-16,Andy L Nemeth,Patrick Industries,4,3,0,7,
2025-09-16,Roger W Jenkins,Murphy Oil,4,13,0,17,
2025-09-16,Kevin S Blair,Synovus Financial,7,3,0,10,
2025-09-16,Julie Felss Masino,Cracker Barrel Old Country Store,10,18,12,40,
2025-09-16,David M Overton,Cheesecake Factory,1,9,0,10,
2025-09-16,Nick DeIuliis,CNX Resources,9,2,1,12,
2025-09-16,Christopher Pappas,Chefs Warehouse,4,10,1,15,
2025-09-16,Tod Carpenter,Donaldson Company,2,8,0,10,
2025-09-16,Gregory L Christopher,Mueller Industries,1,6,0,7,
2025-09-16,Rob Saltiel,MRC Global,3,12,1,16,
2025-09-16,Jillian C Evanko,Chart Industries,3,7,0,10,
2025-09-16,Dave Guilmette,Alight Solutions,3,7,0,10,
2025-09-16,Joel Smejkal,Vishay Intertechnology,5,4,1,10,
2025-09-16,Dennis Degner,Range Resources,2,8,0,10,
2025-09-16,Ira D Robbins,Valley National Bancorp,0,2,0,2,
2025-09-16,Bernard Kim,Match Group,15,17,8,40,
2025-09-16,Vincent Pilette,Gen Digital,3,9,0,12,
2025-09-16,Timothy S Crane,Wintrust Financial,2,7,1,10,
2025-09-16,Pat Roche,Moog inc,3,10,2,15,
2025-09-16,Mark R Widmar,First Solar,4,3,3,10,
2025-09-16,Niko Lahanas,Central Garden & Pet,1,12,0,13,
2025-09-16,Chris Osowski,Green Plains inc,4,7,2,13,
2025-09-16,Derek J Leathers,Werner Enterprises,2,8,0,10,
2025-09-16,Adam Foroughi,AppLovin,11,25,4,40,
2025-09-16,Luca Savi,ITT,2,7,0,9,
2025-09-16,Lawrence H Silber,Herc Rentals,0,0,0,0,
2025-09-16,Hilton H Howell Jr,Gray Television,7,19,1,27,
2025-09-16,Eric D Ashleman,IDEX,0,9,0,9,
2025-09-16,Owen D Thomas,Boston Properties,2,7,0,9,
2025-09-16,Kurt Wolf,Pitney Bowes,6,18,1,25,
2025-09-16,Sara E Armbruster,Steelcase,0,0,0,0,
2025-09-16,Charles D. Young,Sun Communities,3,4,0,7,
2025-09-16,Suzanne Foster,AdaptHealth,3,9,1,13,
2025-09-16,Grant E Sims,Genesis Energy,3,2,0,5,
2025-09-16,Laura Prieskorn,Jackson Financial,2,6,2,10,
2025-09-16,Rick L Wessel,FirstCash,4,5,1,10,
2025-09-16,Sherman Miller,Cal-Maine Foods,11,29,0,40,
2025-09-16,Paul A Lang,Arch Resources,4,5,0,9,
2025-09-16,Ashish K Khandpur,Avient,2,6,0,8,
2025-09-16,Shyam K Reddy,BlueLinx,2,7,0,9,
2025-09-16,Christopher S Ripley,Sinclair,1,7,0,8,
2025-09-16,Stacy Kymes,BOK Financial,10,5,0,15,
2025-09-16,James H Walter,Permian Resources,0,0,0,0,
2025-09-16,Jason Murray,PACS Group,5,12,2,19,
2025-09-16,Brian Armstrong,Coinbase Global,14,22,4,40,
2025-09-16,Oscar K Brown,Western Midstream Partners,1,3,0,4,
2025-09-16,Nicholas R Lower,Federated Mutual Insurance,0,0,0,0,
2025-09-16,Morris Goldfarb,G-III Apparel Group,7,28,5,40,
2025-09-16,Mark D Morelli,Vontier,0,3,0,3,
2025-09-16,Matthew J Cox,Matson inc,2,4,0,6,
2025-09-16,David W Grzebinski,Kirby Corporation,1,3,0,4,
2025-09-16,Keith A Harvey,Kaiser Aluminum,5,3,2,10,
2025-09-16,Eric Nyman,Vista Outdoor,4,9,1,14,
2025-09-16,Doug Howe,Designer Brands,5,19,0,24,
2025-09-16,Jerry E Gahlhoff Jr,Rollins inc,0,2,0,2,
2025-09-16,D Scott Barbour,Advanced Drainage Systems,2,3,0,5,
2025-09-16,Sean Gamble,Cinemark,15,23,2,40,
2025-09-16,George Kurtz,CrowdStrike,13,24,3,40,
2025-09-16,Bill Ready,Pinterest,24,16,0,40,
2025-09-16,Fidji Simo,Instacart,9,30,1,40,
2025-09-16,Kimberly K Ryan,Hillenbrand,2,5,0,7,
2025-09-16,David S Graziosi,Allison Transmission,1,20,1,22,
2025-09-16,Gary G Friedman,Restoration Hardware,1,5,0,6,
2025-09-16,Lucinda M Baier,Brookdale Senior Living,5,3,1,9,
2025-09-16,Brian J Blaser,QuidelOrtho,1,9,0,10,
2025-09-16,E Jean Savage,Trinity Industries,1,8,1,10,
2025-09-16,Liam J Kelly,Teleflex,1,2,1,4,
2025-09-16,Laurans A Mendelson,HEICO,6,16,0,22,
2025-09-16,Frank H Laukien,Bruker,2,6,1,9,
2025-09-16,Harvey M Schwartz,Carlyle Group,5,13,0,18,
2025-09-16,Mark S LaVigne,Energizer,1,1,0,2,
2025-09-16,Joel Quadracci,Quad/Graphics,10,25,5,40,
2025-09-16,Amar Maletira,Rackspace Technology,4,10,2,16,
2025-09-16,Udit Batra,Waters Corporation,10,21,0,31,
2025-09-16,Eric M Green,West Pharmaceutical Services,2,8,0,10,
2025-09-16,Doug Palladini,Carters inc,2,2,2,6,
2025-09-16,G Mike Mikan,NeueHealth,4,1,0,5,
2025-09-16,Russell ChipChilds,SkyWest,0,0,0,0,
2025-09-16,Christopher H Hunter,Acadia Healthcare,0,1,0,1,
2025-09-16,Prahlad Singh,Revvity,2,8,0,10,
2025-09-16,Maria M Pope,Portland General Electric,4,4,0,8,
2025-09-16,Charles Chip Blankenship,Woodward inc,0,2,0,2,
2025-09-16,Mike Steib,TEGNA,14,13,1,28,
2025-09-16,Kurt J Ekert,Sabre Corporation,0,0,0,0,
2025-09-16,Matt Wilson,Light & Wonder,18,19,3,40,
2025-09-16,Rob Katz,Vail Resorts,3,11,26,40,
2025-09-16,Schnitzer Steel Industries,Radius Recycling,6,26,6,38,
2025-09-16,David A Spector,PennyMac Financial Services,6,1,0,7,
2025-09-16,Frederick J Holzgrefe III,Saia inc,0,1,0,1,
2025-09-16,Mark J Parrell,Equity Residential,4,6,1,11,
2025-09-16,John W Lindsay,Helmerich & Payne,0,5,0,5,
2025-09-16,Gary D Burnison,Korn Ferry,4,12,0,16,
2025-09-16,Timothy J McGrath,PC Connection Inc,1,2,0,3,
2025-09-16,Lynn M Bamford,Curtiss-Wright,11,10,0,21,
2025-09-16,Jonathan W Witter,Sallie Mae,0,1,0,1,
2025-09-16,Jeff Benck,Benchmark Electronics,3,8,0,11,
2025-09-16,Charles H Giancarlo,Pure Storage,0,3,0,3,
2025-09-16,Brian R Gray,Knife River Corporation,0,1,0,1,
2025-09-16,Jay Schmidt,Caleres inc,3,4,2,9,
2025-09-16,Dale Asplund,BrightView Holdings,2,7,0,9,
2025-09-16,Jeffrey S Edwards,Cooper-Standard,0,7,0,7,
2025-09-16,Glenn J Williams,Primerica,4,2,2,8,
2025-09-16,Francois Locoh-Donou,F5,6,24,2,32,
2025-09-16,Joseph Wm Foran,Matador Resources,8,9,0,17,
2025-09-16,Sridhar Ramaswamy,Snowflake inc,13,18,3,34,
2025-09-16,Mark D Dankberg,Viasat,1,6,3,10,
2025-09-16,Francisco J Leon,California Resources,1,2,1,4,
2025-09-16,Peter Stern,Peloton,16,20,4,40,
2025-09-16,David Baszucki,Roblox,8,22,10,40,
2025-09-16,Jeffrey W Edwards,Installed Building Products,0,0,0,0,
2025-09-16,Clark Lauritzen,First National of Nebraska,1,7,0,8,
2025-09-16,Carlos Alberini,Guess inc,13,26,1,40,
2025-09-16,Shyam P Kambeyanda,ESAB,3,5,0,8,
2025-09-16,Edmund Shallcross III,Amica Mutual Insurance,0,4,0,4,
2025-09-16,Benjamin W Schall,AvalonBay Communities,1,6,1,8,
2025-09-16,Allan C Thygesen,DocuSign,3,5,0,8,
2025-09-16,Bryan J Knutson,Titan Machinery,1,1,0,2,
2025-09-16,Heath Sampson,ModivCare,6,2,1,9,
2025-09-16,Ara K Hovnanian,Hovnanian Enterprises,1,15,2,18,
2025-09-16,Joshua G Silverman,Etsy,1,2,1,4,
2025-09-16,Kevin Roycraft,Adams Resources & Energy,5,4,1,10,
2025-09-16,J Eric Evans,Surgery Partners,0,3,0,3,
2025-09-16,Clint E Stein,Columbia Banking System,1,4,0,5,
2025-09-16,Lee M Shavel,Verisk Analytics,2,7,0,9,
2025-09-16,Dave Banyard Jr,MasterBrand,0,0,0,0,
2025-09-16,Peter R Ingram,Hawaiian Airlines inc,1,0,0,1,
2025-09-16,Kristin A Dolan,AMC Networks,3,2,0,5,
2025-09-16,Brendan T Cavanagh,SBA Communications,1,3,0,4,
2025-09-16,George F Chappelle Jr,Americold Realty Trust,2,3,0,5,
2025-09-16,Thomas E Gottwald,NewMarket Corporation,2,7,0,9,
2025-09-16,Thomas J Baltimore Jr,Park Hotels & Resorts,3,27,1,31,
2025-09-16,Peter M Moglia,Alexandria Real Estate Equities,4,4,0,8,
2025-09-16,Ronald J Kramer,Griffon Corporation,1,6,1,8,
2025-09-16,John L Plueger,Air Lease,2,13,0,15,
2025-09-16,Jennifer F Scanlon,UL Solutions,1,3,0,4,
2025-09-16,Greg Smith,Teradyne,1,7,2,10,
2025-09-16,Sean Trauschke,OGE Energy,18,4,0,22,
2025-09-16,Norman D Schwartz,Bio-Rad Laboratories,0,0,1,1,
2025-09-16,Scott Doyle,Spire inc,4,5,1,10,
2025-09-16,Michael E Reed,Gannett,0,4,1,5,
2025-09-16,Cindy J Miller,Stericycle,2,4,3,9,
2025-09-16,Phillip D Green,Cullen Frost Bankers,1,3,2,6,
2025-09-16,Joseph D Margolis,Extra Space Storage,2,7,1,10,
2025-09-16,Mark A Skonieczny,REV Group,1,3,0,4,
2025-09-16,Ladd Wilks,ProFrac Holding,4,0,0,4,
2025-09-16,Sundaram Nagarajan,Nordson,0,9,1,10,
2025-09-16,Anne P Noonan,Summit Materials,0,1,0,1,
2025-09-16,Lori Flees,Valvoline inc,4,4,1,9,
2025-09-16,Scott H Baxter,Kontoor Brands,2,2,0,4,
2025-09-16,Tim Larson,Skyline Champion,5,0,0,5,
2025-09-16,Chuck Divita,Teladoc Health,11,15,5,31,
2025-09-16,W Bradley Southern,Louisiana-Pacific Corporation,0,0,0,0,
2025-09-16,George C Freeman III,Universal Corporation,2,7,0,9,
2025-09-16,James A Brock,Consol Energy,1,0,0,1,
2025-09-16,Robert Antokol,Playtika Holding,0,7,1,8,
2025-09-16,Joe Craft,Alliance Resource Partners,5,11,2,18,
2025-09-16,Paul Keel,Envista,3,6,1,10,
2025-09-16,Jared Isaacman,Shift4 Payments,8,27,5,40,
2025-09-16,Mark Mac McFarland,Talen Energy,5,1,1,7,
2025-09-16,Tony R Thene,Carpenter Technology,2,7,0,9,
2025-09-16,Melissa D Smith,WEX,1,6,2,9,
2025-09-16,James Jim C Ryan III,Old National Bancorp,1,0,0,1,
2025-09-16,Peter J Federico,AGNC Investment,1,0,0,1,
2025-09-16,Brent L Yeagy,Wabash National,0,1,0,1,
2025-09-16,Henry A Fernandez,MSCI,2,15,0,17,
2025-09-16,Mark Penn,Stagwell,11,22,6,39,
2025-09-16,Julie Schertell,Mativ,2,8,0,10,
2025-09-16,Ashish Chand,Belden,2,6,1,9,
2025-09-16,Greg Anderson,Allegiant Travel Company,5,7,0,12,
2025-09-16,Drew Houston,Dropbox,14,18,8,40,
2025-09-16,Kevin T Conroy,Exact Sciences,1,6,2,9,
2025-09-16,Rex D Geveden,BWX Technologies,3,7,0,10,
2025-09-16,Scott R Wells,Clear Channel Outdoor Hldgs,0,0,0,0,
2025-09-16,Paul Bay,Ingram Micro,11,24,5,40,
2025-09-17,Doug McMillon,Walmart,17,17,6,40,
2025-09-17,Andrew Jassy,Amazon,3,32,5,40,
2025-09-17,Tim Cook,Apple,15,22,2,39,
2025-09-17,Stephen Hemsley,UnitedHealth,7,29,4,40,
2025-09-17,Warren Buffett,Berkshire Hathaway,13,15,12,40,
2025-09-17,David Joyner,CVS Health,6,29,5,40,
2025-09-17,Darren Woods,Exxon Mobil,11,22,7,40,
2025-09-17,Sundar Pichai,Alphabet,17,19,4,40,
2025-09-17,Brian Tyler,McKesson,6,14,6,26,
2025-09-17,Robert Mauch,Cencora,3,7,0,10,
2025-09-17,Ron Vachris,Costco,6,31,3,40,
2025-09-17,Jamie Dimon,JPMorgan Chase,9,18,13,40,
2025-09-17,Satya Nadella,Microsoft,17,17,5,39,
2025-09-17,Jason Hollar,Cardinal Health,14,22,4,40,
2025-09-17,Mike Wirth,Chevron,18,15,7,40,
2025-09-17,David Cordani,Cigna,22,15,3,40,
2025-09-17,Jim Farley,Ford Motor,10,21,9,40,
2025-09-17,Brian Moynihan,Bank of America,9,29,2,40,
2025-09-17,Mary Barra,General Motors,12,24,4,40,
2025-09-17,Gail Boudreaux,Elevance Health,16,15,9,40,
2025-09-17,Jane Fraser,Citigroup,9,26,5,40,
2025-09-17,Sarah London,Centene,13,17,9,39,
2025-09-17,Ted Decker,Home Depot,10,25,5,40,
2025-09-17,Maryann Mannen,Marathon Petroleum,6,15,1,22,
2025-09-17,Ron Sargent,Kroger,5,22,13,40,
2025-09-17,Mark Lashier,Phillips 66,10,21,7,38,
2025-09-17,Priscilla Almodovar,Fannie Mae,11,16,13,40,
2025-09-17,Tim Wentworth,Walgreens,7,24,9,40,
2025-09-17,Lane Riggs,Valero Energy,13,7,0,20,
2025-09-17,Mark Zuckerberg,Meta,12,18,10,40,
2025-09-17,Hans Vestberg,Verizon,14,22,4,40,
2025-09-17,John Stankey,AT&T,9,25,6,40,
2025-09-17,Brian Roberts,Comcast,12,22,6,40,
2025-09-17,Charles Scharf,Wells Fargo,26,7,7,40,
2025-09-17,David Solomon,Goldman Sachs,10,20,10,40,
2025-09-17,Michael Hutchins,Freddie Mac,2,11,3,16,
2025-09-17,Michael Fiddelke,Target,7,25,8,40,
2025-09-17,Jim Rechtin,Humana,18,17,5,40,
2025-09-17,Jon Farney,State Farm Insurance,1,14,3,18,
2025-09-17,Elon Musk,Tesla,21,16,2,39,
2025-09-17,Ted Pick,Morgan Stanley,17,21,2,40,
2025-09-17,Joaquin Duato,Johnson & Johnson,12,24,4,40,
2025-09-17,Juan Luciano,Archer Daniels Midland,4,20,10,34,
2025-09-17,Ramon Laguarta,PepsiCo,9,25,6,40,
2025-09-17,Carol Tom√©,UPS,6,23,11,40,
2025-09-17,Rajesh Subramaniam,FedEx,10,28,0,38,
2025-09-17,Bob Iger,Walt Disney,11,27,2,40,
2025-09-17,Michael Dell,Dell Technologies,11,25,4,40,
2025-09-17,Marvin Ellison,Lowes,13,24,2,39,
2025-09-17,Jon Moeller,Procter & Gamble,4,30,6,40,
2025-09-17,Thomas Long,Energy Transfer,9,0,1,10,
2025-09-17,Kelly Ortberg,Boeing,8,27,4,39,
2025-09-17,Susan Morris,Albertsons,15,21,4,40,
2025-09-17,Kevin Hourican,Sysco,9,28,3,40,
2025-09-17,Christopher Calio,RTX,6,11,0,17,
2025-09-17,Larry Culp,General Electric,10,27,3,40,
2025-09-17,James Taiclet,Lockheed Martin,16,17,7,40,
2025-09-17,Stephen Squeri,American Express,14,25,1,40,
2025-09-17,Joe Creed,Caterpillar,10,27,3,40,
2025-09-17,Michel Khalaf,MetLife,9,17,0,26,
2025-09-17,Samuel Hazen,HCA Healthcare,9,5,0,14,
2025-09-17,Tricia Griffith,Progressive Insurance,8,26,5,39,
2025-09-17,Arvind Krishna,IBM,14,20,6,40,
2025-09-17,John May,Deere,8,27,5,40,
2025-09-17,Jensen Huang,Nvidia,10,21,9,40,
2025-09-17,Philip Smith,StoneX,0,9,0,9,
2025-09-17,Robert M Davis,Merck,4,18,0,22,
2025-09-17,Ryan Lance,ConocoPhillips,16,20,4,40,
2025-09-17,Albert Bourla,Pfizer,21,12,7,40,
2025-09-17,Ed Bastian,Delta Air Lines,10,16,14,40,
2025-09-17,Patrick Zammit,TD Synnex,8,13,0,21,
2025-09-17,Kevin Murphy,Publix Super Markets,10,22,1,33,
2025-09-17,Thomas J Wilson,Allstate,1,7,1,9,
2025-09-17,Chuck Robbins,Cisco Systems,16,21,3,40,
2025-09-17,Kirt Walker,Nationwide Insurance,5,5,0,10,
2025-09-17,Christopher Winfrey,Charter Communications,5,14,5,24,
2025-09-17,Bob Michael,AbbVie,0,0,0,0,
2025-09-17,Craig DeSanto,New York Life Insurance,2,21,0,23,
2025-09-17,Lip-Bu Tan,Intel,6,19,15,40,
2025-09-17,Ernie Herrman,TJX,16,23,1,40,
2025-09-17,Andrew Sullivan,Prudential Financial,12,20,0,32,
2025-09-17,Enrique Lores,Hewlett Packard,10,15,6,31,
2025-09-17,Scott Kirby,United Airlines,29,7,4,40,
2025-09-17,George Holm,Performance Food,8,20,2,30,
2025-09-17,Donnie King,Tyson Foods,9,25,6,40,
2025-09-17,Robert Isom,American Airlines,5,26,9,40,
2025-09-17,Timothy M Sweeney,Liberty Mutual Insurance,11,0,0,11,
2025-09-17,Elliott Hill,Nike,11,26,3,40,
2025-09-17,Safra Catz,Oracle,20,13,6,39,
2025-09-17,AJ Jim Teague,Enterprise Products Partners,6,11,0,17,
2025-09-17,Richard Fairbank,Capital One,18,20,2,40,
2025-09-17,Willie Chiang,Plains GP,3,5,1,9,
2025-09-17,Michael Kasbar,World Kinect,2,8,0,10,
2025-09-17,Peter Zaffino,American International Group,8,27,5,40,
2025-09-17,James Quincey,The Coca-Cola Company,10,28,2,40,
2025-09-17,Thasunda Brown Duckett,TIAA,19,21,0,40,
2025-09-17,Jay Debertin,CHS,4,11,3,18,
2025-09-17,Chris Boerner,Bristol-Myers Squibb,10,25,5,40,
2025-09-17,Corie Barry,Best Buy,39,1,0,40,
2025-09-17,Marc Casper,Thermo Fisher Scientific,14,22,4,40,
2025-09-17,Roger Crandall,Mass Mutual,2,8,0,10,
2025-09-17,Juan Andrade,USAA,5,18,0,23,
2025-09-17,Phebe Novakovic,General Dynamics,28,8,4,40,
2025-09-17,Alan Schnitzer,Travelers Insurance,3,5,2,10,
2025-09-17,David Zaslav,Warner Bros Discovery,3,30,7,40,
2025-09-17,Gunjan Kedia,US Bancorp,17,21,2,40,
2025-09-17,Robert Ford,Abbott Laboratories,10,22,8,40,
2025-09-17,Kathy Warden,Northrop Grumman,14,22,4,40,
2025-09-17,Tim Gerend,Northwestern Mutual,12,27,1,40,
2025-09-17,Todd Vasos,Dollar General,5,26,9,40,
2025-09-17,Matthew Lucey,PBF Energy,6,2,0,8,
2025-09-17,Dara Khosrowshahi,Uber,15,20,5,40,
2025-09-17,Vimal Kapur,Honeywell,11,29,0,40,
2025-09-17,Dirk Van de Put,Mondelez,7,30,3,40,
2025-09-17,Brian Niccol,Starbucks,2,5,3,10,
2025-09-17,Cristiano Amon,Qualcomm,11,27,2,40,
2025-09-17,Hock Tan,Broadcom,11,28,1,40,
2025-09-17,David Flitman,US Foods,3,7,0,10,
2025-09-17,Paul Romanowski,DR Horton,5,12,5,22,
2025-09-17,Jacek Olczak,Philip Morris,13,22,5,40,
2025-09-17,Preston Feight,Paccar,9,25,1,35,
2025-09-17,Marc Benioff,Salesforce,10,17,13,40,
2025-09-17,Leon Topalian,Nucor,14,23,3,40,
2025-09-17,Michael Dastoor,Jabil,2,5,0,7,
2025-09-17,Jonathan Jaffe,Lennar,2,7,1,10,
2025-09-17,David Ricks,Eli Lilly,9,23,8,40,
2025-09-17,Joe Zubretsky,Molina Healthcare,11,3,4,18,
2025-09-17,Jennifer Rumsey,Cummins,7,28,5,40,
2025-09-17,Robin Vince,Bank of New York Mellon,20,19,1,40,
2025-09-17,Ted Sarandos,Netflix,11,27,2,40,
2025-09-17,William H Rogers Jr,Truist Financial,3,7,0,10,
2025-09-17,Sean Kerins,Arrow Electronics,1,14,0,15,
2025-09-17,William M Brown,3M,2,8,0,10,
2025-09-17,Ryan McInerney,Visa,13,23,4,40,
2025-09-17,Marc Rowan,Apollo Global Management,13,22,5,40,
2025-09-17,Tim Go,HF Sinclair,6,2,0,8,
2025-09-17,Robert Sulentic,CBRE Group,1,8,1,10,
2025-09-17,William Demchak,PNC Financial Services,14,21,5,40,
2025-09-17,Bryan DeBoer,Lithia Motors,12,27,1,40,
2025-09-17,William Nash,CarMax,3,5,2,10,
2025-09-17,Brian Robbins,Paramount Global,7,32,1,40,
2025-09-17,Michael Creedon,Dollar Tree,6,33,1,40,
2025-09-17,Sandy Douglas,United Natural Foods,33,5,2,40,
2025-09-17,Alex Chriss,PayPal,14,22,4,40,
2025-09-17,Roger Penske,Penske Automotive,18,21,1,40,
2025-09-17,Antonio Neri,Hewlett Packard Enterprise,9,23,8,40,
2025-09-17,Harry Sideris,Duke Energy,36,4,0,40,
2025-09-17,Vicki Hollub,Occidental Petroleum,21,16,3,40,
2025-09-17,Lawrence Coben,NRG Energy,6,3,0,9,
2025-09-17,Robert Bradway,Amgen,10,28,2,40,
2025-09-17,John Ketchum,NextEra Energy,24,16,0,40,
2025-09-17,Rainer Blair,Danaher,7,15,2,24,
2025-09-17,Daniel ODay,Gilead Sciences,1,8,1,10,
2025-09-17,Michael Manley,AutoNation,3,6,1,10,
2025-09-17,Carlos Abrams-Rivera,Kraft Heinz,10,23,7,40,
2025-09-17,Philip Gallagher,Avnet,1,5,0,6,
2025-09-17,Gary Dickerson,Applied Materials,6,20,14,40,
2025-09-17,Bob Jordan,Southwest Airlines,9,24,7,40,
2025-09-17,Rick Wurster,Charles Schwab,13,21,5,39,
2025-09-17,Lorenzo Simonelli,Baker Hughes,16,22,2,40,
2025-09-17,Chris Kempczinski,McDonalds,11,21,8,40,
2025-09-17,Christopher Womack,Southern Company,2,8,0,10,
2025-09-17,Michael Miebach,Mastercard,12,25,3,40,
2025-09-17,Joseph Dominguez,Constellation Energy,15,9,1,25,
2025-09-17,Christopher Swift,The Hartford,14,22,4,40,
2025-09-17,Patricia Poppe,PG&E,7,13,2,22,
2025-09-17,Bom Kim,Coupang,8,30,2,40,
2025-09-17,Ezra Yacob,EOG Resources,24,14,2,40,
2025-09-17,Jim Vena,Union Pacific,15,24,1,40,
2025-09-17,Matt Schroeder,Rite Aid,3,34,3,40,
2025-09-17,Tony Spring,Macys,9,26,5,40,
2025-09-17,Anthony Capuano,Marriott International,11,26,3,40,
2025-09-17,Raymond E Scott,Lear Corporation,4,6,0,10,
2025-09-17,William Stengel II,Genuine Parts,0,4,0,4,
2025-09-17,Heidi Petz,Sherwin-Williams,9,27,2,38,
2025-09-17,Jeff Miller,Halliburton,10,24,6,40,
2025-09-17,Kathleen Quirk,Freeport-McMoRan,13,17,2,32,
2025-09-17,Michael Rapino,Live Nation Entertainment,13,24,3,40,
2025-09-17,John Doyle,Marsh & McLennan,9,6,1,16,
2025-09-17,Lisa Su,Advanced Micro Devices,16,18,6,40,
2025-09-17,Frank Holding,First Citizens BancShares,10,16,2,28,
2025-09-17,John Engel,WESCO International,4,15,1,20,
2025-09-17,David Gitlin,Carrier Global,14,24,2,40,
2025-09-17,Lourenco Goncalves,Cleveland-Cliffs,5,22,13,40,
2025-09-17,Calvin G Butler Jr,Exelon,6,4,0,10,
2025-09-17,Joseph Bae,KKR & Co,8,7,1,16,
2025-09-17,Christine Leahy,CDW,0,9,2,11,
2025-09-17,Glenn Fogel,Booking Holdings,11,23,6,40,
2025-09-17,Brian Doubles,Synchrony Financial,3,7,2,12,
2025-09-17,Earl Austin,Quanta Services,2,5,1,8,
2025-09-17,Christian Ulbrich,Jones Lang LaSalle,8,15,0,23,
2025-09-17,Saumya Sutaria,Tenet Healthcare,6,2,1,9,
2025-09-17,William Gifford,Altria Group,2,7,1,10,
2025-09-17,Kevin Lobo,Stryker,12,25,3,40,
2025-09-17,Michael Hsu,Kimberly-Clark,5,6,0,11,
2025-09-17,Jack Fusco,Cheniere Energy,19,18,3,40,
2025-09-17,James Conroy,Ross Stores,4,15,0,19,
2025-09-17,Anthony Smurfit,Smurfit Westrock,3,5,0,8,
2025-09-17,Jeffrey Harmening,General Mills,3,18,5,26,
2025-09-17,Mark Stewart,Goodyear Tire & Rubber,3,36,1,40,
2025-09-17,Bob Eddy,BJs Wholesale Club,6,20,3,29,
2025-09-17,Peter Arduini,GE HealthCare Technologies,3,8,0,11,
2025-09-17,Noel Wallace,Colgate-Palmolive,10,19,2,31,
2025-09-17,Marc Bitzer,Whirlpool,11,15,14,40,
2025-09-17,Chris Kubasik,L3Harris Technologies,6,13,1,20,
2025-09-17,Shantanu Narayen,Adobe,18,20,1,39,
2025-09-17,Thomas Polen,Becton Dickinson,6,4,0,10,
2025-09-17,Richard P Dealy,Pioneer Natural Resources,7,3,0,10,
2025-09-17,Ravi Kumar S,Cognizant Technology Solutions,11,19,3,33,
2025-09-17,Andrew Clyde,Murphy USA,14,25,1,40,
2025-09-17,Mike Lyons,Fiserv,4,12,0,16,
2025-09-17,Jennifer Parmentier,Parker-Hannifin,3,14,0,17,
2025-09-17,William Fehrman,American Electric Power,3,7,0,10,
2025-09-17,Andrew Silvernail,International Paper,6,24,0,30,
2025-09-17,Jonas Prising,ManpowerGroup,7,22,2,31,
2025-09-17,John Zillmer,Aramark,7,13,2,22,
2025-09-17,Mark Millett,Steel Dynamics,15,2,0,17,
2025-09-17,Dan Amos,Aflac,14,17,9,40,
2025-09-17,Tony Cheng,Reinsurance Group of America,2,10,2,14,
2025-09-17,Karsanbhai,Emerson Electric,7,15,2,24,
2025-09-17,Ronald P OHanley,State Street,0,4,0,4,
2025-09-17,Timothy Knavish,PPG Industries,1,1,0,2,
2025-09-17,David Burritt,United States Steel,10,19,10,39,
2025-09-17,Maria Black,Automatic Data Processing,4,4,1,9,
2025-09-17,Daryl Kenningham,Group 1 Automotive,13,24,3,40,
2025-09-17,Robert Blue,Dominion Energy,26,12,2,40,
2025-09-17,Larry Fink,BlackRock,9,23,8,40,
2025-09-17,Pierce Norton II,Oneok,5,3,1,9,
2025-09-17,David Bozeman,CH Robinson Worldwide,2,8,0,10,
2025-09-17,Haviv Ilan,Texas Instruments,12,26,2,40,
2025-09-17,Michael Bender,Kohls,2,23,13,38,
2025-09-17,Philip Daniele III,AutoZone,0,2,0,2,
2025-09-17,Timothy Archer,Lam Research,2,8,0,10,
2025-09-17,Charles Magro,Corteva,5,3,1,9,
2025-09-17,Rick Lanoha,Peter Kiewit Sons,0,2,0,2,
2025-09-17,Peter Jackson,Builders FirstSource,5,11,1,17,
2025-09-17,Martin Schroeter,Kyndryl,9,31,0,40,
2025-09-17,Hamid Akhavan,EchoStar,6,26,8,40,
2025-09-17,Bill Westrate,American Family Insurance,10,16,2,28,
2025-09-17,Avigal Soreq,Delek US,5,8,5,18,
2025-09-17,Beth Ford,Land OLakes,4,6,1,11,
2025-09-17,Walker Martin,Sempra,0,1,0,1,
2025-09-17,Eric Slifka,Global Partners,11,22,7,40,
2025-09-17,DG Macpherson,WW Grainger,2,7,0,9,
2025-09-17,Bob Pragada,Jacobs Solutions,5,10,0,15,
2025-09-17,Pedro Pizarro,Edison International,16,6,18,40,
2025-09-17,William Hornbuckle,MGM Resorts International,8,25,1,34,
2025-09-17,Andrew McMahon,Guardian Life insurance,6,12,0,18,
2025-09-17,Christopher OHerlihy,Illinois Tool Works,0,1,0,1,
2025-09-17,James Cracchiolo,Ameriprise Financial,2,22,2,26,
2025-09-17,Ryan Marshall,PulteGroup,9,15,9,33,
2025-09-17,Matthew Meloy,Targa Resources,6,4,0,10,
2025-09-17,Michael Rhodes,Ally Financial,9,27,4,40,
2025-09-17,Joseph Fadool,BorgWarner,4,11,0,15,
2025-09-17,St√©phane de La Faverie,Est√©e Lauder,17,20,3,40,
2025-09-17,Benjamin Tisch,Loews,2,6,0,8,
2025-09-17,Brad Beckham,OReilly Automotive,2,7,0,9,
2025-09-17,Thomas Gayner,Markel Group,3,7,0,10,
2025-09-17,Donald Allan,Stanley Black & Decker,10,28,2,40,
2025-09-17,Sanjay Mehrotra,Micron Technology,18,21,1,40,
2025-09-17,James Breuer,Fluor,1,1,1,3,
2025-09-17,Thomas Bell,Leidos,8,17,2,27,
2025-09-17,Scott Smith,Viatris,6,4,0,10,
2025-09-17,Kimberly Dang,Kinder Morgan,9,1,0,10,
2025-09-17,Christophe Beck,Ecolab,20,20,0,40,
2025-09-17,Brent Shafer,Baxter International,1,9,0,10,
2025-09-17,Clay Gaspar,Devon Energy,21,1,0,22,
2025-09-17,Steven Cahillane,Kellanova,2,7,0,9,
2025-09-17,Raul Nicholas Vargas Ochoa,Farmers Insurance Exchange,0,0,0,0,
2025-09-17,Darren Rebelez,Caseys General Stores,4,5,0,9,
2025-09-17,Ari Bousbib,IQVIA,6,14,0,20,
2025-09-17,Jon Vander Ark,Republic Services,11,18,11,40,
2025-09-17,Timothy Cofer,Keurig Dr Pepper,2,5,1,8,
2025-09-17,Karla Lewis,Reliance Inc,5,5,0,10,
2025-09-17,David Hult,Asbury Automotive Group,8,31,1,40,
2025-09-17,Darryl Button,Pacific Life,0,8,0,8,
2025-09-17,James Burke,Vistra,6,4,0,10,
2025-09-17,John Barrett,Western & Southern Financial,12,26,2,40,
2025-09-17,William Krueger,The Andersons Inc,0,2,0,2,
2025-09-17,Erik Nordstrom,Nordstrom,8,27,5,40,
2025-09-17,John Wren,Omnicom Group,13,21,6,40,
2025-09-17,Stephanie Ferris,Fidelity National Information Services,15,23,2,40,
2025-09-17,Timothy Cawley,Consolidated Edison,4,5,0,9,
2025-09-17,Joseph Hinrichs,CSX,7,8,1,16,
2025-09-17,Troy Rudd,AECOM,7,25,4,36,
2025-09-17,Kathleen Johnson,Lumen Technologies,4,5,1,10,
2025-09-17,Harry Lawton III,Tractor Supply,1,0,0,1,
2025-09-17,Raul Fernandez,DXC Technology,3,23,1,27,
2025-09-17,Eric Hansotia,AGCO,13,25,2,40,
2025-09-17,David Bruton Smith,Sonic Automotive,3,6,9,18,
2025-09-17,Sasan Goodarzi,Intuit,10,26,4,40,
2025-09-17,Matthew Flannery,United Rentals,31,1,0,32,
2025-09-17,Marc Miller,Universal Health Services,3,24,3,30,
2025-09-17,Michael Mahoney,Boston Scientific,11,25,0,36,
2025-09-17,Judith Marks,Otis Worldwide,2,4,0,6,
2025-09-17,Robert Frenzel,Xcel Energy,3,4,1,8,
2025-09-17,Penny Pennington,Edward Jones,6,28,6,40,
2025-09-17,Daniel Fisher,Ball,1,17,6,24,
2025-09-17,Justin Jude,LKQ,4,5,1,10,
2025-09-17,James Blackledge,Mutual of Omaha,1,30,2,33,
2025-09-17,Bruce Bodine,Mosaic,3,6,0,9,
2025-09-17,Scott Donnelly,Textron,10,27,3,40,
2025-09-17,Adam Schechter,Labcorp Holdings,1,6,1,8,
2025-09-17,Deanna Strable-Soethout,Principal Financial,1,8,0,9,
2025-09-17,Leonard Schleifer,Regeneron Pharmaceuticals,6,27,7,40,
2025-09-17,Paul Shoukry,Raymond James Financial,15,24,1,40,
2025-09-17,Lauren Hobart,Dicks Sporting Goods,11,25,4,40,
2025-09-17,Jamie Whisnant,Auto-Owners Insurance,0,2,0,2,
2025-09-17,Ariane Gorin,Expedia,10,29,1,40,
2025-09-17,Shelley Simpson,JB Hunt Transport Services,8,28,4,40,
2025-09-17,Ren√© Jones,M&T Bank,10,25,5,40,
2025-09-17,Gerardo Norcia,DTE Energy,6,2,1,9,
2025-09-17,Andr√©s Gluski,AES,15,19,1,35,
2025-09-17,Timothy Spence,Fifth Third Bancorp,5,5,0,10,
2025-09-17,Eduardo Menezes,Air Products & Chemicals,3,6,1,10,
2025-09-17,Wendell Weeks,Corning,15,24,1,40,
2025-09-17,Anthony Guzzi,EMCOR Group,3,6,1,10,
2025-09-17,Adam Norwitt,Amphenol,2,17,0,19,
2025-09-17,Jean-Marc Gilson,Westlake Corporation,2,4,1,7,
2025-09-17,Lori Koch,DuPont,6,17,0,23,
2025-09-17,Derek Chang,Liberty Media,36,3,1,40,
2025-09-17,Martina Cheung,S&P Global,10,25,0,35,
2025-09-17,Tim Hingtgen,Community Health Systems,10,28,2,40,
2025-09-17,Brian Tierney,FirstEnergy,6,19,3,28,
2025-09-17,Rick McKenney,Unum Group,6,5,0,11,
2025-09-17,Stanley Bergman,Henry Schein,14,25,1,40,
2025-09-17,Tiang Yew Tan,Western Digital,1,3,0,4,
2025-09-17,Vincent Roche,Analog Devices,13,23,4,40,
2025-09-17,Sean Connolly,Conagra Brands,8,30,2,40,
2025-09-17,Bruce Van Saun,Citizens Financial Group,12,25,3,40,
2025-09-17,Mark George,Norfolk Southern,17,20,3,40,
2025-09-17,Andrew Marsh,Entergy,4,4,0,8,
2025-09-17,Robert Berkley,WR Berkley,8,29,3,40,
2025-09-17,Javier Rodriguez,DaVita,13,14,1,28,
2025-09-17,Michael OGrady,Northern Trust,3,1,0,4,
2025-09-17,James Snee,Hormel Foods,4,29,1,34,
2025-09-17,Timothy J Donahue,Crown Holdings,2,9,0,11,
2025-09-17,Joseph Ferraro,Avis Budget,3,6,1,10,
2025-09-17,Niraj Shah,Wayfair,5,26,9,40,
2025-09-17,Jos√© Mas,MasTec,6,14,0,20,
2025-09-17,Joseph Nolan,Eversource Energy,5,3,1,9,
2025-09-17,Thomas Palmer,Newmont,5,5,0,10,
2025-09-17,Robert Sanchez,Ryder System,9,7,0,16,
2025-09-17,Michael Nolan,Fidelity National Financial,2,1,0,3,
2025-09-17,Gavin Hattersley,Molson Coors Beverage,6,28,6,40,
2025-09-17,Thomas Reeg,Caesars Entertainment,5,5,0,10,
2025-09-17,Ellen Cooper,Lincoln National,3,7,0,10,
2025-09-17,Bracken Darrell,VF Corporation,8,29,3,40,
2025-09-17,Erik Fyrwald,International Flavors & Fragrances,6,10,3,19,
2025-09-17,Christopher Kastner,Huntington Ingalls Industries,3,4,1,8,
2025-09-17,Shane OKelly,Advance Auto Parts,0,6,0,6,
2025-09-17,Ralph LaRossa,Public Service Enterprise Group,11,17,0,28,
2025-09-17,Kecia Steelman,Ulta Beauty,33,6,1,40,
2025-09-17,Michele Buck,Hershey,6,32,2,40,
2025-09-17,Sumit Singh,Chewy,13,23,4,40,
2025-09-17,Steven Vondran,American Tower,4,6,0,10,
2025-09-17,Jeffrey Lorberbaum,Mohawk Industries,11,5,1,17,
2025-09-17,Keith Demmings,Assurant,5,8,0,13,
2025-09-17,Robert Martin,Thor Industries,4,5,1,10,
2025-09-17,Kathleen Mazzarella,Graybar Electric,1,6,2,9,
2025-09-17,Joey Wat,Yum China,15,22,3,40,
2025-09-17,Scott Richardson,Celanese,6,14,2,22,
2025-09-17,David Rawlinson II,QVC,8,15,2,25,
2025-09-17,Alan Armstrong,Williams,24,12,4,40,
2025-09-17,Philippe Krakowsky,Interpublic Group,13,24,3,40,
2025-09-17,Brendan McCracken,Ovintiv,6,5,0,11,
2025-09-17,Andrew Teno,Icahn Enterprises,4,6,0,10,
2025-09-17,Stephen Steinour,Huntington Bancshares,3,8,0,11,
2025-09-17,Timothy NeCastro,Erie Insurance,3,7,0,10,
2025-09-17,Ernest Garcia III,Carvana,23,13,4,40,
2025-09-17,R Bruce McDonald,Dana Incorporated,3,8,1,12,
2025-09-17,William Oplinger,Alcoa Corporation,2,6,1,9,
2025-09-17,Mark Pearson,Equitable,8,7,0,15,
2025-09-17,Richard Wallace,KLA,4,4,0,8,
2025-09-17,Ricardo Cardenas,Darden Restaurants,4,3,1,8,
2025-09-17,Mikael Bratt,Autoliv,5,8,2,15,
2025-09-17,Benito Minicucci,Alaska Air,2,3,2,7,
2025-09-17,Christopher Gorman,KeyCorp,5,5,0,10,
2025-09-17,Robert Goldstein,Las Vegas Sands,4,30,6,40,
2025-09-17,Edward Pesicka,Owens & Minor,3,32,2,37,
2025-09-17,Christopher Nassetta,Hilton Worldwide,8,15,3,26,
2025-09-17,Jamie Iannone,Ebay,17,20,3,40,
2025-09-17,Patrick Gallagher,Arthur J Gallagher,8,30,2,40,
2025-09-17,Rich Steinmeier,LPL Financial,22,16,2,40,
2025-09-17,Stephen Spray,Cincinnati Financial,1,7,1,9,
2025-09-17,Douglas Yearley,Toll Brothers,10,25,5,40,
2025-09-17,Gregory Brown,Motorola Solutions,3,4,1,8,
2025-09-17,Brian Chesky,Airbnb,3,31,6,40,
2025-09-17,Jeffrey Sprecher,Intercontinental Exchange,17,20,3,40,
2025-09-17,Robert Thomson,News Corp,6,31,3,40,
2025-09-17,Scott Boatwright,Chipotle Mexican Grill,10,27,3,40,
2025-09-17,Reshma Kewalramani,Vertex Pharmaceuticals,21,14,5,40,
2025-09-17,Christopher Viehbacher,Biogen,0,26,3,29,
2025-09-17,Malcolm Wilson,GXO Logistics,6,22,0,28,
2025-09-17,Tony Sarsam,SpartanNash,18,20,2,40,
2025-09-17,Michael O‚ÄôSullivan,Burlington Stores,9,27,4,40,
2025-09-17,Teresa Rasmussen,Thrivent Financial for Lutherans,4,1,0,5,
2025-09-17,Eugene Bredow,NVR,0,4,1,5,
2025-09-17,Brian Chambers,Owens Corning,3,14,0,17,
2025-09-17,Rafael Santana,Westinghouse Air Brake Technologies,3,11,1,15,
2025-09-17,John Pfeifer,Oshkosh Corporation,3,18,0,21,
2025-09-17,Cameron Bready,Global Payments,8,29,3,40,
2025-09-17,Calvin McDonald,Lululemon athletica,9,30,1,40,
2025-09-17,J Kent Masters,Albemarle Corporation,4,5,0,9,
2025-09-17,Joanna Geraghty,JetBlue Airways,15,18,7,40,
2025-09-17,Robert Steer,Seaboard,1,5,0,6,
2025-09-17,William Newlands,Constellation Brands,0,5,2,7,
2025-09-17,Michael Doss,Graphic Packaging,3,9,1,13,
2025-09-17,Gil West,Hertz,7,24,9,40,
2025-09-17,Malcolm C Roberts,FM Global,2,11,2,15,
2025-09-17,Mick Beekhuizen,Campbell Soup,8,23,0,31,
2025-09-17,Daniel Wall,Expeditors International of Washington,2,4,0,6,
2025-09-17,Gregory Roberts,A-Mark Precious Metals,2,4,1,7,
2025-09-17,Horacio Rozanski,Booz Allen Hamilton,16,19,5,40,
2025-09-17,James Davis,Quest Diagnostics,5,5,0,10,
2025-09-17,Dennis Mathew,Altice,5,24,7,36,
2025-09-17,Stefan Larsson,PVH,11,24,5,40,
2025-09-17,Mark Costa,Eastman Chemical,6,15,4,25,
2025-09-17,Joyce Mullen,Insight Enterprises,5,12,0,17,
2025-09-17,John Turner,Regions Financial,22,16,2,40,
2025-09-17,Julian G Francis,Beacon Roofing Supply,0,1,0,1,
2025-09-17,Blake Moret,Rockwell Automation,12,26,2,40,
2025-09-17,Mike Speetzen,Polaris Inc,3,17,2,22,
2025-09-17,William McDermott,ServiceNow,3,5,0,8,
2025-09-17,Jure Sola,Sanmina,2,11,1,14,
2025-09-17,Bob Flexon,UGI Utilities Inc,0,1,0,1,
2025-09-17,Scott Lauber,WEC Energy,13,7,0,20,
2025-09-17,Jon Rousseau,BrightSpring Health Services,20,19,1,40,
2025-09-17,Todd Schneider,Cintas,11,18,1,30,
2025-09-17,Peter Matt,Commercial Metals,5,3,1,9,
2025-09-17,Robert D Lawler,Continental Resources,0,0,0,0,
2025-09-17,Domenic Dell‚ÄôOsso Jr,Expand Energy,4,0,0,4,
2025-09-17,Jason P Wells,CenterPoint Energy,7,4,1,12,
2025-09-17,H Michael Krimbill,NGL Energy Partners,5,1,0,6,
2025-09-17,Tony Xu,DoorDash,15,18,7,40,
2025-09-17,Clay Williams,NOV,7,17,4,28,
2025-09-17,Kristin Peck,Zoetis,11,19,1,31,
2025-09-17,Mark Smucker,JM Smucker,12,22,6,40,
2025-09-17,Steve Sanghi,Microchip Technology,6,30,4,40,
2025-09-17,Richard Tobin,Dover Corporation,4,3,0,7,
2025-09-17,Kaes Van‚Äôt Hof,Diamondback Energy,22,14,3,39,
2025-09-17,Deon Stander,Avery Dennison,0,13,0,13,
2025-09-17,Vincent Sorgi,PPL,8,9,1,18,
2025-09-17,Hassane El-Khoury,ON Semiconductor,3,16,4,23,
2025-09-17,Arie Kotler,ARKO,4,23,0,27,
2025-09-17,William Monteleone,Par Pacific,2,6,2,10,
2025-09-17,John Christmann IV,APA,6,4,0,10,
2025-09-17,Adaire Fox-Martin,Equinix,17,21,2,40,
2025-09-17,Joseph M Otting,Flagstar Financial,3,5,2,10,
2025-09-17,Mary Dillon,Foot Locker,10,25,5,40,
2025-09-17,James Zallie,Ingredion,5,5,0,10,
2025-09-17,Christopher Peterson,Newell Brands,0,9,1,10,
2025-09-17,Scott Salmirs,ABM Industries,5,4,1,10,
2025-09-17,Christopher Hilger,Securian Financial,0,6,0,6,
2025-09-17,Hamid Moghadam,Prologis,8,27,5,40,
2025-09-17,Stephen Schwarzman,Blackstone,11,20,8,39,
2025-09-17,Robert Greenberg,Skechers USA,5,24,3,32,
2025-09-17,Keith Allman,Masco,3,9,0,12,
2025-09-17,Rusty Rush,Rush Enterprises,15,22,3,40,
2025-09-17,Jennifer Johnson,Franklin Resources,1,8,1,10,
2025-09-17,Gerry P Smith,ODP Business Solutions,0,0,0,0,
2025-09-17,Carl Lindner lll,American Financial,0,0,0,0,
2025-09-17,Mark Kowlzan,Packaging Corp of America,0,9,1,10,
2025-09-17,Thomas Hill,Vulcan Materials,4,7,2,13,
2025-09-17,Milan Galik,Interactive Brokers,7,19,2,28,
2025-09-17,Laura Alber,Williams-Sonoma,15,21,4,40,
2025-09-17,Mario Harik,XPO,8,31,1,40,
2025-09-17,Devin Stockfish,Weyerhaeuser,5,5,0,10,
2025-09-17,Thomas J McInerney,Genworth Financial,2,6,1,9,
2025-09-17,Garrick Rochow,CMS Energy,9,3,1,13,
2025-09-17,Toni Townes-Whitley,Science Applications International,11,19,1,31,
2025-09-17,Rich Handler,Jefferies Financial,12,13,2,27,
2025-09-17,Daniel Heaf,Bath & Body Works,16,23,1,40,
2025-09-17,Andrew Wilson,Electronic Arts,11,16,13,40,
2025-09-17,Sheryl Palmer,Taylor Morrison Home,8,10,1,19,
2025-09-17,Ivan Tornos,Zimmer Biomet,9,29,2,40,
2025-09-17,Linda Rendle,Clorox,2,34,3,39,
2025-09-17,Matthew Pine,Xylem Inc,1,9,1,11,
2025-09-17,Heather Lavallee,Voya Financial,6,12,2,20,
2025-09-17,Daniel Florness,Fastenal,2,6,2,10,
2025-09-17,Albert Nahmad,Watsco,2,6,0,8,
2025-09-17,Carl Eschenbach,Workday,13,18,9,40,
2025-09-17,Craig Smiddy,Old Republic International,1,7,1,9,
2025-09-17,Frank C Sullivan,RPM International,3,8,1,12,
2025-09-17,Matthew Missad,UFP Industries,8,2,0,10,
2025-09-17,Martin J Lyons,Ameren,3,3,1,7,
2025-09-17,Adam W Miller,Knight Swift Transportation,1,2,1,4,
2025-09-17,Rodney Sacks,Monster Beverage,13,25,1,39,
2025-09-17,Gary Guthart,Intuitive Surgical,10,24,6,40,
2025-09-17,Charles Liang,Super Micro Computer,34,6,0,40,
2025-09-17,Christopher Caldwell,Concentrix,3,5,0,8,
2025-09-17,Gordon J Hardie,O-I Glass,1,5,0,6,
2025-09-17,David Gibbs,Yum Brands,3,37,0,40,
2025-09-17,Steve Henry,Domtar,4,6,0,10,
2025-09-17,Chuck Treadway,CommScope,8,18,3,29,
2025-09-17,Rob Vitale,Post Holdings,1,13,5,19,
2025-09-17,Steven J Moskowitz,Crown Castle,2,5,3,10,
2025-09-17,Emmanuel Ligner,Avantor,2,10,1,13,
2025-09-17,Stuart Bradie,KBR,14,16,4,34,
2025-09-17,Carrie Wheeler,Opendoor Technologies,10,25,5,40,
2025-09-17,Russell Becker,APi Group,4,4,0,8,
2025-09-17,Toby Rice,EQT,25,12,3,40,
2025-09-17,Jesse Arenivas,EnLink Midstream,8,8,0,16,
2025-09-17,Nikesh Arora,Palo Alto Networks,6,25,9,40,
2025-09-17,Steven Bandrowczak,Xerox,2,6,2,10,
2025-09-17,Vicente Reynal,Ingersoll Rand,8,30,0,38,
2025-09-17,William T Dillard II,Dillards,4,3,2,9,
2025-09-17,C Howard Nye,Martin Marietta Materials,4,3,3,10,
2025-09-17,Giordano Albertazzi,Vertiv,15,19,4,38,
2025-09-17,Stephane Bancel,Moderna,9,21,10,40,
2025-09-17,Nate R Jorgensen,Boise Cascade,0,0,0,0,
2025-09-17,Jack Sinclair,Sprouts Farmers Market,17,23,0,40,
2025-09-17,Padraig McDonnell,Agilent Technologies,7,11,0,18,
2025-09-17,Kenneth T Lane,Olin,1,1,0,2,
2025-09-17,Randall C Stuewe,Darling Ingredients,27,1,0,28,
2025-09-17,R Howard Coker,Sonoco Products,1,7,1,9,
2025-09-17,John Mengucci,CACI International,23,16,1,40,
2025-09-17,Mark Witkowski,Core & Main,1,13,2,16,
2025-09-17,Lee M Tillman,Marathon Oil,4,5,0,9,
2025-09-17,Mark Hoplamazian,Hyatt Hotels,15,20,5,40,
2025-09-17,David S Chernow,Select Medical,0,9,1,10,
2025-09-17,Brendan M Foley,McCormick & Company,0,8,0,8,
2025-09-17,Joanne Crevoiserat,Tapestry,15,21,4,40,
2025-09-17,John Plant,Howmet Aerospace,4,13,3,20,
2025-09-17,Shankh Mitra,Welltower,17,21,2,40,
2025-09-17,W Anthony Will,CF Industries,3,5,0,8,
2025-09-17,David A Zapico,Ametek,2,16,1,19,
2025-09-17,Kevin Stein,TransDigm,11,10,2,23,
2025-09-17,Craig Billings,Wynn Resorts,14,24,2,40,
2025-09-17,William J Way,Southwestern Energy,2,0,0,2,
2025-09-17,Giel Rutten,Amkor Technology,3,6,1,10,
2025-09-17,Paul Sarvadi,Insperity,4,5,0,9,
2025-09-17,Donald Zurbay,Patterson Companies Inc,1,5,0,6,
2025-09-17,Rob Sharps,T Rowe Price,16,19,5,40,
2025-09-17,Patrice Louvet,Ralph Lauren,11,22,7,40,
2025-09-17,Jeffrey Mezger,KB Home,3,29,7,39,
2025-09-17,David M Foulkes,Brunswick,0,9,0,9,
2025-09-17,M Keith Waddell,Robert Half,4,6,0,10,
2025-09-17,Jay Snowden,PENN Entertainment,18,18,4,40,
2025-09-17,George Kurian,NetApp,15,22,3,40,
2025-09-17,Kevin Ali,Organon,9,15,2,26,
2025-09-17,Joel D Anderson,Petco Health and Wellness,1,8,0,9,
2025-09-17,Louis V Pinkham,Regal Rexnord,0,1,0,1,
2025-09-17,Jay Geldmacher,Resideo Technologies,10,6,0,16,
2025-09-17,Marcus Lemonis,Camping World,9,22,9,40,
2025-09-17,Peter R Huntsman,Huntsman,6,11,3,20,
2025-09-17,Hillary Super,Victorias Secret,11,4,7,22,
2025-09-17,Michelle Gass,Levi Strauss,11,25,3,39,
2025-09-17,Neil Hunn,Roper Technologies,2,21,0,23,
2025-09-17,Steven P Lawrence,Academy Sports and Outdoors,1,1,0,2,
2025-09-17,Phillippe Lord,Meritage Homes,8,17,0,25,
2025-09-17,David C Dauch,American Axle & Manufacturing,6,8,2,16,
2025-09-17,Olumide Soroye,Fortive,1,8,0,9,
2025-09-17,Adena Friedman,Nasdaq,14,22,4,40,
2025-09-17,Tim Gokey,Broadridge Financial Solutions,4,13,1,18,
2025-09-17,Patrick M Shanahan,Spirit AeroSystems,1,9,0,10,
2025-09-17,Robert Kyncl,Warner Music Group,10,28,2,40,
2025-09-17,Denise Dignam,Chemours,4,16,3,23,
2025-09-17,Jim DeVries,ADT,9,6,1,16,
2025-09-17,Bernard Zovighian,Edwards Lifesciences,6,7,2,15,
2025-09-17,Mark E Seaton,First American Financial,1,9,0,10,
2025-09-17,John C Roche,Hanover Insurance Group,7,13,0,20,
2025-09-17,Adam J Greenlee,Silgan,0,4,0,4,
2025-09-17,Jayne Hrdlicka,Endeavor Group,0,1,0,1,
2025-09-17,Robert Fauber,Moodys Corporation,0,6,0,6,
2025-09-17,Thomas E Jorden,Coterra Energy,9,0,0,9,
2025-09-17,Eugene A Hall,Gartner,1,9,0,10,
2025-09-17,Kevin Plank,Under Armour,10,25,2,37,
2025-09-17,James W Lanning,Ingles Markets,3,3,0,6,
2025-09-17,Matthew T Farrell,Church & Dwight,7,7,0,14,
2025-09-17,Kevin M Freeman,Old Dominion Freight Line,0,0,0,0,
2025-09-17,Joe Shoen,U-Haul,14,21,4,39,
2025-09-17,Mark Bertolini,Oscar Health,13,18,8,39,
2025-09-17,Jayshree Ullal,Arista Networks,20,19,1,40,
2025-09-17,Sassine Ghazi,Synopsys,12,24,4,40,
2025-09-17,Jochen Zeitz,Harley-Davidson,5,27,8,40,
2025-09-17,Nick Jeffery,Frontier Communications,10,24,0,34,
2025-09-17,Thomas Edward McCormick,Primoris Services,0,6,0,6,
2025-09-17,D Christian Koch,Carlisle Companies,0,4,0,4,
2025-09-17,David E Simon,Simon Property Group,3,6,1,10,
2025-09-17,Stephen Bratspies,Hanesbrands,3,11,2,16,
2025-09-17,Ryan M. Schneider,Anywhere Real Estate Inc,0,1,0,1,
2025-09-17,George Bobb III,Teledyne Technologies,1,4,0,5,
2025-09-17,Terrence A Duffy,CME Group,6,9,1,16,
2025-09-17,Rami Rahim,Juniper Networks,12,26,2,40,
2025-09-17,Sue Nabi,Coty,14,19,7,40,
2025-09-17,Peter D Arvan,Pool Corporation,3,6,0,9,
2025-09-17,David Campbell,Evergy,14,8,0,22,
2025-09-17,Matthew J Murphy,Marvell Technology,2,6,1,9,
2025-09-17,Lloyd Yates,NiSource,5,5,0,10,
2025-09-17,William C Stone,SS&C Technologies,3,5,1,9,
2025-09-17,Mark Rourke,Schneider National,11,15,0,26,
2025-09-17,Andrew Anagnost,Autodesk,11,22,7,40,
2025-09-17,Dustin Semach,Sealed Air Corporation,0,9,0,9,
2025-09-17,William L Meaney,Iron Mountain,3,13,0,16,
2025-09-17,Andy P Power,Digital Realty Trust,0,0,0,0,
2025-09-17,Satish Dhanasekaran,Keysight Technologies,3,10,0,13,
2025-09-17,Frank M Svoboda,Globe Life,1,6,3,10,
2025-09-17,Carey A Smith,Parsons Corporation,0,2,0,2,
2025-09-17,Ynon Kreiz,Mattel,8,26,6,40,
2025-09-17,Karen S Haller,Southwest Gas,3,6,0,9,
2025-09-17,Terrance Williams,TruStage,5,5,1,11,
2025-09-17,Eric W Gerstenberg,Clean Harbors,5,1,1,7,
2025-09-17,Gunner Smith,Cornerstone Building Brands,1,7,2,10,
2025-09-17,Gerben W Bakker,Hubbell,1,5,0,6,
2025-09-17,Dave Davis,Spirit Airlines,4,35,1,40,
2025-09-17,Michael J Smith,Lamb Weston,0,7,3,10,
2025-09-17,Strauss Zelnick,Take-Two Interactive Software,13,16,11,40,
2025-09-17,John C Turner Jr,GMS,2,8,0,10,
2025-09-17,David M OMalley,Penn Mutual Life Insurance,0,1,0,1,
2025-09-17,Frank A Lonegro,Landstar System,1,4,0,5,
2025-09-17,James F Risoleo,Host Hotels & Resorts,4,16,0,20,
2025-09-17,Ken Xie,Fortinet,12,20,8,40,
2025-09-17,Doug Shulman,OneMain,4,6,0,10,
2025-09-17,Ryan Cohen,GameStop,12,22,6,40,
2025-09-17,Mark W Begor,Equifax,2,12,0,14,
2025-09-17,Jay L Schottenstein,American Eagle Outfitters,7,17,0,24,
2025-09-17,Curtis C Farmer,Comerica,4,8,0,12,
2025-09-17,Ole Rosgaard,Greif,3,14,0,17,
2025-09-17,Brian E Lane,Comfort Systems USA,10,0,0,10,
2025-09-17,Robert M Buck,TopBuild,4,6,0,10,
2025-09-17,Ralph Andretta,Bread Financial,3,9,0,12,
2025-09-17,Jim Anderson,Coherent,5,32,1,38,
2025-09-17,Walter C. D. Carlson,Telephone & Data Systems,0,2,0,2,
2025-09-17,Ronald Kruszewski,Stifel Financial,7,3,0,10,
2025-09-17,Richard Hayne,Urban Outfitters,11,20,8,39,
2025-09-17,Simon Meester,Terex,4,7,0,11,
2025-09-17,Edward J Lehner,Ryerson Holding,0,3,0,3,
2025-09-17,Nicholas T Pinchuk,Snap-on,2,7,0,9,
2025-09-17,Ryals McMullian,Flowers Foods,5,26,3,34,
2025-09-17,D Bryan Jordan,First Horizon,3,7,1,11,
2025-09-17,John B Gibson,Paychex,4,5,1,10,
2025-09-17,Chris Cocks,Hasbro,12,19,9,40,
2025-09-17,Pete McPartland,Sentry Insurance Group,0,2,0,2,
2025-09-17,Michael Arougheti,Ares Management,16,22,2,40,
2025-09-17,Alok Maskara,Lennox International,5,3,1,9,
2025-09-17,James C Grech,Peabody Energy,3,0,0,3,
2025-09-17,Joseph P Lacher Jr,Kemper,3,19,3,25,
2025-09-17,Perry A Sook,Nexstar Media Group,9,26,1,36,
2025-09-17,Wade Davis,TelevisaUnivision,12,27,1,40,
2025-09-17,Scott L Thompson,Tempur Sealy International,0,8,0,8,
2025-09-17,Mike Simonds,TriNet Group,0,9,0,9,
2025-09-17,B Andrew Rose,Worthington Enterprises,0,1,0,1,
2025-09-17,Bruce L Caswell,Maximus,3,3,0,6,
2025-09-17,Robert L Reffkin,Compass,1,5,0,6,
2025-09-17,Mark Eubanks,Brinks Company,1,2,1,4,
2025-09-17,Peter Quigley,Kelly Services inc,1,8,0,9,
2025-09-17,David L Yowan,Navient,1,0,0,1,
2025-09-17,Mary E Kipp,Puget Sound Energy,3,0,1,4,
2025-09-17,Adam Aron,AMC Entertainment,17,18,5,40,
2025-09-17,Mark J Tarr,Encompass Health,2,3,1,6,
2025-09-17,Liam K Griffin,Skyworks Solutions,1,4,1,6,
2025-09-17,Richard G Kyle,Timken,2,12,1,15,
2025-09-17,Ron Gusek,Liberty Energy,25,1,0,26,
2025-09-17,John E Geller Jr,Marriott Vacations Worldwide,6,6,0,12,
2025-09-17,Karl G. Glassman,Leggett & Platt,0,3,0,3,
2025-09-17,Bruce K Thorn,Big Lots,2,7,1,10,
2025-09-17,Jonathan H Weis,Weis Markets,11,28,0,39,
2025-09-17,Jeffrey B Guldner,Pinnacle West Capital,1,1,0,2,
2025-09-17,Arkadiy Dobkin,EPAM Systems,9,14,1,24,
2025-09-17,Paul M Rady,Antero Resources,3,8,0,11,
2025-09-17,Michael Spanos,Bloomin Brands,1,8,1,10,
2025-09-17,Nicole A Kivisto,MDU Resources Group,4,6,0,10,
2025-09-17,Gerald L Morgan,Texas Roadhouse,2,3,4,9,
2025-09-17,Gabriel Tirador,Mercury General,5,3,2,10,
2025-09-17,Nicholas I Fink,Fortune Brands Innovations,4,6,0,10,
2025-09-17,Paul E Burdiss,Zions Bancorp,1,1,0,2,
2025-09-17,William J Christensen,JELD-WEN Holding,4,5,0,9,
2025-09-17,Evan Spiegel,Snap Inc,19,17,4,40,
2025-09-17,Bill Burns,Zebra Technologies,5,20,1,26,
2025-09-17,Steven Sell,Agilon Health,0,8,0,8,
2025-09-17,Richard M Olson,Toro Company,1,10,0,11,
2025-09-17,Eric S Yuan,Zoom Video Communications,5,7,0,12,
2025-09-17,Dan L Batrack,Tetra Tech,2,4,1,7,
2025-09-17,Joseph D Russell Jr,Public Storage,0,7,0,7,
2025-09-17,Jacob Thaysen,Illumina inc,4,6,1,11,
2025-09-17,Debra A Cafaro,Ventas inc,6,6,0,12,
2025-09-17,Pierre R Brondeau,FMC Corporation,0,4,0,4,
2025-09-17,Judy R McReynolds,ArcBest,5,13,1,19,
2025-09-17,Russell J Weiner,Dominos Pizza inc,0,0,0,0,
2025-09-17,Theodore S Hanson,ASGN,0,0,0,0,
2025-09-17,RJ Scaringe,Rivian Automotive,7,29,4,40,
2025-09-17,Jeffrey N Simmons,Elanco Animal Health,2,6,1,9,
2025-09-17,Tim O Shaughnessy,Graham Holdings Company,2,7,0,9,
2025-09-17,Thomas V Taylor,Floor & Decor,1,2,2,5,
2025-09-17,Neil A Schrimsher,Applied Industrial Technologies,5,22,1,28,
2025-09-17,Robert E Price,PriceSmart,4,6,0,10,
2025-09-17,John David Risher,Lyft,4,4,1,9,
2025-09-17,Gary B Smith,Ciena,4,7,0,11,
2025-09-17,Joey Levin,IAC,7,32,1,40,
2025-09-17,Jim Jacobs,Country Financial,6,5,2,13,
2025-09-17,Devin B McGranahan,Western Union,2,6,0,8,
2025-09-17,R Scott Rowe,Flowserve,5,4,1,10,
2025-09-17,Kenneth A Vecchione,Western Alliance Bancorp,0,0,1,1,
2025-09-17,John C Rademacher,Option Care Health,7,0,0,7,
2025-09-17,Doug Black,SiteOne Landscape Supply,2,14,1,17,
2025-09-17,Oliver G Brewer III,Topgolf Callaway Brands,1,0,0,1,
2025-09-17,Glenn Sanford,eXp World,15,20,5,40,
2025-09-17,Fran Horowitz,Abercrombie & Fitch,15,20,5,40,
2025-09-17,Kevin Akers,Atmos Energy,6,3,0,9,
2025-09-17,Alessandro Maselli,Catalent,3,11,2,16,
2025-09-17,J Powell Brown,Brown & Brown,13,21,6,40,
2025-09-17,Aman Bhutani,GoDaddy,16,22,2,40,
2025-09-17,John C. Griffith,American Water Works,1,4,0,5,
2025-09-17,John J Marchioni,Selective Insurance Group,5,13,3,21,
2025-09-17,Lawson E Whiting,Brown-Forman,2,7,0,9,
2025-09-17,Dave Peacock,Advantage Solutions,22,6,0,28,
2025-09-17,Mick Farrell,ResMed,15,23,2,40,
2025-09-17,Kamal Hathi,Splunk,3,6,0,9,
2025-09-17,Todd Kelsey,Plexus,3,7,0,10,
2025-09-17,Phillip D Yeager,Hub Group,4,5,0,9,
2025-09-17,Steven B Hedlund,Lincoln Electric,5,10,0,15,
2025-09-17,Timothy C Oliver,NCR Atleos,0,1,0,1,
2025-09-17,Bruce Fleming,Calumet,2,7,0,9,
2025-09-17,Daniel S. Peyovich,Dycom Industries,0,4,0,4,
2025-09-17,Avner M Applbaum,Valmont Industries,0,8,0,8,
2025-09-17,Kimberly A Fields,ATI inc,4,8,0,12,
2025-09-17,Khozema Z Shipchandler,Twilio,0,3,1,4,
2025-09-17,Gary C Bhojwani,CNO Financial Group,1,6,1,8,
2025-09-17,William Andrew Hendricks Jr,Patterson-UTI Energy,0,0,0,0,
2025-09-17,Kevin D Hochman,Brinker International,1,2,0,3,
2025-09-17,James C Foster,Charles River Laboratories International,2,8,0,10,
2025-09-17,Rajiv K Prasad,Hyster-Yale,2,5,0,7,
2025-09-17,Eric T Steigerwalt,Brighthouse Financial,0,2,0,2,
2025-09-17,Thomas L Ryan,Service Corp International,3,6,0,9,
2025-09-17,Charles M Nifong Jr,CrossAmerica Partners,0,0,0,0,
2025-09-17,Anirudh Devgan,Cadence,11,27,2,40,
2025-09-17,Andi Owen,MillerKnoll,17,15,8,40,
2025-09-17,Sumit Roy,Realty Income,12,19,2,33,
2025-09-17,Timothy John Fitzgerald,Middleby,0,0,0,0,
2025-09-17,Robert H Schottenstein,M/I Homes,2,8,0,10,
2025-09-17,Stephen P MacMillan,Hologic,1,7,1,9,
2025-09-17,Lisa M Barton,Alliant Energy,2,0,0,2,
2025-09-17,Aaron P Jagdfeld,Generac,2,6,1,9,
2025-09-17,Erik Gershwind,MSC Industrial Direct,2,5,3,10,
2025-09-17,Varun Krishna,Rocket Companies,9,30,1,40,
2025-09-17,Fahmi Karam,Upbound Group,4,2,0,6,
2025-09-17,NADominic Ng,East West Bancorp,0,0,0,0,
2025-09-17,Mark Wang,Hilton Grand Vacations,38,2,0,40,
2025-09-17,Robert J Sheedy Jr,Grocery Outlet Holding,0,0,0,0,
2025-09-17,Simon D Campion,Dentsply Sirona,1,2,0,3,
2025-09-17,Jeremy Wensinger,V2X,6,6,0,12,
2025-09-17,Andrew Rees,Crocs,16,13,11,40,
2025-09-17,David M Maura,Spectrum Brands,6,0,0,6,
2025-09-17,Sachin S Lawande,Visteon,0,0,0,0,
2025-09-17,Neil M Ashe,Acuity Inc,0,2,0,2,
2025-09-17,Lorie L Tekorius,Greenbrier,2,8,0,10,
2025-09-17,John R Ciulla,Webster Financial,4,6,0,10,
2025-09-17,Sean D Keohane,Cabot Corporation,4,4,1,9,
2025-09-17,Drew M Wilkerson,RXO inc,0,0,0,0,
2025-09-17,Daniel E Brown,Chord Energy,1,0,0,1,
2025-09-17,Javier D Ferrer Fernandez,Popular inc,0,0,0,0,
2025-09-17,Olivier Rabiller,Garrett Motion inc,2,8,0,10,
2025-09-17,Ronald N Tutor,Tutor Perini Corporation,2,7,0,9,
2025-09-17,Jeff Liaw,Copart,4,7,0,11,
2025-09-17,Aman Narang,Toast inc,6,5,1,12,
2025-09-17,Joseph M Hogan,Align Technology,2,6,0,8,
2025-09-17,Kevin J Wheeler,A O Smith,0,16,1,17,
2025-09-17,Christopher A Cartwright,TransUnion,2,0,1,3,
2025-09-17,James Kelly,NCR Voyix,2,12,0,14,
2025-09-17,Tom Leighton,Akamai Technologies,16,15,5,36,
2025-09-17,Robert G Painter,Trimble,3,2,0,5,
2025-09-17,Tony Helton,Medical Mutual of Ohio,2,3,1,6,
2025-09-17,Caroline S Grace,AMN Healthcare Services,0,0,0,0,
2025-09-17,Patrick Kaltenbach,Mettler-Toledo International,1,8,0,9,
2025-09-17,Michael L Baur,ScanSource,0,1,0,1,
2025-09-17,Jason Lippert,LCI Industries,5,13,0,18,
2025-09-17,Fredric J Tomczyk,Cboe Global Markets,0,8,1,9,
2025-09-17,Octavio Marquez,Diebold Nixdorf,7,11,1,19,
2025-09-17,Sivasankaran Somasundaram,ChampionX,7,2,0,9,
2025-09-17,Ronald F Clarke,Corpay,0,0,0,0,
2025-09-17,Robert W Pittman,iHeartMedia,5,3,0,8,
2025-09-17,Patrick Zalupski,Dream Finders Homes,22,16,2,40,
2025-09-17,Keith E Smith,Boyd Gaming,0,5,0,5,
2025-09-17,Mehran Assadi,NLV Financial,1,1,0,2,
2025-09-17,Barry R Port,Ensign Group,2,5,2,9,
2025-09-17,Denise A Paulonis,Sally Beauty,0,1,0,1,
2025-09-17,Clifford A Skelton,Conduent,0,2,1,3,
2025-09-17,Jean-Michel Ribieras,Sylvamo,2,6,0,8,
2025-09-17,Douglas F Bauer,Tri Pointe Homes,0,8,0,8,
2025-09-17,Shawn OConnell,EnerSys,0,1,0,1,
2025-09-17,Bill Meury,Incyte,7,14,0,21,
2025-09-17,Dale Francescon,Century Communities,1,10,3,14,
2025-09-17,Michael Nierenberg,Rithm Capital,11,19,2,32,
2025-09-17,Michael J Brown,Euronet Worldwide,2,6,0,8,
2025-09-17,Scott Seu,Hawaiian Electric Industries,5,15,1,21,
2025-09-17,Jason D Robins,DraftKings,5,2,1,8,
2025-09-17,Jonathan J Mazelsky,IDEXX Laboratories,1,1,1,3,
2025-09-17,Richard S Swartz,MYR Group,0,0,0,0,
2025-09-17,Stefano Caroti,Deckers Outdoor,2,7,1,10,
2025-09-17,Kevin R Sayer,DexCom,1,6,0,7,
2025-09-17,John T C Lee,MKS Instruments,3,7,0,10,
2025-09-17,Edward B Pitoniak,VICI Properties,1,7,0,8,
2025-09-17,Albert White III,Cooper Cos,0,0,0,0,
2025-09-17,Barry L Biffle,Frontier Airlines,1,5,6,12,
2025-09-17,Robert A Bruggeworth,Qorvo,5,3,0,8,
2025-09-17,Winnie Park,Five Below,9,27,4,40,
2025-09-17,Steven Oakland,TreeHouse Foods,1,12,0,13,
2025-09-17,James S Hagedorn,Scotts Miracle-Gro,1,0,0,1,
2025-09-17,Michael Cannon-Brookes,Atlassian,17,23,0,40,
2025-09-17,Bertrand Loy,Entegris,2,10,1,13,
2025-09-17,William E Waltz,Atkore,3,6,0,9,
2025-09-17,Celeste B Mastin,H B Fuller,0,2,0,2,
2025-09-17,Kyle T Larkin,Granite Construction,0,4,0,4,
2025-09-17,Michael J Happe,Winnebago Industries,1,3,1,5,
2025-09-17,Steven H Gunby,FTI Consulting,5,12,0,17,
2025-09-17,Stephan B Tanda,AptarGroup,1,4,2,7,
2025-09-17,Timothy P Boyle,Columbia Sportswear,5,3,2,10,
2025-09-17,Anthony J Wood,Roku,5,3,1,9,
2025-09-17,M Christopher Doyle,Civitas Resources,1,2,0,3,
2025-09-17,Andy Eidson,Alpha Metallurgical Resources,1,5,3,9,
2025-09-17,Andy L Nemeth,Patrick Industries,3,4,0,7,
2025-09-17,Roger W Jenkins,Murphy Oil,4,13,0,17,
2025-09-17,Kevin S Blair,Synovus Financial,7,3,0,10,
2025-09-17,Julie Felss Masino,Cracker Barrel Old Country Store,11,20,9,40,
2025-09-17,David M Overton,Cheesecake Factory,1,9,0,10,
2025-09-17,Nick DeIuliis,CNX Resources,8,3,1,12,
2025-09-17,Christopher Pappas,Chefs Warehouse,3,10,1,14,
2025-09-17,Tod Carpenter,Donaldson Company,2,8,0,10,
2025-09-17,Gregory L Christopher,Mueller Industries,2,5,0,7,
2025-09-17,Rob Saltiel,MRC Global,3,12,1,16,
2025-09-17,Jillian C Evanko,Chart Industries,3,7,0,10,
2025-09-17,Dave Guilmette,Alight Solutions,3,7,0,10,
2025-09-17,Joel Smejkal,Vishay Intertechnology,5,4,1,10,
2025-09-17,Dennis Degner,Range Resources,3,9,0,12,
2025-09-17,Ira D Robbins,Valley National Bancorp,0,2,0,2,
2025-09-17,Bernard Kim,Match Group,14,18,8,40,
2025-09-17,Vincent Pilette,Gen Digital,3,9,0,12,
2025-09-17,Timothy S Crane,Wintrust Financial,2,7,1,10,
2025-09-17,Pat Roche,Moog inc,3,10,2,15,
2025-09-17,Mark R Widmar,First Solar,4,3,3,10,
2025-09-17,Niko Lahanas,Central Garden & Pet,1,12,0,13,
2025-09-17,Chris Osowski,Green Plains inc,4,7,2,13,
2025-09-17,Derek J Leathers,Werner Enterprises,2,8,0,10,
2025-09-17,Adam Foroughi,AppLovin,10,26,4,40,
2025-09-17,Luca Savi,ITT,2,7,0,9,
2025-09-17,Lawrence H Silber,Herc Rentals,0,0,0,0,
2025-09-17,Hilton H Howell Jr,Gray Television,7,19,1,27,
2025-09-17,Eric D Ashleman,IDEX,0,10,0,10,
2025-09-17,Owen D Thomas,Boston Properties,2,7,0,9,
2025-09-17,Kurt Wolf,Pitney Bowes,5,18,1,24,
2025-09-17,Sara E Armbruster,Steelcase,0,1,0,1,
2025-09-17,Charles D. Young,Sun Communities,2,5,0,7,
2025-09-17,Suzanne Foster,AdaptHealth,3,9,1,13,
2025-09-17,Grant E Sims,Genesis Energy,3,2,0,5,
2025-09-17,Laura Prieskorn,Jackson Financial,2,6,2,10,
2025-09-17,Rick L Wessel,FirstCash,5,4,1,10,
2025-09-17,Sherman Miller,Cal-Maine Foods,10,30,0,40,
2025-09-17,Paul A Lang,Arch Resources,4,5,0,9,
2025-09-17,Ashish K Khandpur,Avient,2,6,0,8,
2025-09-17,Shyam K Reddy,BlueLinx,2,7,0,9,
2025-09-17,Christopher S Ripley,Sinclair,1,7,0,8,
2025-09-17,Stacy Kymes,BOK Financial,10,5,0,15,
2025-09-17,James H Walter,Permian Resources,0,0,0,0,
2025-09-17,Jason Murray,PACS Group,5,14,2,21,
2025-09-17,Brian Armstrong,Coinbase Global,14,21,5,40,
2025-09-17,Oscar K Brown,Western Midstream Partners,2,3,0,5,
2025-09-17,Nicholas R Lower,Federated Mutual Insurance,0,0,0,0,
2025-09-17,Morris Goldfarb,G-III Apparel Group,7,28,5,40,
2025-09-17,Mark D Morelli,Vontier,0,3,0,3,
2025-09-17,Matthew J Cox,Matson inc,2,4,0,6,
2025-09-17,David W Grzebinski,Kirby Corporation,1,3,0,4,
2025-09-17,Keith A Harvey,Kaiser Aluminum,5,3,2,10,
2025-09-17,Eric Nyman,Vista Outdoor,4,10,1,15,
2025-09-17,Doug Howe,Designer Brands,5,20,0,25,
2025-09-17,Jerry E Gahlhoff Jr,Rollins inc,0,2,0,2,
2025-09-17,D Scott Barbour,Advanced Drainage Systems,2,3,0,5,
2025-09-17,Sean Gamble,Cinemark,14,24,2,40,
2025-09-17,George Kurtz,CrowdStrike,14,25,1,40,
2025-09-17,Bill Ready,Pinterest,24,16,0,40,
2025-09-17,Fidji Simo,Instacart,8,31,1,40,
2025-09-17,Kimberly K Ryan,Hillenbrand,2,5,0,7,
2025-09-17,David S Graziosi,Allison Transmission,2,20,1,23,
2025-09-17,Gary G Friedman,Restoration Hardware,1,5,0,6,
2025-09-17,Lucinda M Baier,Brookdale Senior Living,5,3,1,9,
2025-09-17,Brian J Blaser,QuidelOrtho,1,9,0,10,
2025-09-17,E Jean Savage,Trinity Industries,2,7,1,10,
2025-09-17,Liam J Kelly,Teleflex,1,3,1,5,
2025-09-17,Laurans A Mendelson,HEICO,5,16,0,21,
2025-09-17,Frank H Laukien,Bruker,2,6,1,9,
2025-09-17,Harvey M Schwartz,Carlyle Group,5,14,0,19,
2025-09-17,Mark S LaVigne,Energizer,1,1,0,2,
2025-09-17,Joel Quadracci,Quad/Graphics,10,25,5,40,
2025-09-17,Amar Maletira,Rackspace Technology,4,10,2,16,
2025-09-17,Udit Batra,Waters Corporation,10,21,0,31,
2025-09-17,Eric M Green,West Pharmaceutical Services,2,8,0,10,
2025-09-17,Doug Palladini,Carters inc,2,2,2,6,
2025-09-17,G Mike Mikan,NeueHealth,3,1,0,4,
2025-09-17,Russell ChipChilds,SkyWest,0,0,0,0,
2025-09-17,Christopher H Hunter,Acadia Healthcare,0,1,0,1,
2025-09-17,Prahlad Singh,Revvity,3,7,0,10,
2025-09-17,Maria M Pope,Portland General Electric,4,5,0,9,
2025-09-17,Charles Chip Blankenship,Woodward inc,0,2,0,2,
2025-09-17,Mike Steib,TEGNA,15,15,1,31,
2025-09-17,Kurt J Ekert,Sabre Corporation,0,0,0,0,
2025-09-17,Matt Wilson,Light & Wonder,16,18,6,40,
2025-09-17,Rob Katz,Vail Resorts,3,12,25,40,
2025-09-17,Schnitzer Steel Industries,Radius Recycling,6,26,7,39,
2025-09-17,David A Spector,PennyMac Financial Services,5,0,0,5,
2025-09-17,Frederick J Holzgrefe III,Saia inc,0,1,0,1,
2025-09-17,Mark J Parrell,Equity Residential,4,7,1,12,
2025-09-17,John W Lindsay,Helmerich & Payne,0,5,0,5,
2025-09-17,Gary D Burnison,Korn Ferry,4,11,0,15,
2025-09-17,Timothy J McGrath,PC Connection Inc,1,2,0,3,
2025-09-17,Lynn M Bamford,Curtiss-Wright,10,10,0,20,
2025-09-17,Jonathan W Witter,Sallie Mae,0,1,0,1,
2025-09-17,Jeff Benck,Benchmark Electronics,3,8,0,11,
2025-09-17,Charles H Giancarlo,Pure Storage,0,4,0,4,
2025-09-17,Brian R Gray,Knife River Corporation,0,1,0,1,
2025-09-17,Jay Schmidt,Caleres inc,3,5,2,10,
2025-09-17,Dale Asplund,BrightView Holdings,2,6,0,8,
2025-09-17,Jeffrey S Edwards,Cooper-Standard,0,7,0,7,
2025-09-17,Glenn J Williams,Primerica,4,2,2,8,
2025-09-17,Francois Locoh-Donou,F5,5,26,2,33,
2025-09-17,Joseph Wm Foran,Matador Resources,8,8,0,16,
2025-09-17,Sridhar Ramaswamy,Snowflake inc,14,20,4,38,
2025-09-17,Mark D Dankberg,Viasat,2,5,3,10,
2025-09-17,Francisco J Leon,California Resources,1,2,1,4,
2025-09-17,Peter Stern,Peloton,17,19,4,40,
2025-09-17,David Baszucki,Roblox,8,24,8,40,
2025-09-17,Jeffrey W Edwards,Installed Building Products,0,0,0,0,
2025-09-17,Clark Lauritzen,First National of Nebraska,1,7,0,8,
2025-09-17,Carlos Alberini,Guess inc,12,27,1,40,
2025-09-17,Shyam P Kambeyanda,ESAB,3,5,0,8,
2025-09-17,Edmund Shallcross III,Amica Mutual Insurance,0,4,0,4,
2025-09-17,Benjamin W Schall,AvalonBay Communities,1,5,1,7,
2025-09-17,Allan C Thygesen,DocuSign,3,5,0,8,
2025-09-17,Bryan J Knutson,Titan Machinery,1,1,0,2,
2025-09-17,Heath Sampson,ModivCare,6,2,2,10,
2025-09-17,Ara K Hovnanian,Hovnanian Enterprises,2,15,0,17,
2025-09-17,Joshua G Silverman,Etsy,1,2,1,4,
2025-09-17,Kevin Roycraft,Adams Resources & Energy,6,3,1,10,
2025-09-17,J Eric Evans,Surgery Partners,0,2,0,2,
2025-09-17,Clint E Stein,Columbia Banking System,1,4,0,5,
2025-09-17,Lee M Shavel,Verisk Analytics,2,7,0,9,
2025-09-17,Dave Banyard Jr,MasterBrand,0,0,0,0,
2025-09-17,Peter R Ingram,Hawaiian Airlines inc,1,0,0,1,
2025-09-17,Kristin A Dolan,AMC Networks,3,2,0,5,
2025-09-17,Brendan T Cavanagh,SBA Communications,1,3,0,4,
2025-09-17,George F Chappelle Jr,Americold Realty Trust,2,3,0,5,
2025-09-17,Thomas E Gottwald,NewMarket Corporation,2,7,0,9,
2025-09-17,Thomas J Baltimore Jr,Park Hotels & Resorts,3,28,1,32,
2025-09-17,Peter M Moglia,Alexandria Real Estate Equities,5,4,0,9,
2025-09-17,Ronald J Kramer,Griffon Corporation,1,7,1,9,
2025-09-17,John L Plueger,Air Lease,2,13,0,15,
2025-09-17,Jennifer F Scanlon,UL Solutions,1,3,0,4,
2025-09-17,Greg Smith,Teradyne,2,7,2,11,
2025-09-17,Sean Trauschke,OGE Energy,18,4,0,22,
2025-09-17,Norman D Schwartz,Bio-Rad Laboratories,0,0,1,1,
2025-09-17,Scott Doyle,Spire inc,4,5,1,10,
2025-09-17,Michael E Reed,Gannett,0,4,1,5,
2025-09-17,Cindy J Miller,Stericycle,2,3,4,9,
2025-09-17,Phillip D Green,Cullen Frost Bankers,1,3,2,6,
2025-09-17,Joseph D Margolis,Extra Space Storage,2,7,1,10,
2025-09-17,Mark A Skonieczny,REV Group,1,3,0,4,
2025-09-17,Ladd Wilks,ProFrac Holding,4,0,0,4,
2025-09-17,Sundaram Nagarajan,Nordson,0,9,0,9,
2025-09-17,Anne P Noonan,Summit Materials,0,1,0,1,
2025-09-17,Lori Flees,Valvoline inc,4,4,1,9,
2025-09-17,Scott H Baxter,Kontoor Brands,2,2,0,4,
2025-09-17,Tim Larson,Skyline Champion,5,0,0,5,
2025-09-17,Chuck Divita,Teladoc Health,11,15,5,31,
2025-09-17,W Bradley Southern,Louisiana-Pacific Corporation,0,0,0,0,
2025-09-17,George C Freeman III,Universal Corporation,2,7,0,9,
2025-09-17,James A Brock,Consol Energy,1,0,0,1,
2025-09-17,Robert Antokol,Playtika Holding,1,7,1,9,
2025-09-17,Joe Craft,Alliance Resource Partners,5,11,2,18,
2025-09-17,Paul Keel,Envista,2,7,1,10,
2025-09-17,Jared Isaacman,Shift4 Payments,7,29,4,40,
2025-09-17,Mark Mac McFarland,Talen Energy,5,1,1,7,
2025-09-17,Tony R Thene,Carpenter Technology,3,7,0,10,
2025-09-17,Melissa D Smith,WEX,1,6,2,9,
2025-09-17,James Jim C Ryan III,Old National Bancorp,1,0,0,1,
2025-09-17,Peter J Federico,AGNC Investment,1,0,0,1,
2025-09-17,Brent L Yeagy,Wabash National,0,1,0,1,
2025-09-17,Henry A Fernandez,MSCI,2,16,0,18,
2025-09-17,Mark Penn,Stagwell,10,23,6,39,
2025-09-17,Julie Schertell,Mativ,3,8,0,11,
2025-09-17,Ashish Chand,Belden,3,6,1,10,
2025-09-17,Greg Anderson,Allegiant Travel Company,5,7,0,12,
2025-09-17,Drew Houston,Dropbox,14,18,8,40,
2025-09-17,Kevin T Conroy,Exact Sciences,1,6,2,9,
2025-09-17,Rex D Geveden,BWX Technologies,3,8,0,11,
2025-09-17,Scott R Wells,Clear Channel Outdoor Hldgs,0,0,0,0,
2025-09-17,Paul Bay,Ingram Micro,11,24,5,40,
2025-09-18,Doug McMillon,Walmart,15,19,6,40,None
2025-09-18,Andrew Jassy,Amazon,4,29,5,38,None
2025-09-18,Tim Cook,Apple,17,21,2,40,None
2025-09-18,Stephen Hemsley,UnitedHealth,8,27,5,40,None
2025-09-18,Warren Buffett,Berkshire Hathaway,15,15,10,40,None
2025-09-18,David Joyner,CVS Health,6,30,4,40,None
2025-09-18,Darren Woods,Exxon Mobil,11,22,7,40,None
2025-09-18,Sundar Pichai,Alphabet,18,17,5,40,None
2025-09-18,Brian Tyler,McKesson,5,16,6,27,None
2025-09-18,Robert Mauch,Cencora,3,7,0,10,None
2025-09-18,Ron Vachris,Costco,6,30,4,40,None
2025-09-18,Jamie Dimon,JPMorgan Chase,7,16,17,40,None
2025-09-18,Satya Nadella,Microsoft,16,20,4,40,None
2025-09-18,Jason Hollar,Cardinal Health,14,22,4,40,None
2025-09-18,Mike Wirth,Chevron,18,15,7,40,None
2025-09-18,David Cordani,Cigna,21,17,2,40,None
2025-09-18,Jim Farley,Ford Motor,12,20,8,40,None
2025-09-18,Brian Moynihan,Bank of America,7,32,1,40,None
2025-09-18,Mary Barra,General Motors,13,23,4,40,None
2025-09-18,Gail Boudreaux,Elevance Health,14,17,9,40,None
2025-09-18,Jane Fraser,Citigroup,11,25,4,40,None
2025-09-18,Sarah London,Centene,13,18,8,39,None
2025-09-18,Ted Decker,Home Depot,11,23,6,40,None
2025-09-18,Maryann Mannen,Marathon Petroleum,6,15,1,22,None
2025-09-18,Ron Sargent,Kroger,5,23,12,40,None
2025-09-18,Mark Lashier,Phillips 66,9,23,6,38,None
2025-09-18,Priscilla Almodovar,Fannie Mae,11,16,13,40,None
2025-09-18,Tim Wentworth,Walgreens,8,24,8,40,None
2025-09-18,Lane Riggs,Valero Energy,13,8,0,21,None
2025-09-18,Mark Zuckerberg,Meta,18,15,7,40,None
2025-09-18,Hans Vestberg,Verizon,13,24,3,40,None
2025-09-18,John Stankey,AT&T,10,24,6,40,None
2025-09-18,Brian Roberts,Comcast,11,23,6,40,None
2025-09-18,Charles Scharf,Wells Fargo,27,6,7,40,None
2025-09-18,David Solomon,Goldman Sachs,10,20,10,40,None
2025-09-18,Michael Hutchins,Freddie Mac,2,11,2,15,None
2025-09-18,Michael Fiddelke,Target,9,23,8,40,None
2025-09-18,Jim Rechtin,Humana,19,17,4,40,None
2025-09-18,Jon Farney,State Farm Insurance,1,14,3,18,None
2025-09-18,Elon Musk,Tesla,19,13,7,39,None
2025-09-18,Ted Pick,Morgan Stanley,17,21,2,40,None
2025-09-18,Joaquin Duato,Johnson & Johnson,10,24,6,40,None
2025-09-18,Juan Luciano,Archer Daniels Midland,4,20,12,36,None
2025-09-18,Ramon Laguarta,PepsiCo,8,26,6,40,None
2025-09-18,Carol Tom√©,UPS,8,22,10,40,None
2025-09-18,Rajesh Subramaniam,FedEx,10,27,0,37,None
2025-09-18,Bob Iger,Walt Disney,10,28,2,40,None
2025-09-18,Michael Dell,Dell Technologies,11,26,3,40,None
2025-09-18,Marvin Ellison,Lowes,12,25,2,39,None
2025-09-18,Jon Moeller,Procter & Gamble,2,30,8,40,None
2025-09-18,Thomas Long,Energy Transfer,8,0,1,9,None
2025-09-18,Kelly Ortberg,Boeing,8,27,4,39,None
2025-09-18,Susan Morris,Albertsons,15,21,4,40,None
2025-09-18,Kevin Hourican,Sysco,9,28,3,40,None
2025-09-18,Christopher Calio,RTX,5,12,0,17,None
2025-09-18,Larry Culp,General Electric,10,27,3,40,None
2025-09-18,James Taiclet,Lockheed Martin,15,18,7,40,None
2025-09-18,Stephen Squeri,American Express,15,24,1,40,None
2025-09-18,Joe Creed,Caterpillar,12,25,3,40,None
2025-09-18,Michel Khalaf,MetLife,9,16,1,26,None
2025-09-18,Samuel Hazen,HCA Healthcare,9,5,0,14,None
2025-09-18,Tricia Griffith,Progressive Insurance,9,26,5,40,None
2025-09-18,Arvind Krishna,IBM,14,20,6,40,None
2025-09-18,John May,Deere,8,26,6,40,None
2025-09-18,Jensen Huang,Nvidia,7,24,9,40,None
2025-09-18,Philip Smith,StoneX,0,9,0,9,None
2025-09-18,Robert M Davis,Merck,4,18,0,22,None
2025-09-18,Ryan Lance,ConocoPhillips,15,19,6,40,None
2025-09-18,Albert Bourla,Pfizer,21,12,7,40,None
2025-09-18,Ed Bastian,Delta Air Lines,11,16,13,40,None
2025-09-18,Patrick Zammit,TD Synnex,7,12,0,19,None
2025-09-18,Kevin Murphy,Publix Super Markets,9,22,1,32,None
2025-09-18,Thomas J Wilson,Allstate,1,7,1,9,None
2025-09-18,Chuck Robbins,Cisco Systems,16,20,4,40,None
2025-09-18,Kirt Walker,Nationwide Insurance,5,5,0,10,None
2025-09-18,Christopher Winfrey,Charter Communications,5,14,5,24,None
2025-09-18,Bob Michael,AbbVie,0,0,0,0,None
2025-09-18,Craig DeSanto,New York Life Insurance,2,20,0,22,None
2025-09-18,Lip-Bu Tan,Intel,6,20,14,40,None
2025-09-18,Ernie Herrman,TJX,17,22,1,40,None
2025-09-18,Andrew Sullivan,Prudential Financial,13,19,0,32,None
2025-09-18,Enrique Lores,Hewlett Packard,10,14,6,30,None
2025-09-18,Scott Kirby,United Airlines,28,8,4,40,None
2025-09-18,George Holm,Performance Food,8,20,2,30,None
2025-09-18,Donnie King,Tyson Foods,7,27,6,40,None
2025-09-18,Robert Isom,American Airlines,7,24,9,40,None
2025-09-18,Timothy M Sweeney,Liberty Mutual Insurance,10,0,0,10,None
2025-09-18,Elliott Hill,Nike,11,24,5,40,None
2025-09-18,Safra Catz,Oracle,20,14,6,40,None
2025-09-18,AJ Jim Teague,Enterprise Products Partners,6,11,0,17,None
2025-09-18,Richard Fairbank,Capital One,18,20,2,40,None
2025-09-18,Willie Chiang,Plains GP,3,5,1,9,None
2025-09-18,Michael Kasbar,World Kinect,2,7,0,9,None
2025-09-18,Peter Zaffino,American International Group,8,26,6,40,None
2025-09-18,James Quincey,The Coca-Cola Company,9,25,6,40,None
2025-09-18,Thasunda Brown Duckett,TIAA,17,23,0,40,None
2025-09-18,Jay Debertin,CHS,4,11,3,18,None
2025-09-18,Chris Boerner,Bristol-Myers Squibb,10,25,5,40,None
2025-09-18,Corie Barry,Best Buy,39,1,0,40,None
2025-09-18,Marc Casper,Thermo Fisher Scientific,14,22,4,40,None
2025-09-18,Roger Crandall,Mass Mutual,2,8,0,10,None
2025-09-18,Juan Andrade,USAA,5,17,0,22,None
2025-09-18,Phebe Novakovic,General Dynamics,28,8,4,40,None
2025-09-18,Alan Schnitzer,Travelers Insurance,3,5,2,10,None
2025-09-18,David Zaslav,Warner Bros Discovery,3,26,11,40,None
2025-09-18,Gunjan Kedia,US Bancorp,16,22,2,40,None
2025-09-18,Robert Ford,Abbott Laboratories,12,21,7,40,None
2025-09-18,Kathy Warden,Northrop Grumman,15,20,5,40,None
2025-09-18,Tim Gerend,Northwestern Mutual,11,28,1,40,None
2025-09-18,Todd Vasos,Dollar General,5,26,9,40,None
2025-09-18,Matthew Lucey,PBF Energy,5,2,0,7,None
2025-09-18,Dara Khosrowshahi,Uber,15,19,6,40,None
2025-09-18,Vimal Kapur,Honeywell,12,28,0,40,None
2025-09-18,Dirk Van de Put,Mondelez,7,30,3,40,None
2025-09-18,Brian Niccol,Starbucks,9,24,7,40,None
2025-09-18,Cristiano Amon,Qualcomm,14,25,1,40,None
2025-09-18,Hock Tan,Broadcom,7,32,1,40,None
2025-09-18,David Flitman,US Foods,4,5,0,9,None
2025-09-18,Paul Romanowski,DR Horton,6,15,4,25,None
2025-09-18,Jacek Olczak,Philip Morris,12,24,4,40,None
2025-09-18,Preston Feight,Paccar,9,25,0,34,None
2025-09-18,Marc Benioff,Salesforce,9,17,14,40,None
2025-09-18,Leon Topalian,Nucor,14,23,3,40,None
2025-09-18,Michael Dastoor,Jabil,2,6,0,8,None
2025-09-18,Jonathan Jaffe,Lennar,2,7,1,10,None
2025-09-18,David Ricks,Eli Lilly,9,22,9,40,None
2025-09-18,Joe Zubretsky,Molina Healthcare,11,3,4,18,None
2025-09-18,Jennifer Rumsey,Cummins,8,27,5,40,None
2025-09-18,Robin Vince,Bank of New York Mellon,19,20,1,40,None
2025-09-18,Ted Sarandos,Netflix,12,26,2,40,None
2025-09-18,William H Rogers Jr,Truist Financial,3,7,0,10,None
2025-09-18,Sean Kerins,Arrow Electronics,1,15,0,16,None
2025-09-18,William M Brown,3M,2,8,0,10,None
2025-09-18,Ryan McInerney,Visa,12,24,4,40,None
2025-09-18,Marc Rowan,Apollo Global Management,12,23,5,40,None
2025-09-18,Tim Go,HF Sinclair,6,2,0,8,None
2025-09-18,Robert Sulentic,CBRE Group,1,7,1,9,None
2025-09-18,William Demchak,PNC Financial Services,14,21,5,40,None
2025-09-18,Bryan DeBoer,Lithia Motors,11,28,1,40,None
2025-09-18,William Nash,CarMax,3,5,2,10,None
2025-09-18,Brian Robbins,Paramount Global,8,32,0,40,None
2025-09-18,Michael Creedon,Dollar Tree,6,32,2,40,None
2025-09-18,Sandy Douglas,United Natural Foods,33,5,2,40,None
2025-09-18,Alex Chriss,PayPal,13,23,4,40,None
2025-09-18,Roger Penske,Penske Automotive,18,21,1,40,None
2025-09-18,Antonio Neri,Hewlett Packard Enterprise,10,23,7,40,None
2025-09-18,Harry Sideris,Duke Energy,36,4,0,40,None
2025-09-18,Vicki Hollub,Occidental Petroleum,21,16,3,40,None
2025-09-18,Lawrence Coben,NRG Energy,6,3,0,9,None
2025-09-18,Robert Bradway,Amgen,11,27,2,40,None
2025-09-18,John Ketchum,NextEra Energy,23,15,2,40,None
2025-09-18,Rainer Blair,Danaher,5,15,2,22,None
2025-09-18,Daniel ODay,Gilead Sciences,2,8,0,10,None
2025-09-18,Michael Manley,AutoNation,3,6,1,10,None
2025-09-18,Carlos Abrams-Rivera,Kraft Heinz,9,24,7,40,None
2025-09-18,Philip Gallagher,Avnet,1,5,0,6,None
2025-09-18,Gary Dickerson,Applied Materials,3,23,14,40,None
2025-09-18,Bob Jordan,Southwest Airlines,10,23,7,40,None
2025-09-18,Rick Wurster,Charles Schwab,13,21,5,39,None
2025-09-18,Lorenzo Simonelli,Baker Hughes,15,22,3,40,None
2025-09-18,Chris Kempczinski,McDonalds,10,21,9,40,None
2025-09-18,Christopher Womack,Southern Company,3,7,0,10,None
2025-09-18,Michael Miebach,Mastercard,11,25,4,40,None
2025-09-18,Joseph Dominguez,Constellation Energy,14,10,1,25,None
2025-09-18,Christopher Swift,The Hartford,13,23,4,40,None
2025-09-18,Patricia Poppe,PG&E,8,14,2,24,None
2025-09-18,Bom Kim,Coupang,8,30,2,40,None
2025-09-18,Ezra Yacob,EOG Resources,24,13,3,40,None
2025-09-18,Jim Vena,Union Pacific,14,25,1,40,None
2025-09-18,Matt Schroeder,Rite Aid,4,33,3,40,None
2025-09-18,Tony Spring,Macys,8,21,5,34,None
2025-09-18,Anthony Capuano,Marriott International,11,27,2,40,None
2025-09-18,Raymond E Scott,Lear Corporation,4,6,0,10,None
2025-09-18,William Stengel II,Genuine Parts,0,4,0,4,None
2025-09-18,Heidi Petz,Sherwin-Williams,9,27,2,38,None
2025-09-18,Jeff Miller,Halliburton,10,25,5,40,None
2025-09-18,Kathleen Quirk,Freeport-McMoRan,13,16,2,31,None
2025-09-18,Michael Rapino,Live Nation Entertainment,14,23,3,40,None
2025-09-18,John Doyle,Marsh & McLennan,9,6,1,16,None
2025-09-18,Lisa Su,Advanced Micro Devices,16,20,4,40,None
2025-09-18,Frank Holding,First Citizens BancShares,10,17,2,29,None
2025-09-18,John Engel,WESCO International,6,13,1,20,None
2025-09-18,David Gitlin,Carrier Global,14,24,2,40,None
2025-09-18,Lourenco Goncalves,Cleveland-Cliffs,6,22,12,40,None
2025-09-18,Calvin G Butler Jr,Exelon,6,5,0,11,None
2025-09-18,Joseph Bae,KKR & Co,10,7,1,18,None
2025-09-18,Christine Leahy,CDW,0,9,2,11,None
2025-09-18,Glenn Fogel,Booking Holdings,12,23,5,40,None
2025-09-18,Brian Doubles,Synchrony Financial,4,8,2,14,None
2025-09-18,Earl Austin,Quanta Services,2,5,2,9,None
2025-09-18,Christian Ulbrich,Jones Lang LaSalle,8,15,0,23,None
2025-09-18,Saumya Sutaria,Tenet Healthcare,6,3,1,10,None
2025-09-18,William Gifford,Altria Group,2,7,1,10,None
2025-09-18,Kevin Lobo,Stryker,13,24,3,40,None
2025-09-18,Michael Hsu,Kimberly-Clark,5,7,0,12,None
2025-09-18,Jack Fusco,Cheniere Energy,19,18,3,40,None
2025-09-18,James Conroy,Ross Stores,4,16,0,20,None
2025-09-18,Anthony Smurfit,Smurfit Westrock,3,5,0,8,None
2025-09-18,Jeffrey Harmening,General Mills,3,17,5,25,None
2025-09-18,Mark Stewart,Goodyear Tire & Rubber,4,35,1,40,None
2025-09-18,Bob Eddy,BJs Wholesale Club,6,20,3,29,None
2025-09-18,Peter Arduini,GE HealthCare Technologies,3,9,0,12,None
2025-09-18,Noel Wallace,Colgate-Palmolive,10,19,2,31,None
2025-09-18,Marc Bitzer,Whirlpool,11,15,14,40,None
2025-09-18,Chris Kubasik,L3Harris Technologies,7,13,1,21,None
2025-09-18,Shantanu Narayen,Adobe,20,19,1,40,None
2025-09-18,Thomas Polen,Becton Dickinson,6,4,0,10,None
2025-09-18,Richard P Dealy,Pioneer Natural Resources,6,2,0,8,None
2025-09-18,Ravi Kumar S,Cognizant Technology Solutions,11,19,3,33,None
2025-09-18,Andrew Clyde,Murphy USA,14,25,1,40,None
2025-09-18,Mike Lyons,Fiserv,3,12,0,15,None
2025-09-18,Jennifer Parmentier,Parker-Hannifin,3,14,0,17,None
2025-09-18,William Fehrman,American Electric Power,3,7,0,10,None
2025-09-18,Andrew Silvernail,International Paper,6,24,0,30,None
2025-09-18,Jonas Prising,ManpowerGroup,6,22,2,30,None
2025-09-18,John Zillmer,Aramark,6,13,2,21,None
2025-09-18,Mark Millett,Steel Dynamics,14,2,0,16,None
2025-09-18,Dan Amos,Aflac,15,16,9,40,None
2025-09-18,Tony Cheng,Reinsurance Group of America,3,9,2,14,None
2025-09-18,Karsanbhai,Emerson Electric,7,14,1,22,None
2025-09-18,Ronald P OHanley,State Street,0,4,0,4,None
2025-09-18,Timothy Knavish,PPG Industries,1,1,0,2,None
2025-09-18,David Burritt,United States Steel,10,20,9,39,None
2025-09-18,Maria Black,Automatic Data Processing,4,4,1,9,None
2025-09-18,Daryl Kenningham,Group 1 Automotive,12,25,3,40,None
2025-09-18,Robert Blue,Dominion Energy,26,12,2,40,None
2025-09-18,Larry Fink,BlackRock,11,21,8,40,None
2025-09-18,Pierce Norton II,Oneok,5,4,1,10,None
2025-09-18,David Bozeman,CH Robinson Worldwide,2,8,0,10,None
2025-09-18,Haviv Ilan,Texas Instruments,12,26,2,40,None
2025-09-18,Michael Bender,Kohls,2,22,11,35,None
2025-09-18,Philip Daniele III,AutoZone,0,2,0,2,None
2025-09-18,Timothy Archer,Lam Research,3,7,0,10,None
2025-09-18,Charles Magro,Corteva,5,3,1,9,None
2025-09-18,Rick Lanoha,Peter Kiewit Sons,0,2,0,2,None
2025-09-18,Peter Jackson,Builders FirstSource,5,11,1,17,None
2025-09-18,Martin Schroeter,Kyndryl,8,32,0,40,None
2025-09-18,Hamid Akhavan,EchoStar,8,24,8,40,None
2025-09-18,Bill Westrate,American Family Insurance,10,16,2,28,None
2025-09-18,Avigal Soreq,Delek US,6,8,4,18,None
2025-09-18,Beth Ford,Land OLakes,4,7,1,12,None
2025-09-18,Walker Martin,Sempra,1,1,0,2,None
2025-09-18,Eric Slifka,Global Partners,12,22,6,40,None
2025-09-18,DG Macpherson,WW Grainger,2,7,0,9,None
2025-09-18,Bob Pragada,Jacobs Solutions,5,10,0,15,None
2025-09-18,Pedro Pizarro,Edison International,15,7,18,40,None
2025-09-18,William Hornbuckle,MGM Resorts International,8,25,1,34,None
2025-09-18,Andrew McMahon,Guardian Life insurance,5,12,0,17,None
2025-09-18,Christopher OHerlihy,Illinois Tool Works,0,1,0,1,None
2025-09-18,James Cracchiolo,Ameriprise Financial,1,21,2,24,None
2025-09-18,Ryan Marshall,PulteGroup,10,14,9,33,None
2025-09-18,Matthew Meloy,Targa Resources,5,5,0,10,None
2025-09-18,Michael Rhodes,Ally Financial,9,27,4,40,None
2025-09-18,Joseph Fadool,BorgWarner,4,10,0,14,None
2025-09-18,St√©phane de La Faverie,Est√©e Lauder,17,20,3,40,None
2025-09-18,Benjamin Tisch,Loews,2,6,0,8,None
2025-09-18,Brad Beckham,OReilly Automotive,2,7,0,9,None
2025-09-18,Thomas Gayner,Markel Group,2,8,0,10,None
2025-09-18,Donald Allan,Stanley Black & Decker,11,28,1,40,None
2025-09-18,Sanjay Mehrotra,Micron Technology,17,22,1,40,None
2025-09-18,James Breuer,Fluor,0,1,1,2,None
2025-09-18,Thomas Bell,Leidos,8,17,2,27,None
2025-09-18,Scott Smith,Viatris,6,4,0,10,None
2025-09-18,Kimberly Dang,Kinder Morgan,9,1,0,10,None
2025-09-18,Christophe Beck,Ecolab,21,18,1,40,None
2025-09-18,Brent Shafer,Baxter International,1,10,0,11,None
2025-09-18,Clay Gaspar,Devon Energy,21,1,0,22,None
2025-09-18,Steven Cahillane,Kellanova,2,7,0,9,None
2025-09-18,Raul Nicholas Vargas Ochoa,Farmers Insurance Exchange,0,0,0,0,None
2025-09-18,Darren Rebelez,Caseys General Stores,4,5,0,9,None
2025-09-18,Ari Bousbib,IQVIA,5,14,0,19,None
2025-09-18,Jon Vander Ark,Republic Services,11,18,11,40,None
2025-09-18,Timothy Cofer,Keurig Dr Pepper,2,5,1,8,None
2025-09-18,Karla Lewis,Reliance Inc,5,4,0,9,None
2025-09-18,David Hult,Asbury Automotive Group,8,31,1,40,None
2025-09-18,Darryl Button,Pacific Life,0,7,0,7,None
2025-09-18,James Burke,Vistra,7,3,0,10,None
2025-09-18,John Barrett,Western & Southern Financial,12,26,2,40,None
2025-09-18,William Krueger,The Andersons Inc,0,2,0,2,None
2025-09-18,Erik Nordstrom,Nordstrom,9,25,5,39,None
2025-09-18,John Wren,Omnicom Group,12,22,6,40,None
2025-09-18,Stephanie Ferris,Fidelity National Information Services,15,23,2,40,None
2025-09-18,Timothy Cawley,Consolidated Edison,4,5,0,9,None
2025-09-18,Joseph Hinrichs,CSX,6,9,0,15,None
2025-09-18,Troy Rudd,AECOM,7,23,4,34,None
2025-09-18,Kathleen Johnson,Lumen Technologies,4,4,1,9,None
2025-09-18,Harry Lawton III,Tractor Supply,0,0,0,0,None
2025-09-18,Raul Fernandez,DXC Technology,3,27,1,31,None
2025-09-18,Eric Hansotia,AGCO,13,26,1,40,None
2025-09-18,David Bruton Smith,Sonic Automotive,4,6,9,19,None
2025-09-18,Sasan Goodarzi,Intuit,11,25,4,40,None
2025-09-18,Matthew Flannery,United Rentals,30,1,0,31,None
2025-09-18,Marc Miller,Universal Health Services,3,24,3,30,None
2025-09-18,Michael Mahoney,Boston Scientific,11,24,0,35,None
2025-09-18,Judith Marks,Otis Worldwide,1,4,0,5,None
2025-09-18,Robert Frenzel,Xcel Energy,4,3,1,8,None
2025-09-18,Penny Pennington,Edward Jones,5,30,5,40,None
2025-09-18,Daniel Fisher,Ball,1,19,5,25,None
2025-09-18,Justin Jude,LKQ,5,5,1,11,None
2025-09-18,James Blackledge,Mutual of Omaha,1,31,2,34,None
2025-09-18,Bruce Bodine,Mosaic,2,7,0,9,None
2025-09-18,Scott Donnelly,Textron,10,27,3,40,None
2025-09-18,Adam Schechter,Labcorp Holdings,1,6,1,8,None
2025-09-18,Deanna Strable-Soethout,Principal Financial,1,8,0,9,None
2025-09-18,Leonard Schleifer,Regeneron Pharmaceuticals,7,26,7,40,None
2025-09-18,Paul Shoukry,Raymond James Financial,15,24,1,40,None
2025-09-18,Lauren Hobart,Dicks Sporting Goods,11,25,4,40,None
2025-09-18,Jamie Whisnant,Auto-Owners Insurance,0,2,0,2,None
2025-09-18,Ariane Gorin,Expedia,10,28,1,39,None
2025-09-18,Shelley Simpson,JB Hunt Transport Services,7,29,4,40,None
2025-09-18,Ren√© Jones,M&T Bank,10,25,5,40,None
2025-09-18,Gerardo Norcia,DTE Energy,6,2,1,9,None
2025-09-18,Andr√©s Gluski,AES,14,17,1,32,None
2025-09-18,Timothy Spence,Fifth Third Bancorp,5,5,0,10,None
2025-09-18,Eduardo Menezes,Air Products & Chemicals,2,7,0,9,None
2025-09-18,Wendell Weeks,Corning,15,23,2,40,None
2025-09-18,Anthony Guzzi,EMCOR Group,3,6,1,10,None
2025-09-18,Adam Norwitt,Amphenol,2,16,0,18,None
2025-09-18,Jean-Marc Gilson,Westlake Corporation,2,5,1,8,None
2025-09-18,Lori Koch,DuPont,6,16,0,22,None
2025-09-18,Derek Chang,Liberty Media,35,4,1,40,None
2025-09-18,Martina Cheung,S&P Global,9,24,0,33,None
2025-09-18,Tim Hingtgen,Community Health Systems,10,27,3,40,None
2025-09-18,Brian Tierney,FirstEnergy,6,19,3,28,None
2025-09-18,Rick McKenney,Unum Group,6,4,0,10,None
2025-09-18,Stanley Bergman,Henry Schein,14,25,1,40,None
2025-09-18,Tiang Yew Tan,Western Digital,1,4,0,5,None
2025-09-18,Vincent Roche,Analog Devices,15,21,4,40,None
2025-09-18,Sean Connolly,Conagra Brands,8,30,2,40,None
2025-09-18,Bruce Van Saun,Citizens Financial Group,11,25,4,40,None
2025-09-18,Mark George,Norfolk Southern,16,21,3,40,None
2025-09-18,Andrew Marsh,Entergy,4,4,0,8,None
2025-09-18,Robert Berkley,WR Berkley,8,28,4,40,None
2025-09-18,Javier Rodriguez,DaVita,14,15,1,30,None
2025-09-18,Michael OGrady,Northern Trust,3,1,0,4,None
2025-09-18,James Snee,Hormel Foods,4,30,1,35,None
2025-09-18,Timothy J Donahue,Crown Holdings,2,8,0,10,None
2025-09-18,Joseph Ferraro,Avis Budget,3,6,1,10,None
2025-09-18,Niraj Shah,Wayfair,6,25,9,40,None
2025-09-18,Jos√© Mas,MasTec,6,14,0,20,None
2025-09-18,Joseph Nolan,Eversource Energy,4,3,1,8,None
2025-09-18,Thomas Palmer,Newmont,5,5,0,10,None
2025-09-18,Robert Sanchez,Ryder System,9,6,1,16,None
2025-09-18,Michael Nolan,Fidelity National Financial,3,1,0,4,None
2025-09-18,Gavin Hattersley,Molson Coors Beverage,6,28,6,40,None
2025-09-18,Thomas Reeg,Caesars Entertainment,5,6,0,11,None
2025-09-18,Ellen Cooper,Lincoln National,3,6,0,9,None
2025-09-18,Bracken Darrell,VF Corporation,8,29,3,40,None
2025-09-18,Erik Fyrwald,International Flavors & Fragrances,5,9,4,18,None
2025-09-18,Christopher Kastner,Huntington Ingalls Industries,2,5,1,8,None
2025-09-18,Shane OKelly,Advance Auto Parts,0,6,0,6,None
2025-09-18,Ralph LaRossa,Public Service Enterprise Group,11,17,0,28,None
2025-09-18,Kecia Steelman,Ulta Beauty,33,6,1,40,None
2025-09-18,Michele Buck,Hershey,5,33,2,40,None
2025-09-18,Sumit Singh,Chewy,12,23,5,40,None
2025-09-18,Steven Vondran,American Tower,4,6,0,10,None
2025-09-18,Jeffrey Lorberbaum,Mohawk Industries,11,6,1,18,None
2025-09-18,Keith Demmings,Assurant,3,10,0,13,None
2025-09-18,Robert Martin,Thor Industries,4,5,1,10,None
2025-09-18,Kathleen Mazzarella,Graybar Electric,2,5,2,9,None
2025-09-18,Joey Wat,Yum China,14,24,2,40,None
2025-09-18,Scott Richardson,Celanese,6,15,1,22,None
2025-09-18,David Rawlinson II,QVC,8,15,2,25,None
2025-09-18,Alan Armstrong,Williams,23,12,5,40,None
2025-09-18,Philippe Krakowsky,Interpublic Group,14,24,2,40,None
2025-09-18,Brendan McCracken,Ovintiv,6,5,0,11,None
2025-09-18,Andrew Teno,Icahn Enterprises,4,5,0,9,None
2025-09-18,Stephen Steinour,Huntington Bancshares,3,7,0,10,None
2025-09-18,Timothy NeCastro,Erie Insurance,2,7,1,10,None
2025-09-18,Ernest Garcia III,Carvana,25,11,4,40,None
2025-09-18,R Bruce McDonald,Dana Incorporated,3,7,1,11,None
2025-09-18,William Oplinger,Alcoa Corporation,2,7,1,10,None
2025-09-18,Mark Pearson,Equitable,8,6,0,14,None
2025-09-18,Richard Wallace,KLA,2,4,0,6,None
2025-09-18,Ricardo Cardenas,Darden Restaurants,4,3,1,8,None
2025-09-18,Mikael Bratt,Autoliv,7,6,2,15,None
2025-09-18,Benito Minicucci,Alaska Air,2,3,2,7,None
2025-09-18,Christopher Gorman,KeyCorp,5,5,0,10,None
2025-09-18,Robert Goldstein,Las Vegas Sands,5,30,5,40,None
2025-09-18,Edward Pesicka,Owens & Minor,3,33,2,38,None
2025-09-18,Christopher Nassetta,Hilton Worldwide,8,15,3,26,None
2025-09-18,Jamie Iannone,Ebay,18,19,3,40,None
2025-09-18,Patrick Gallagher,Arthur J Gallagher,8,30,2,40,None
2025-09-18,Rich Steinmeier,LPL Financial,22,15,3,40,None
2025-09-18,Stephen Spray,Cincinnati Financial,1,7,1,9,None
2025-09-18,Douglas Yearley,Toll Brothers,10,25,5,40,None
2025-09-18,Gregory Brown,Motorola Solutions,4,4,1,9,None
2025-09-18,Brian Chesky,Airbnb,5,30,5,40,None
2025-09-18,Jeffrey Sprecher,Intercontinental Exchange,16,21,3,40,None
2025-09-18,Robert Thomson,News Corp,5,32,3,40,None
2025-09-18,Scott Boatwright,Chipotle Mexican Grill,10,27,3,40,None
2025-09-18,Reshma Kewalramani,Vertex Pharmaceuticals,21,15,4,40,None
2025-09-18,Christopher Viehbacher,Biogen,0,26,3,29,None
2025-09-18,Malcolm Wilson,GXO Logistics,5,22,0,27,None
2025-09-18,Tony Sarsam,SpartanNash,17,21,2,40,None
2025-09-18,Michael O‚ÄôSullivan,Burlington Stores,8,29,3,40,None
2025-09-18,Teresa Rasmussen,Thrivent Financial for Lutherans,3,1,0,4,None
2025-09-18,Eugene Bredow,NVR,0,4,1,5,None
2025-09-18,Brian Chambers,Owens Corning,3,14,0,17,None
2025-09-18,Rafael Santana,Westinghouse Air Brake Technologies,3,10,1,14,None
2025-09-18,John Pfeifer,Oshkosh Corporation,2,18,0,20,None
2025-09-18,Cameron Bready,Global Payments,8,30,2,40,None
2025-09-18,Calvin McDonald,Lululemon athletica,9,30,1,40,None
2025-09-18,J Kent Masters,Albemarle Corporation,4,5,0,9,None
2025-09-18,Joanna Geraghty,JetBlue Airways,17,16,7,40,None
2025-09-18,Robert Steer,Seaboard,1,5,0,6,None
2025-09-18,William Newlands,Constellation Brands,0,5,2,7,None
2025-09-18,Michael Doss,Graphic Packaging,4,8,1,13,None
2025-09-18,Gil West,Hertz,7,23,10,40,None
2025-09-18,Malcolm C Roberts,FM Global,2,10,2,14,None
2025-09-18,Mick Beekhuizen,Campbell Soup,8,23,1,32,None
2025-09-18,Daniel Wall,Expeditors International of Washington,2,4,0,6,None
2025-09-18,Gregory Roberts,A-Mark Precious Metals,2,4,1,7,None
2025-09-18,Horacio Rozanski,Booz Allen Hamilton,16,19,5,40,None
2025-09-18,James Davis,Quest Diagnostics,5,5,0,10,None
2025-09-18,Dennis Mathew,Altice,6,24,7,37,None
2025-09-18,Stefan Larsson,PVH,10,25,5,40,None
2025-09-18,Mark Costa,Eastman Chemical,5,17,3,25,None
2025-09-18,Joyce Mullen,Insight Enterprises,4,12,0,16,None
2025-09-18,John Turner,Regions Financial,21,17,2,40,None
2025-09-18,Julian G Francis,Beacon Roofing Supply,0,2,0,2,None
2025-09-18,Blake Moret,Rockwell Automation,10,28,2,40,None
2025-09-18,Mike Speetzen,Polaris Inc,2,17,2,21,None
2025-09-18,William McDermott,ServiceNow,3,4,0,7,None
2025-09-18,Jure Sola,Sanmina,2,11,1,14,None
2025-09-18,Bob Flexon,UGI Utilities Inc,0,1,0,1,None
2025-09-18,Scott Lauber,WEC Energy,13,7,0,20,None
2025-09-18,Jon Rousseau,BrightSpring Health Services,20,19,1,40,None
2025-09-18,Todd Schneider,Cintas,11,18,1,30,None
2025-09-18,Peter Matt,Commercial Metals,5,3,1,9,None
2025-09-18,Robert D Lawler,Continental Resources,0,0,0,0,None
2025-09-18,Domenic Dell‚ÄôOsso Jr,Expand Energy,3,0,0,3,None
2025-09-18,Jason P Wells,CenterPoint Energy,6,3,1,10,None
2025-09-18,H Michael Krimbill,NGL Energy Partners,6,1,0,7,None
2025-09-18,Tony Xu,DoorDash,13,20,7,40,None
2025-09-18,Clay Williams,NOV,7,18,4,29,None
2025-09-18,Kristin Peck,Zoetis,11,19,1,31,None
2025-09-18,Mark Smucker,JM Smucker,13,22,5,40,None
2025-09-18,Steve Sanghi,Microchip Technology,7,28,5,40,None
2025-09-18,Richard Tobin,Dover Corporation,3,3,0,6,None
2025-09-18,Kaes Van‚Äôt Hof,Diamondback Energy,22,14,3,39,None
2025-09-18,Deon Stander,Avery Dennison,0,13,0,13,None
2025-09-18,Vincent Sorgi,PPL,8,8,1,17,None
2025-09-18,Hassane El-Khoury,ON Semiconductor,3,15,5,23,None
2025-09-18,Arie Kotler,ARKO,4,23,0,27,None
2025-09-18,William Monteleone,Par Pacific,2,6,1,9,None
2025-09-18,John Christmann IV,APA,6,3,1,10,None
2025-09-18,Adaire Fox-Martin,Equinix,16,21,3,40,None
2025-09-18,Joseph M Otting,Flagstar Financial,3,5,2,10,None
2025-09-18,Mary Dillon,Foot Locker,10,26,4,40,None
2025-09-18,James Zallie,Ingredion,5,5,0,10,None
2025-09-18,Christopher Peterson,Newell Brands,0,9,1,10,None
2025-09-18,Scott Salmirs,ABM Industries,4,4,1,9,None
2025-09-18,Christopher Hilger,Securian Financial,0,6,0,6,None
2025-09-18,Hamid Moghadam,Prologis,7,28,5,40,None
2025-09-18,Stephen Schwarzman,Blackstone,8,23,8,39,None
2025-09-18,Robert Greenberg,Skechers USA,5,24,3,32,None
2025-09-18,Keith Allman,Masco,3,9,1,13,None
2025-09-18,Rusty Rush,Rush Enterprises,16,20,4,40,None
2025-09-18,Jennifer Johnson,Franklin Resources,1,8,1,10,None
2025-09-18,Gerry P Smith,ODP Business Solutions,0,0,0,0,None
2025-09-18,Carl Lindner lll,American Financial,0,0,0,0,None
2025-09-18,Mark Kowlzan,Packaging Corp of America,1,6,1,8,None
2025-09-18,Thomas Hill,Vulcan Materials,4,7,2,13,None
2025-09-18,Milan Galik,Interactive Brokers,7,17,2,26,None
2025-09-18,Laura Alber,Williams-Sonoma,14,22,4,40,None
2025-09-18,Mario Harik,XPO,8,31,1,40,None
2025-09-18,Devin Stockfish,Weyerhaeuser,4,5,0,9,None
2025-09-18,Thomas J McInerney,Genworth Financial,2,5,1,8,None
2025-09-18,Garrick Rochow,CMS Energy,9,3,1,13,None
2025-09-18,Toni Townes-Whitley,Science Applications International,11,21,1,33,None
2025-09-18,Rich Handler,Jefferies Financial,12,14,2,28,None
2025-09-18,Daniel Heaf,Bath & Body Works,15,24,1,40,None
2025-09-18,Andrew Wilson,Electronic Arts,11,17,12,40,None
2025-09-18,Sheryl Palmer,Taylor Morrison Home,7,10,1,18,None
2025-09-18,Ivan Tornos,Zimmer Biomet,9,30,1,40,None
2025-09-18,Linda Rendle,Clorox,2,34,3,39,None
2025-09-18,Matthew Pine,Xylem Inc,1,9,1,11,None
2025-09-18,Heather Lavallee,Voya Financial,6,11,2,19,None
2025-09-18,Daniel Florness,Fastenal,2,6,1,9,None
2025-09-18,Albert Nahmad,Watsco,2,7,0,9,None
2025-09-18,Carl Eschenbach,Workday,10,20,10,40,None
2025-09-18,Craig Smiddy,Old Republic International,2,6,1,9,None
2025-09-18,Frank C Sullivan,RPM International,3,7,1,11,None
2025-09-18,Matthew Missad,UFP Industries,8,2,0,10,None
2025-09-18,Martin J Lyons,Ameren,3,3,1,7,None
2025-09-18,Adam W Miller,Knight Swift Transportation,1,1,1,3,None
2025-09-18,Rodney Sacks,Monster Beverage,13,26,0,39,None
2025-09-18,Gary Guthart,Intuitive Surgical,11,23,6,40,None
2025-09-18,Charles Liang,Super Micro Computer,34,5,1,40,None
2025-09-18,Christopher Caldwell,Concentrix,3,5,0,8,None
2025-09-18,Gordon J Hardie,O-I Glass,1,5,0,6,None
2025-09-18,David Gibbs,Yum Brands,2,38,0,40,None
2025-09-18,Steve Henry,Domtar,3,7,0,10,None
2025-09-18,Chuck Treadway,CommScope,8,17,3,28,None
2025-09-18,Rob Vitale,Post Holdings,1,13,5,19,None
2025-09-18,Steven J Moskowitz,Crown Castle,3,5,2,10,None
2025-09-18,Emmanuel Ligner,Avantor,1,9,1,11,None
2025-09-18,Stuart Bradie,KBR,13,15,4,32,None
2025-09-18,Carrie Wheeler,Opendoor Technologies,9,25,5,39,None
2025-09-18,Russell Becker,APi Group,4,5,1,10,None
2025-09-18,Toby Rice,EQT,25,12,3,40,None
2025-09-18,Jesse Arenivas,EnLink Midstream,8,8,0,16,None
2025-09-18,Nikesh Arora,Palo Alto Networks,7,24,9,40,None
2025-09-18,Steven Bandrowczak,Xerox,2,7,1,10,None
2025-09-18,Vicente Reynal,Ingersoll Rand,7,30,0,37,None
2025-09-18,William T Dillard II,Dillards,4,3,2,9,None
2025-09-18,C Howard Nye,Martin Marietta Materials,4,3,3,10,None
2025-09-18,Giordano Albertazzi,Vertiv,13,17,4,34,None
2025-09-18,Stephane Bancel,Moderna,10,20,10,40,None
2025-09-18,Nate R Jorgensen,Boise Cascade,0,0,0,0,None
2025-09-18,Jack Sinclair,Sprouts Farmers Market,18,22,0,40,None
2025-09-18,Padraig McDonnell,Agilent Technologies,8,11,0,19,None
2025-09-18,Kenneth T Lane,Olin,1,0,0,1,None
2025-09-18,Randall C Stuewe,Darling Ingredients,27,1,0,28,None
2025-09-18,R Howard Coker,Sonoco Products,1,7,1,9,None
2025-09-18,John Mengucci,CACI International,22,17,1,40,None
2025-09-18,Mark Witkowski,Core & Main,1,12,2,15,None
2025-09-18,Lee M Tillman,Marathon Oil,4,4,0,8,None
2025-09-18,Mark Hoplamazian,Hyatt Hotels,15,20,5,40,None
2025-09-18,David S Chernow,Select Medical,0,8,1,9,None
2025-09-18,Brendan M Foley,McCormick & Company,0,8,0,8,None
2025-09-18,Joanne Crevoiserat,Tapestry,13,24,3,40,None
2025-09-18,John Plant,Howmet Aerospace,4,12,3,19,None
2025-09-18,Shankh Mitra,Welltower,17,21,2,40,None
2025-09-18,W Anthony Will,CF Industries,4,5,0,9,None
2025-09-18,David A Zapico,Ametek,2,16,1,19,None
2025-09-18,Kevin Stein,TransDigm,11,10,2,23,None
2025-09-18,Craig Billings,Wynn Resorts,11,25,4,40,None
2025-09-18,William J Way,Southwestern Energy,2,0,0,2,None
2025-09-18,Giel Rutten,Amkor Technology,2,7,1,10,None
2025-09-18,Paul Sarvadi,Insperity,4,6,0,10,None
2025-09-18,Donald Zurbay,Patterson Companies Inc,0,5,0,5,None
2025-09-18,Rob Sharps,T Rowe Price,15,20,5,40,None
2025-09-18,Patrice Louvet,Ralph Lauren,10,21,9,40,None
2025-09-18,Jeffrey Mezger,KB Home,4,28,7,39,None
2025-09-18,David M Foulkes,Brunswick,0,9,0,9,None
2025-09-18,M Keith Waddell,Robert Half,4,6,0,10,None
2025-09-18,Jay Snowden,PENN Entertainment,18,19,3,40,None
2025-09-18,George Kurian,NetApp,16,21,3,40,None
2025-09-18,Kevin Ali,Organon,9,15,2,26,None
2025-09-18,Joel D Anderson,Petco Health and Wellness,2,7,0,9,None
2025-09-18,Louis V Pinkham,Regal Rexnord,0,1,0,1,None
2025-09-18,Jay Geldmacher,Resideo Technologies,10,6,0,16,None
2025-09-18,Marcus Lemonis,Camping World,11,20,9,40,None
2025-09-18,Peter R Huntsman,Huntsman,6,10,3,19,None
2025-09-18,Hillary Super,Victorias Secret,11,4,8,23,None
2025-09-18,Michelle Gass,Levi Strauss,11,25,3,39,None
2025-09-18,Neil Hunn,Roper Technologies,2,21,0,23,None
2025-09-18,Steven P Lawrence,Academy Sports and Outdoors,1,1,0,2,None
2025-09-18,Phillippe Lord,Meritage Homes,8,18,0,26,None
2025-09-18,David C Dauch,American Axle & Manufacturing,6,7,2,15,None
2025-09-18,Olumide Soroye,Fortive,2,6,1,9,None
2025-09-18,Adena Friedman,Nasdaq,13,23,4,40,None
2025-09-18,Tim Gokey,Broadridge Financial Solutions,4,13,1,18,None
2025-09-18,Patrick M Shanahan,Spirit AeroSystems,1,9,0,10,None
2025-09-18,Robert Kyncl,Warner Music Group,10,28,2,40,None
2025-09-18,Denise Dignam,Chemours,4,16,3,23,None
2025-09-18,Jim DeVries,ADT,9,7,1,17,None
2025-09-18,Bernard Zovighian,Edwards Lifesciences,7,7,2,16,None
2025-09-18,Mark E Seaton,First American Financial,1,9,0,10,None
2025-09-18,John C Roche,Hanover Insurance Group,7,12,0,19,None
2025-09-18,Adam J Greenlee,Silgan,0,4,0,4,None
2025-09-18,Jayne Hrdlicka,Endeavor Group,0,1,0,1,None
2025-09-18,Robert Fauber,Moodys Corporation,0,6,0,6,None
2025-09-18,Thomas E Jorden,Coterra Energy,8,0,0,8,None
2025-09-18,Eugene A Hall,Gartner,1,9,0,10,None
2025-09-18,Kevin Plank,Under Armour,9,27,2,38,None
2025-09-18,James W Lanning,Ingles Markets,3,3,0,6,None
2025-09-18,Matthew T Farrell,Church & Dwight,8,8,0,16,None
2025-09-18,Kevin M Freeman,Old Dominion Freight Line,0,0,0,0,None
2025-09-18,Joe Shoen,U-Haul,14,21,4,39,None
2025-09-18,Mark Bertolini,Oscar Health,12,19,8,39,None
2025-09-18,Jayshree Ullal,Arista Networks,20,19,1,40,None
2025-09-18,Sassine Ghazi,Synopsys,9,27,4,40,None
2025-09-18,Jochen Zeitz,Harley-Davidson,4,28,8,40,None
2025-09-18,Nick Jeffery,Frontier Communications,10,24,1,35,None
2025-09-18,Thomas Edward McCormick,Primoris Services,0,6,0,6,None
2025-09-18,D Christian Koch,Carlisle Companies,0,3,0,3,None
2025-09-18,David E Simon,Simon Property Group,3,6,1,10,None
2025-09-18,Stephen Bratspies,Hanesbrands,3,11,2,16,None
2025-09-18,Ryan M. Schneider,Anywhere Real Estate Inc,0,1,0,1,None
2025-09-18,George Bobb III,Teledyne Technologies,1,3,0,4,None
2025-09-18,Terrence A Duffy,CME Group,6,9,1,16,None
2025-09-18,Rami Rahim,Juniper Networks,12,26,2,40,None
2025-09-18,Sue Nabi,Coty,15,18,7,40,None
2025-09-18,Peter D Arvan,Pool Corporation,3,6,0,9,None
2025-09-18,David Campbell,Evergy,13,8,0,21,None
2025-09-18,Matthew J Murphy,Marvell Technology,2,6,1,9,None
2025-09-18,Lloyd Yates,NiSource,5,5,0,10,None
2025-09-18,William C Stone,SS&C Technologies,2,5,1,8,None
2025-09-18,Mark Rourke,Schneider National,9,16,0,25,None
2025-09-18,Andrew Anagnost,Autodesk,12,21,7,40,None
2025-09-18,Dustin Semach,Sealed Air Corporation,0,8,0,8,None
2025-09-18,William L Meaney,Iron Mountain,3,14,0,17,None
2025-09-18,Andy P Power,Digital Realty Trust,0,0,0,0,None
2025-09-18,Satish Dhanasekaran,Keysight Technologies,3,10,0,13,None
2025-09-18,Frank M Svoboda,Globe Life,1,6,3,10,None
2025-09-18,Carey A Smith,Parsons Corporation,0,2,0,2,None
2025-09-18,Ynon Kreiz,Mattel,10,24,6,40,None
2025-09-18,Karen S Haller,Southwest Gas,3,5,0,8,None
2025-09-18,Terrance Williams,TruStage,5,5,1,11,None
2025-09-18,Eric W Gerstenberg,Clean Harbors,5,1,1,7,None
2025-09-18,Gunner Smith,Cornerstone Building Brands,1,7,2,10,None
2025-09-18,Gerben W Bakker,Hubbell,1,5,0,6,None
2025-09-18,Dave Davis,Spirit Airlines,4,33,3,40,None
2025-09-18,Michael J Smith,Lamb Weston,0,6,3,9,None
2025-09-18,Strauss Zelnick,Take-Two Interactive Software,13,16,11,40,None
2025-09-18,John C Turner Jr,GMS,2,8,0,10,None
2025-09-18,David M OMalley,Penn Mutual Life Insurance,0,1,0,1,None
2025-09-18,Frank A Lonegro,Landstar System,1,4,0,5,None
2025-09-18,James F Risoleo,Host Hotels & Resorts,4,16,0,20,None
2025-09-18,Ken Xie,Fortinet,13,19,8,40,None
2025-09-18,Doug Shulman,OneMain,3,6,0,9,None
2025-09-18,Ryan Cohen,GameStop,12,22,6,40,None
2025-09-18,Mark W Begor,Equifax,3,12,0,15,None
2025-09-18,Jay L Schottenstein,American Eagle Outfitters,8,19,1,28,None
2025-09-18,Curtis C Farmer,Comerica,4,8,0,12,None
2025-09-18,Ole Rosgaard,Greif,3,14,0,17,None
2025-09-18,Brian E Lane,Comfort Systems USA,10,0,0,10,None
2025-09-18,Robert M Buck,TopBuild,5,5,0,10,None
2025-09-18,Ralph Andretta,Bread Financial,2,9,0,11,None
2025-09-18,Jim Anderson,Coherent,5,32,1,38,None
2025-09-18,Walter C. D. Carlson,Telephone & Data Systems,0,3,0,3,None
2025-09-18,Ronald Kruszewski,Stifel Financial,6,3,0,9,None
2025-09-18,Richard Hayne,Urban Outfitters,12,20,7,39,None
2025-09-18,Simon Meester,Terex,4,5,1,10,None
2025-09-18,Edward J Lehner,Ryerson Holding,0,3,0,3,None
2025-09-18,Nicholas T Pinchuk,Snap-on,4,6,0,10,None
2025-09-18,Ryals McMullian,Flowers Foods,5,29,3,37,None
2025-09-18,D Bryan Jordan,First Horizon,3,6,1,10,None
2025-09-18,John B Gibson,Paychex,4,5,0,9,None
2025-09-18,Chris Cocks,Hasbro,11,20,9,40,None
2025-09-18,Pete McPartland,Sentry Insurance Group,0,2,0,2,None
2025-09-18,Michael Arougheti,Ares Management,17,22,1,40,None
2025-09-18,Alok Maskara,Lennox International,5,3,1,9,None
2025-09-18,James C Grech,Peabody Energy,3,0,0,3,None
2025-09-18,Joseph P Lacher Jr,Kemper,3,19,4,26,None
2025-09-18,Perry A Sook,Nexstar Media Group,9,26,1,36,None
2025-09-18,Wade Davis,TelevisaUnivision,13,26,1,40,None
2025-09-18,Scott L Thompson,Tempur Sealy International,0,8,0,8,None
2025-09-18,Mike Simonds,TriNet Group,0,9,0,9,None
2025-09-18,B Andrew Rose,Worthington Enterprises,0,1,0,1,None
2025-09-18,Bruce L Caswell,Maximus,4,3,0,7,None
2025-09-18,Robert L Reffkin,Compass,1,5,0,6,None
2025-09-18,Mark Eubanks,Brinks Company,0,2,1,3,None
2025-09-18,Peter Quigley,Kelly Services inc,1,8,0,9,None
2025-09-18,David L Yowan,Navient,1,0,0,1,None
2025-09-18,Mary E Kipp,Puget Sound Energy,3,0,1,4,None
2025-09-18,Adam Aron,AMC Entertainment,15,18,7,40,None
2025-09-18,Mark J Tarr,Encompass Health,2,2,1,5,None
2025-09-18,Liam K Griffin,Skyworks Solutions,1,5,1,7,None
2025-09-18,Richard G Kyle,Timken,2,11,1,14,None
2025-09-18,Ron Gusek,Liberty Energy,24,1,0,25,None
2025-09-18,John E Geller Jr,Marriott Vacations Worldwide,6,6,0,12,None
2025-09-18,Karl G. Glassman,Leggett & Platt,0,3,0,3,None
2025-09-18,Bruce K Thorn,Big Lots,2,7,1,10,None
2025-09-18,Jonathan H Weis,Weis Markets,11,28,0,39,None
2025-09-18,Jeffrey B Guldner,Pinnacle West Capital,1,1,0,2,None
2025-09-18,Arkadiy Dobkin,EPAM Systems,10,14,1,25,None
2025-09-18,Paul M Rady,Antero Resources,3,9,0,12,None
2025-09-18,Michael Spanos,Bloomin Brands,1,8,1,10,None
2025-09-18,Nicole A Kivisto,MDU Resources Group,5,5,0,10,None
2025-09-18,Gerald L Morgan,Texas Roadhouse,2,3,3,8,None
2025-09-18,Gabriel Tirador,Mercury General,5,4,1,10,None
2025-09-18,Nicholas I Fink,Fortune Brands Innovations,4,6,0,10,None
2025-09-18,Paul E Burdiss,Zions Bancorp,1,1,0,2,None
2025-09-18,William J Christensen,JELD-WEN Holding,4,5,0,9,None
2025-09-18,Evan Spiegel,Snap Inc,20,16,4,40,None
2025-09-18,Bill Burns,Zebra Technologies,5,21,1,27,None
2025-09-18,Steven Sell,Agilon Health,0,8,0,8,None
2025-09-18,Richard M Olson,Toro Company,1,13,0,14,None
2025-09-18,Eric S Yuan,Zoom Video Communications,5,9,0,14,None
2025-09-18,Dan L Batrack,Tetra Tech,2,4,1,7,None
2025-09-18,Joseph D Russell Jr,Public Storage,0,7,0,7,None
2025-09-18,Jacob Thaysen,Illumina inc,4,6,1,11,None
2025-09-18,Debra A Cafaro,Ventas inc,6,5,0,11,None
2025-09-18,Pierre R Brondeau,FMC Corporation,0,4,0,4,None
2025-09-18,Judy R McReynolds,ArcBest,5,13,1,19,None
2025-09-18,Russell J Weiner,Dominos Pizza inc,0,0,0,0,None
2025-09-18,Theodore S Hanson,ASGN,0,0,0,0,None
2025-09-18,RJ Scaringe,Rivian Automotive,9,27,4,40,None
2025-09-18,Jeffrey N Simmons,Elanco Animal Health,2,6,1,9,None
2025-09-18,Tim O Shaughnessy,Graham Holdings Company,2,7,0,9,None
2025-09-18,Thomas V Taylor,Floor & Decor,1,2,2,5,None
2025-09-18,Neil A Schrimsher,Applied Industrial Technologies,5,22,1,28,None
2025-09-18,Robert E Price,PriceSmart,4,6,0,10,None
2025-09-18,John David Risher,Lyft,4,1,1,6,None
2025-09-18,Gary B Smith,Ciena,4,6,0,10,None
2025-09-18,Joey Levin,IAC,7,32,1,40,None
2025-09-18,Jim Jacobs,Country Financial,6,6,2,14,None
2025-09-18,Devin B McGranahan,Western Union,2,6,0,8,None
2025-09-18,R Scott Rowe,Flowserve,5,4,1,10,None
2025-09-18,Kenneth A Vecchione,Western Alliance Bancorp,0,0,1,1,None
2025-09-18,John C Rademacher,Option Care Health,7,0,0,7,None
2025-09-18,Doug Black,SiteOne Landscape Supply,2,16,1,19,None
2025-09-18,Oliver G Brewer III,Topgolf Callaway Brands,1,0,0,1,None
2025-09-18,Glenn Sanford,eXp World,15,20,5,40,None
2025-09-18,Fran Horowitz,Abercrombie & Fitch,13,21,6,40,None
2025-09-18,Kevin Akers,Atmos Energy,6,3,1,10,None
2025-09-18,Alessandro Maselli,Catalent,3,10,2,15,None
2025-09-18,J Powell Brown,Brown & Brown,14,20,6,40,None
2025-09-18,Aman Bhutani,GoDaddy,16,22,2,40,None
2025-09-18,John C. Griffith,American Water Works,1,4,0,5,None
2025-09-18,John J Marchioni,Selective Insurance Group,4,12,3,19,None
2025-09-18,Lawson E Whiting,Brown-Forman,3,6,0,9,None
2025-09-18,Dave Peacock,Advantage Solutions,23,7,0,30,None
2025-09-18,Mick Farrell,ResMed,16,22,2,40,None
2025-09-18,Kamal Hathi,Splunk,4,6,0,10,None
2025-09-18,Todd Kelsey,Plexus,3,7,0,10,None
2025-09-18,Phillip D Yeager,Hub Group,4,5,0,9,None
2025-09-18,Steven B Hedlund,Lincoln Electric,5,10,0,15,None
2025-09-18,Timothy C Oliver,NCR Atleos,0,1,0,1,None
2025-09-18,Bruce Fleming,Calumet,2,6,0,8,None
2025-09-18,Daniel S. Peyovich,Dycom Industries,0,4,0,4,None
2025-09-18,Avner M Applbaum,Valmont Industries,0,8,0,8,None
2025-09-18,Kimberly A Fields,ATI inc,4,7,0,11,None
2025-09-18,Khozema Z Shipchandler,Twilio,0,2,1,3,None
2025-09-18,Gary C Bhojwani,CNO Financial Group,1,5,1,7,None
2025-09-18,William Andrew Hendricks Jr,Patterson-UTI Energy,0,0,0,0,None
2025-09-18,Kevin D Hochman,Brinker International,1,1,0,2,None
2025-09-18,James C Foster,Charles River Laboratories International,2,9,0,11,None
2025-09-18,Rajiv K Prasad,Hyster-Yale,2,5,0,7,None
2025-09-18,Eric T Steigerwalt,Brighthouse Financial,0,2,0,2,None
2025-09-18,Thomas L Ryan,Service Corp International,5,5,0,10,None
2025-09-18,Charles M Nifong Jr,CrossAmerica Partners,0,0,0,0,None
2025-09-18,Anirudh Devgan,Cadence,9,25,1,35,None
2025-09-18,Andi Owen,MillerKnoll,16,15,9,40,None
2025-09-18,Sumit Roy,Realty Income,13,17,2,32,None
2025-09-18,Timothy John Fitzgerald,Middleby,0,0,0,0,None
2025-09-18,Robert H Schottenstein,M/I Homes,2,8,0,10,None
2025-09-18,Stephen P MacMillan,Hologic,1,7,1,9,None
2025-09-18,Lisa M Barton,Alliant Energy,2,0,0,2,None
2025-09-18,Aaron P Jagdfeld,Generac,2,6,1,9,None
2025-09-18,Erik Gershwind,MSC Industrial Direct,3,4,3,10,None
2025-09-18,Varun Krishna,Rocket Companies,9,30,1,40,None
2025-09-18,Fahmi Karam,Upbound Group,4,2,0,6,None
2025-09-18,NADominic Ng,East West Bancorp,0,0,0,0,None
2025-09-18,Mark Wang,Hilton Grand Vacations,38,2,0,40,None
2025-09-18,Robert J Sheedy Jr,Grocery Outlet Holding,0,0,0,0,None
2025-09-18,Simon D Campion,Dentsply Sirona,1,2,0,3,None
2025-09-18,Jeremy Wensinger,V2X,6,6,0,12,None
2025-09-18,Andrew Rees,Crocs,18,13,9,40,None
2025-09-18,David M Maura,Spectrum Brands,7,0,0,7,None
2025-09-18,Sachin S Lawande,Visteon,0,0,0,0,None
2025-09-18,Neil M Ashe,Acuity Inc,0,2,0,2,None
2025-09-18,Lorie L Tekorius,Greenbrier,2,8,0,10,None
2025-09-18,John R Ciulla,Webster Financial,4,6,0,10,None
2025-09-18,Sean D Keohane,Cabot Corporation,0,0,0,0,None
2025-09-18,Drew M Wilkerson,RXO inc,0,0,0,0,None
2025-09-18,Daniel E Brown,Chord Energy,1,0,0,1,None
2025-09-18,Javier D Ferrer Fernandez,Popular inc,0,0,0,0,None
2025-09-18,Olivier Rabiller,Garrett Motion inc,2,8,0,10,None
2025-09-18,Ronald N Tutor,Tutor Perini Corporation,2,7,0,9,None
2025-09-18,Jeff Liaw,Copart,4,6,0,10,None
2025-09-18,Aman Narang,Toast inc,5,5,1,11,None
2025-09-18,Joseph M Hogan,Align Technology,4,5,0,9,None
2025-09-18,Kevin J Wheeler,A O Smith,0,16,1,17,None
2025-09-18,Christopher A Cartwright,TransUnion,2,0,1,3,None
2025-09-18,James Kelly,NCR Voyix,2,12,0,14,None
2025-09-18,Tom Leighton,Akamai Technologies,17,14,5,36,None
2025-09-18,Robert G Painter,Trimble,4,2,0,6,None
2025-09-18,Tony Helton,Medical Mutual of Ohio,2,3,1,6,None
2025-09-18,Caroline S Grace,AMN Healthcare Services,0,0,0,0,None
2025-09-18,Patrick Kaltenbach,Mettler-Toledo International,1,7,0,8,None
2025-09-18,Michael L Baur,ScanSource,0,1,0,1,None
2025-09-18,Jason Lippert,LCI Industries,5,13,0,18,None
2025-09-18,Fredric J Tomczyk,Cboe Global Markets,1,7,1,9,None
2025-09-18,Octavio Marquez,Diebold Nixdorf,7,11,1,19,None
2025-09-18,Sivasankaran Somasundaram,ChampionX,6,2,0,8,None
2025-09-18,Ronald F Clarke,Corpay,0,0,0,0,None
2025-09-18,Robert W Pittman,iHeartMedia,5,3,0,8,None
2025-09-18,Patrick Zalupski,Dream Finders Homes,21,17,2,40,None
2025-09-18,Keith E Smith,Boyd Gaming,0,5,0,5,None
2025-09-18,Mehran Assadi,NLV Financial,1,1,0,2,None
2025-09-18,Barry R Port,Ensign Group,2,3,2,7,None
2025-09-18,Denise A Paulonis,Sally Beauty,0,1,0,1,None
2025-09-18,Clifford A Skelton,Conduent,0,2,1,3,None
2025-09-18,Jean-Michel Ribieras,Sylvamo,2,6,0,8,None
2025-09-18,Douglas F Bauer,Tri Pointe Homes,0,8,0,8,None
2025-09-18,Shawn OConnell,EnerSys,0,1,0,1,None
2025-09-18,Bill Meury,Incyte,6,13,0,19,None
2025-09-18,Dale Francescon,Century Communities,1,9,3,13,None
2025-09-18,Michael Nierenberg,Rithm Capital,10,18,2,30,None
2025-09-18,Michael J Brown,Euronet Worldwide,3,5,0,8,None
2025-09-18,Scott Seu,Hawaiian Electric Industries,5,15,1,21,None
2025-09-18,Jason D Robins,DraftKings,5,2,1,8,None
2025-09-18,Jonathan J Mazelsky,IDEXX Laboratories,1,1,1,3,None
2025-09-18,Richard S Swartz,MYR Group,0,0,0,0,None
2025-09-18,Stefano Caroti,Deckers Outdoor,2,7,1,10,None
2025-09-18,Kevin R Sayer,DexCom,1,7,0,8,None
2025-09-18,John T C Lee,MKS Instruments,3,6,0,9,None
2025-09-18,Edward B Pitoniak,VICI Properties,1,6,0,7,None
2025-09-18,Albert White III,Cooper Cos,0,0,0,0,None
2025-09-18,Barry L Biffle,Frontier Airlines,1,5,6,12,None
2025-09-18,Robert A Bruggeworth,Qorvo,5,3,0,8,None
2025-09-18,Winnie Park,Five Below,10,28,2,40,None
2025-09-18,Steven Oakland,TreeHouse Foods,1,12,0,13,None
2025-09-18,James S Hagedorn,Scotts Miracle-Gro,1,0,0,1,None
2025-09-18,Michael Cannon-Brookes,Atlassian,17,22,0,39,None
2025-09-18,Bertrand Loy,Entegris,1,12,1,14,None
2025-09-18,William E Waltz,Atkore,1,5,0,6,None
2025-09-18,Celeste B Mastin,H B Fuller,0,2,0,2,None
2025-09-18,Kyle T Larkin,Granite Construction,0,4,0,4,None
2025-09-18,Michael J Happe,Winnebago Industries,1,3,1,5,None
2025-09-18,Steven H Gunby,FTI Consulting,5,11,0,16,None
2025-09-18,Stephan B Tanda,AptarGroup,0,4,3,7,None
2025-09-18,Timothy P Boyle,Columbia Sportswear,5,3,2,10,None
2025-09-18,Anthony J Wood,Roku,5,3,1,9,None
2025-09-18,M Christopher Doyle,Civitas Resources,1,2,0,3,None
2025-09-18,Andy Eidson,Alpha Metallurgical Resources,1,5,2,8,None
2025-09-18,Andy L Nemeth,Patrick Industries,3,4,0,7,None
2025-09-18,Roger W Jenkins,Murphy Oil,4,14,0,18,None
2025-09-18,Kevin S Blair,Synovus Financial,7,3,0,10,None
2025-09-18,Julie Felss Masino,Cracker Barrel Old Country Store,10,18,12,40,None
2025-09-18,David M Overton,Cheesecake Factory,1,9,0,10,None
2025-09-18,Nick DeIuliis,CNX Resources,8,3,1,12,None
2025-09-18,Christopher Pappas,Chefs Warehouse,3,10,1,14,None
2025-09-18,Tod Carpenter,Donaldson Company,1,9,0,10,None
2025-09-18,Gregory L Christopher,Mueller Industries,2,5,0,7,None
2025-09-18,Rob Saltiel,MRC Global,3,11,1,15,None
2025-09-18,Jillian C Evanko,Chart Industries,3,7,0,10,None
2025-09-18,Dave Guilmette,Alight Solutions,3,6,0,9,None
2025-09-18,Joel Smejkal,Vishay Intertechnology,5,3,1,9,None
2025-09-18,Dennis Degner,Range Resources,4,9,0,13,None
2025-09-18,Ira D Robbins,Valley National Bancorp,0,2,0,2,None
2025-09-18,Bernard Kim,Match Group,14,19,7,40,None
2025-09-18,Vincent Pilette,Gen Digital,2,9,0,11,None
2025-09-18,Timothy S Crane,Wintrust Financial,2,8,0,10,None
2025-09-18,Pat Roche,Moog inc,3,10,2,15,None
2025-09-18,Mark R Widmar,First Solar,4,3,3,10,None
2025-09-18,Niko Lahanas,Central Garden & Pet,2,10,0,12,None
2025-09-18,Chris Osowski,Green Plains inc,5,7,2,14,None
2025-09-18,Derek J Leathers,Werner Enterprises,2,8,0,10,None
2025-09-18,Adam Foroughi,AppLovin,11,26,3,40,None
2025-09-18,Luca Savi,ITT,2,6,0,8,None
2025-09-18,Lawrence H Silber,Herc Rentals,0,0,0,0,None
2025-09-18,Hilton H Howell Jr,Gray Television,7,19,1,27,None
2025-09-18,Eric D Ashleman,IDEX,0,9,0,9,None
2025-09-18,Owen D Thomas,Boston Properties,2,8,0,10,None
2025-09-18,Kurt Wolf,Pitney Bowes,5,19,1,25,None
2025-09-18,Sara E Armbruster,Steelcase,0,0,0,0,None
2025-09-18,Charles D. Young,Sun Communities,2,5,0,7,None
2025-09-18,Suzanne Foster,AdaptHealth,3,8,1,12,None
2025-09-18,Grant E Sims,Genesis Energy,3,2,0,5,None
2025-09-18,Laura Prieskorn,Jackson Financial,2,6,2,10,None
2025-09-18,Rick L Wessel,FirstCash,3,5,1,9,None
2025-09-18,Sherman Miller,Cal-Maine Foods,10,30,0,40,None
2025-09-18,Paul A Lang,Arch Resources,4,5,0,9,None
2025-09-18,Ashish K Khandpur,Avient,2,6,0,8,None
2025-09-18,Shyam K Reddy,BlueLinx,2,7,0,9,None
2025-09-18,Christopher S Ripley,Sinclair,1,7,1,9,None
2025-09-18,Stacy Kymes,BOK Financial,10,6,0,16,None
2025-09-18,James H Walter,Permian Resources,0,0,0,0,None
2025-09-18,Jason Murray,PACS Group,5,14,2,21,None
2025-09-18,Brian Armstrong,Coinbase Global,15,21,4,40,None
2025-09-18,Oscar K Brown,Western Midstream Partners,2,3,0,5,None
2025-09-18,Nicholas R Lower,Federated Mutual Insurance,0,0,0,0,None
2025-09-18,Morris Goldfarb,G-III Apparel Group,8,27,5,40,None
2025-09-18,Mark D Morelli,Vontier,0,3,0,3,None
2025-09-18,Matthew J Cox,Matson inc,2,4,0,6,None
2025-09-18,David W Grzebinski,Kirby Corporation,1,2,0,3,None
2025-09-18,Keith A Harvey,Kaiser Aluminum,5,3,2,10,None
2025-09-18,Eric Nyman,Vista Outdoor,4,9,1,14,None
2025-09-18,Doug Howe,Designer Brands,5,19,0,24,None
2025-09-18,Jerry E Gahlhoff Jr,Rollins inc,0,2,0,2,None
2025-09-18,D Scott Barbour,Advanced Drainage Systems,1,2,0,3,None
2025-09-18,Sean Gamble,Cinemark,14,25,1,40,None
2025-09-18,George Kurtz,CrowdStrike,13,26,1,40,None
2025-09-18,Bill Ready,Pinterest,27,12,1,40,None
2025-09-18,Fidji Simo,Instacart,8,31,1,40,None
2025-09-18,Kimberly K Ryan,Hillenbrand,2,5,0,7,None
2025-09-18,David S Graziosi,Allison Transmission,2,19,2,23,None
2025-09-18,Gary G Friedman,Restoration Hardware,1,5,0,6,None
2025-09-18,Lucinda M Baier,Brookdale Senior Living,5,3,1,9,None
2025-09-18,Brian J Blaser,QuidelOrtho,1,7,0,8,None
2025-09-18,E Jean Savage,Trinity Industries,1,8,1,10,None
2025-09-18,Liam J Kelly,Teleflex,1,3,1,5,None
2025-09-18,Laurans A Mendelson,HEICO,6,14,0,20,None
2025-09-18,Frank H Laukien,Bruker,2,6,1,9,None
2025-09-18,Harvey M Schwartz,Carlyle Group,4,14,0,18,None
2025-09-18,Mark S LaVigne,Energizer,1,1,0,2,None
2025-09-18,Joel Quadracci,Quad/Graphics,9,27,4,40,None
2025-09-18,Amar Maletira,Rackspace Technology,7,10,3,20,None
2025-09-18,Udit Batra,Waters Corporation,10,20,0,30,None
2025-09-18,Eric M Green,West Pharmaceutical Services,1,8,0,9,None
2025-09-18,Doug Palladini,Carters inc,2,2,2,6,None
2025-09-18,G Mike Mikan,NeueHealth,3,1,0,4,None
2025-09-18,Russell ChipChilds,SkyWest,0,0,0,0,None
2025-09-18,Christopher H Hunter,Acadia Healthcare,0,1,0,1,None
2025-09-18,Prahlad Singh,Revvity,3,7,0,10,None
2025-09-18,Maria M Pope,Portland General Electric,2,5,0,7,None
2025-09-18,Charles Chip Blankenship,Woodward inc,0,2,0,2,None
2025-09-18,Mike Steib,TEGNA,14,15,1,30,None
2025-09-18,Kurt J Ekert,Sabre Corporation,0,0,0,0,None
2025-09-18,Matt Wilson,Light & Wonder,18,18,4,40,None
2025-09-18,Rob Katz,Vail Resorts,3,13,24,40,None
2025-09-18,Schnitzer Steel Industries,Radius Recycling,5,26,7,38,None
2025-09-18,David A Spector,PennyMac Financial Services,3,3,0,6,None
2025-09-18,Frederick J Holzgrefe III,Saia inc,0,1,0,1,None
2025-09-18,Mark J Parrell,Equity Residential,5,4,2,11,None
2025-09-18,John W Lindsay,Helmerich & Payne,0,5,0,5,None
2025-09-18,Gary D Burnison,Korn Ferry,4,11,0,15,None
2025-09-18,Timothy J McGrath,PC Connection Inc,1,0,0,1,None
2025-09-18,Lynn M Bamford,Curtiss-Wright,11,11,0,22,None
2025-09-18,Jonathan W Witter,Sallie Mae,0,1,0,1,None
2025-09-18,Jeff Benck,Benchmark Electronics,3,9,0,12,None
2025-09-18,Charles H Giancarlo,Pure Storage,0,4,0,4,None
2025-09-18,Brian R Gray,Knife River Corporation,0,0,0,0,None
2025-09-18,Jay Schmidt,Caleres inc,3,4,2,9,None
2025-09-18,Dale Asplund,BrightView Holdings,2,7,0,9,None
2025-09-18,Jeffrey S Edwards,Cooper-Standard,0,7,0,7,None
2025-09-18,Glenn J Williams,Primerica,4,2,2,8,None
2025-09-18,Francois Locoh-Donou,F5,6,24,1,31,None
2025-09-18,Joseph Wm Foran,Matador Resources,7,8,0,15,None
2025-09-18,Sridhar Ramaswamy,Snowflake inc,15,20,3,38,None
2025-09-18,Mark D Dankberg,Viasat,2,4,4,10,None
2025-09-18,Francisco J Leon,California Resources,1,2,1,4,None
2025-09-18,Peter Stern,Peloton,19,17,4,40,None
2025-09-18,David Baszucki,Roblox,9,24,7,40,None
2025-09-18,Jeffrey W Edwards,Installed Building Products,0,0,0,0,None
2025-09-18,Clark Lauritzen,First National of Nebraska,1,7,0,8,None
2025-09-18,Carlos Alberini,Guess inc,10,29,1,40,None
2025-09-18,Shyam P Kambeyanda,ESAB,3,5,0,8,None
2025-09-18,Edmund Shallcross III,Amica Mutual Insurance,0,4,0,4,None
2025-09-18,Benjamin W Schall,AvalonBay Communities,1,5,1,7,None
2025-09-18,Allan C Thygesen,DocuSign,3,4,0,7,None
2025-09-18,Bryan J Knutson,Titan Machinery,1,1,1,3,None
2025-09-18,Heath Sampson,ModivCare,6,2,2,10,None
2025-09-18,Ara K Hovnanian,Hovnanian Enterprises,2,15,1,18,None
2025-09-18,Joshua G Silverman,Etsy,1,2,1,4,None
2025-09-18,Kevin Roycraft,Adams Resources & Energy,5,4,1,10,None
2025-09-18,J Eric Evans,Surgery Partners,0,2,0,2,None
2025-09-18,Clint E Stein,Columbia Banking System,1,4,0,5,None
2025-09-18,Lee M Shavel,Verisk Analytics,2,6,0,8,None
2025-09-18,Dave Banyard Jr,MasterBrand,0,0,0,0,None
2025-09-18,Peter R Ingram,Hawaiian Airlines inc,1,0,0,1,None
2025-09-18,Kristin A Dolan,AMC Networks,3,1,0,4,None
2025-09-18,Brendan T Cavanagh,SBA Communications,1,3,0,4,None
2025-09-18,George F Chappelle Jr,Americold Realty Trust,2,3,0,5,None
2025-09-18,Thomas E Gottwald,NewMarket Corporation,1,8,0,9,None
2025-09-18,Thomas J Baltimore Jr,Park Hotels & Resorts,3,28,1,32,None
2025-09-18,Peter M Moglia,Alexandria Real Estate Equities,5,4,0,9,None
2025-09-18,Ronald J Kramer,Griffon Corporation,2,7,1,10,None
2025-09-18,John L Plueger,Air Lease,3,11,0,14,None
2025-09-18,Jennifer F Scanlon,UL Solutions,1,4,0,5,None
2025-09-18,Greg Smith,Teradyne,1,7,2,10,None
2025-09-18,Sean Trauschke,OGE Energy,18,4,0,22,None
2025-09-18,Norman D Schwartz,Bio-Rad Laboratories,0,0,1,1,None
2025-09-18,Scott Doyle,Spire inc,4,5,1,10,None
2025-09-18,Michael E Reed,Gannett,0,4,1,5,None
2025-09-18,Cindy J Miller,Stericycle,2,4,4,10,None
2025-09-18,Phillip D Green,Cullen Frost Bankers,1,3,2,6,None
2025-09-18,Joseph D Margolis,Extra Space Storage,1,7,1,9,None
2025-09-18,Mark A Skonieczny,REV Group,1,2,0,3,None
2025-09-18,Ladd Wilks,ProFrac Holding,4,0,0,4,None
2025-09-18,Sundaram Nagarajan,Nordson,0,9,1,10,None
2025-09-18,Anne P Noonan,Summit Materials,0,1,0,1,None
2025-09-18,Lori Flees,Valvoline inc,4,4,1,9,None
2025-09-18,Scott H Baxter,Kontoor Brands,1,3,0,4,None
2025-09-18,Tim Larson,Skyline Champion,4,0,0,4,None
2025-09-18,Chuck Divita,Teladoc Health,10,18,5,33,None
2025-09-18,W Bradley Southern,Louisiana-Pacific Corporation,0,0,0,0,None
2025-09-18,George C Freeman III,Universal Corporation,2,7,0,9,None
2025-09-18,James A Brock,Consol Energy,1,0,0,1,None
2025-09-18,Robert Antokol,Playtika Holding,1,6,1,8,None
2025-09-18,Joe Craft,Alliance Resource Partners,6,9,2,17,None
2025-09-18,Paul Keel,Envista,2,8,0,10,None
2025-09-18,Jared Isaacman,Shift4 Payments,9,27,4,40,None
2025-09-18,Mark Mac McFarland,Talen Energy,5,1,1,7,None
2025-09-18,Tony R Thene,Carpenter Technology,3,6,0,9,None
2025-09-18,Melissa D Smith,WEX,1,6,2,9,None
2025-09-18,James Jim C Ryan III,Old National Bancorp,1,0,0,1,None
2025-09-18,Peter J Federico,AGNC Investment,1,0,1,2,None
2025-09-18,Brent L Yeagy,Wabash National,0,1,0,1,None
2025-09-18,Henry A Fernandez,MSCI,2,16,0,18,None
2025-09-18,Mark Penn,Stagwell,11,22,6,39,None
2025-09-18,Julie Schertell,Mativ,2,8,0,10,None
2025-09-18,Ashish Chand,Belden,3,6,1,10,None
2025-09-18,Greg Anderson,Allegiant Travel Company,5,7,0,12,None
2025-09-18,Drew Houston,Dropbox,14,18,8,40,None
2025-09-18,Kevin T Conroy,Exact Sciences,1,5,3,9,None
2025-09-18,Rex D Geveden,BWX Technologies,4,8,0,12,None
2025-09-18,Scott R Wells,Clear Channel Outdoor Hldgs,0,0,0,0,None
2025-09-18,Paul Bay,Ingram Micro,10,25,5,40,None
